Score Threshold,Measurements (M),Confusion Matrix (cm),True Pos.s (TP),True Neg.s (TN),False Pos.s (FP),*False Neg.s* (FN),Positives (P),Negatives (N),Meas.Pos.s (MP),Meas.Neg.s (MN),Correct Meas.s (CM),Incorrect Meas.s (IM),Accuracy (ACC),Precision (PPV),Recall/Sensitivity (TPR),Specificity/Selectivity (TNR),Fallout (FPR),Miss Rate (FNR),F1 Score (F1)
0.0,400,"[[200, 200], [0, 0]]",200,0,200,0,200,200,400,0,200,200,0.5,0.5,1.0,0.0,1.0,0.0,0.6666666666666666
0.001,400,"[[191, 188], [9, 12]]",191,9,188,9,200,200,379,21,203,197,0.5075,0.503957783641161,0.955,0.06,0.94,0.045,0.6597582037996546
0.002,400,"[[189, 187], [11, 13]]",189,11,187,11,200,200,376,24,202,198,0.505,0.5026595744680851,0.945,0.065,0.935,0.055,0.65625
0.003,400,"[[187, 186], [13, 14]]",187,13,186,13,200,200,373,27,201,199,0.5025,0.5013404825737265,0.935,0.07,0.93,0.065,0.6527050610820244
0.004,400,"[[187, 185], [13, 15]]",187,13,185,13,200,200,372,28,202,198,0.505,0.5026881720430108,0.935,0.075,0.925,0.065,0.6538461538461539
0.005,400,"[[185, 185], [15, 15]]",185,15,185,15,200,200,370,30,200,200,0.5,0.5,0.925,0.075,0.925,0.075,0.6491228070175439
0.006,400,"[[184, 184], [16, 16]]",184,16,184,16,200,200,368,32,200,200,0.5,0.5,0.92,0.08,0.92,0.08,0.647887323943662
0.007,400,"[[184, 183], [16, 17]]",184,16,183,16,200,200,367,33,201,199,0.5025,0.5013623978201635,0.92,0.085,0.915,0.08,0.6490299823633157
0.008,400,"[[184, 182], [16, 18]]",184,16,182,16,200,200,366,34,202,198,0.505,0.5027322404371585,0.92,0.09,0.91,0.08,0.6501766784452296
0.009,400,"[[184, 181], [16, 19]]",184,16,181,16,200,200,365,35,203,197,0.5075,0.5041095890410959,0.92,0.095,0.905,0.08,0.6513274336283187
0.01,400,"[[183, 179], [17, 21]]",183,17,179,17,200,200,362,38,204,196,0.51,0.505524861878453,0.915,0.105,0.895,0.085,0.6512455516014236
0.011,400,"[[183, 179], [17, 21]]",183,17,179,17,200,200,362,38,204,196,0.51,0.505524861878453,0.915,0.105,0.895,0.085,0.6512455516014236
0.012,400,"[[182, 178], [18, 22]]",182,18,178,18,200,200,360,40,204,196,0.51,0.5055555555555555,0.91,0.11,0.89,0.09,0.6499999999999999
0.013,400,"[[182, 176], [18, 24]]",182,18,176,18,200,200,358,42,206,194,0.515,0.5083798882681564,0.91,0.12,0.88,0.09,0.6523297491039426
0.014,400,"[[182, 176], [18, 24]]",182,18,176,18,200,200,358,42,206,194,0.515,0.5083798882681564,0.91,0.12,0.88,0.09,0.6523297491039426
0.015,400,"[[181, 176], [19, 24]]",181,19,176,19,200,200,357,43,205,195,0.5125,0.5070028011204482,0.905,0.12,0.88,0.095,0.6499102333931778
0.016,400,"[[180, 175], [20, 25]]",180,20,175,20,200,200,355,45,205,195,0.5125,0.5070422535211268,0.9,0.125,0.875,0.1,0.6486486486486486
0.017,400,"[[179, 174], [21, 26]]",179,21,174,21,200,200,353,47,205,195,0.5125,0.5070821529745042,0.895,0.13,0.87,0.105,0.6473779385171791
0.018,400,"[[179, 174], [21, 26]]",179,21,174,21,200,200,353,47,205,195,0.5125,0.5070821529745042,0.895,0.13,0.87,0.105,0.6473779385171791
0.019,400,"[[178, 174], [22, 26]]",178,22,174,22,200,200,352,48,204,196,0.51,0.5056818181818182,0.89,0.13,0.87,0.11,0.6449275362318841
0.02,400,"[[178, 174], [22, 26]]",178,22,174,22,200,200,352,48,204,196,0.51,0.5056818181818182,0.89,0.13,0.87,0.11,0.6449275362318841
0.021,400,"[[178, 173], [22, 27]]",178,22,173,22,200,200,351,49,205,195,0.5125,0.5071225071225072,0.89,0.135,0.865,0.11,0.6460980036297642
0.022,400,"[[177, 172], [23, 28]]",177,23,172,23,200,200,349,51,205,195,0.5125,0.5071633237822349,0.885,0.14,0.86,0.115,0.644808743169399
0.023,400,"[[177, 172], [23, 28]]",177,23,172,23,200,200,349,51,205,195,0.5125,0.5071633237822349,0.885,0.14,0.86,0.115,0.644808743169399
0.024,400,"[[177, 172], [23, 28]]",177,23,172,23,200,200,349,51,205,195,0.5125,0.5071633237822349,0.885,0.14,0.86,0.115,0.644808743169399
0.025,400,"[[177, 171], [23, 29]]",177,23,171,23,200,200,348,52,206,194,0.515,0.5086206896551724,0.885,0.145,0.855,0.115,0.645985401459854
0.026,400,"[[177, 171], [23, 29]]",177,23,171,23,200,200,348,52,206,194,0.515,0.5086206896551724,0.885,0.145,0.855,0.115,0.645985401459854
0.027,400,"[[177, 170], [23, 30]]",177,23,170,23,200,200,347,53,207,193,0.5175,0.5100864553314121,0.885,0.15,0.85,0.115,0.6471663619744058
0.028,400,"[[176, 170], [24, 30]]",176,24,170,24,200,200,346,54,206,194,0.515,0.5086705202312138,0.88,0.15,0.85,0.12,0.6446886446886446
0.029,400,"[[176, 170], [24, 30]]",176,24,170,24,200,200,346,54,206,194,0.515,0.5086705202312138,0.88,0.15,0.85,0.12,0.6446886446886446
0.03,400,"[[176, 170], [24, 30]]",176,24,170,24,200,200,346,54,206,194,0.515,0.5086705202312138,0.88,0.15,0.85,0.12,0.6446886446886446
0.031,400,"[[165, 170], [35, 30]]",165,35,170,35,200,200,335,65,195,205,0.4875,0.4925373134328358,0.825,0.15,0.85,0.175,0.6168224299065419
0.032,400,"[[165, 169], [35, 31]]",165,35,169,35,200,200,334,66,196,204,0.49,0.4940119760479042,0.825,0.155,0.845,0.175,0.6179775280898876
0.033,400,"[[165, 169], [35, 31]]",165,35,169,35,200,200,334,66,196,204,0.49,0.4940119760479042,0.825,0.155,0.845,0.175,0.6179775280898876
0.034,400,"[[164, 169], [36, 31]]",164,36,169,36,200,200,333,67,195,205,0.4875,0.4924924924924925,0.82,0.155,0.845,0.18,0.6153846153846154
0.035,400,"[[164, 169], [36, 31]]",164,36,169,36,200,200,333,67,195,205,0.4875,0.4924924924924925,0.82,0.155,0.845,0.18,0.6153846153846154
0.036,400,"[[164, 169], [36, 31]]",164,36,169,36,200,200,333,67,195,205,0.4875,0.4924924924924925,0.82,0.155,0.845,0.18,0.6153846153846154
0.037,400,"[[164, 169], [36, 31]]",164,36,169,36,200,200,333,67,195,205,0.4875,0.4924924924924925,0.82,0.155,0.845,0.18,0.6153846153846154
0.038,400,"[[164, 169], [36, 31]]",164,36,169,36,200,200,333,67,195,205,0.4875,0.4924924924924925,0.82,0.155,0.845,0.18,0.6153846153846154
0.039,400,"[[163, 169], [37, 31]]",163,37,169,37,200,200,332,68,194,206,0.485,0.49096385542168675,0.815,0.155,0.845,0.185,0.6127819548872181
0.04,400,"[[162, 169], [38, 31]]",162,38,169,38,200,200,331,69,193,207,0.4825,0.48942598187311176,0.81,0.155,0.845,0.19,0.6101694915254238
0.041,400,"[[162, 167], [38, 33]]",162,38,167,38,200,200,329,71,195,205,0.4875,0.49240121580547114,0.81,0.165,0.835,0.19,0.6124763705103969
0.042,400,"[[162, 167], [38, 33]]",162,38,167,38,200,200,329,71,195,205,0.4875,0.49240121580547114,0.81,0.165,0.835,0.19,0.6124763705103969
0.043,400,"[[162, 165], [38, 35]]",162,38,165,38,200,200,327,73,197,203,0.4925,0.4954128440366973,0.81,0.175,0.825,0.19,0.6148007590132828
0.044,400,"[[160, 165], [40, 35]]",160,40,165,40,200,200,325,75,195,205,0.4875,0.49230769230769234,0.8,0.175,0.825,0.2,0.6095238095238096
0.045,400,"[[160, 164], [40, 36]]",160,40,164,40,200,200,324,76,196,204,0.49,0.49382716049382713,0.8,0.18,0.82,0.2,0.6106870229007633
0.046,400,"[[160, 163], [40, 37]]",160,40,163,40,200,200,323,77,197,203,0.4925,0.4953560371517028,0.8,0.185,0.815,0.2,0.6118546845124283
0.047,400,"[[160, 163], [40, 37]]",160,40,163,40,200,200,323,77,197,203,0.4925,0.4953560371517028,0.8,0.185,0.815,0.2,0.6118546845124283
0.048,400,"[[160, 163], [40, 37]]",160,40,163,40,200,200,323,77,197,203,0.4925,0.4953560371517028,0.8,0.185,0.815,0.2,0.6118546845124283
0.049,400,"[[160, 162], [40, 38]]",160,40,162,40,200,200,322,78,198,202,0.495,0.4968944099378882,0.8,0.19,0.81,0.2,0.6130268199233716
0.05,400,"[[159, 162], [41, 38]]",159,41,162,41,200,200,321,79,197,203,0.4925,0.4953271028037383,0.795,0.19,0.81,0.205,0.6103646833013435
0.051,400,"[[159, 162], [41, 38]]",159,41,162,41,200,200,321,79,197,203,0.4925,0.4953271028037383,0.795,0.19,0.81,0.205,0.6103646833013435
0.052,400,"[[159, 162], [41, 38]]",159,41,162,41,200,200,321,79,197,203,0.4925,0.4953271028037383,0.795,0.19,0.81,0.205,0.6103646833013435
0.053,400,"[[159, 162], [41, 38]]",159,41,162,41,200,200,321,79,197,203,0.4925,0.4953271028037383,0.795,0.19,0.81,0.205,0.6103646833013435
0.054,400,"[[159, 162], [41, 38]]",159,41,162,41,200,200,321,79,197,203,0.4925,0.4953271028037383,0.795,0.19,0.81,0.205,0.6103646833013435
0.055,400,"[[159, 162], [41, 38]]",159,41,162,41,200,200,321,79,197,203,0.4925,0.4953271028037383,0.795,0.19,0.81,0.205,0.6103646833013435
0.056,400,"[[158, 162], [42, 38]]",158,42,162,42,200,200,320,80,196,204,0.49,0.49375,0.79,0.19,0.81,0.21,0.6076923076923078
0.057,400,"[[158, 162], [42, 38]]",158,42,162,42,200,200,320,80,196,204,0.49,0.49375,0.79,0.19,0.81,0.21,0.6076923076923078
0.058,400,"[[158, 162], [42, 38]]",158,42,162,42,200,200,320,80,196,204,0.49,0.49375,0.79,0.19,0.81,0.21,0.6076923076923078
0.059,400,"[[157, 162], [43, 38]]",157,43,162,43,200,200,319,81,195,205,0.4875,0.49216300940438873,0.785,0.19,0.81,0.215,0.6050096339113681
0.06,400,"[[157, 162], [43, 38]]",157,43,162,43,200,200,319,81,195,205,0.4875,0.49216300940438873,0.785,0.19,0.81,0.215,0.6050096339113681
0.061,400,"[[157, 162], [43, 38]]",157,43,162,43,200,200,319,81,195,205,0.4875,0.49216300940438873,0.785,0.19,0.81,0.215,0.6050096339113681
0.062,400,"[[157, 162], [43, 38]]",157,43,162,43,200,200,319,81,195,205,0.4875,0.49216300940438873,0.785,0.19,0.81,0.215,0.6050096339113681
0.063,400,"[[157, 162], [43, 38]]",157,43,162,43,200,200,319,81,195,205,0.4875,0.49216300940438873,0.785,0.19,0.81,0.215,0.6050096339113681
0.064,400,"[[157, 162], [43, 38]]",157,43,162,43,200,200,319,81,195,205,0.4875,0.49216300940438873,0.785,0.19,0.81,0.215,0.6050096339113681
0.065,400,"[[157, 162], [43, 38]]",157,43,162,43,200,200,319,81,195,205,0.4875,0.49216300940438873,0.785,0.19,0.81,0.215,0.6050096339113681
0.066,400,"[[157, 162], [43, 38]]",157,43,162,43,200,200,319,81,195,205,0.4875,0.49216300940438873,0.785,0.19,0.81,0.215,0.6050096339113681
0.067,400,"[[157, 161], [43, 39]]",157,43,161,43,200,200,318,82,196,204,0.49,0.4937106918238994,0.785,0.195,0.805,0.215,0.6061776061776062
0.068,400,"[[155, 160], [45, 40]]",155,45,160,45,200,200,315,85,195,205,0.4875,0.49206349206349204,0.775,0.2,0.8,0.225,0.6019417475728155
0.069,400,"[[155, 160], [45, 40]]",155,45,160,45,200,200,315,85,195,205,0.4875,0.49206349206349204,0.775,0.2,0.8,0.225,0.6019417475728155
0.07,400,"[[155, 159], [45, 41]]",155,45,159,45,200,200,314,86,196,204,0.49,0.49363057324840764,0.775,0.205,0.795,0.225,0.603112840466926
0.071,400,"[[155, 159], [45, 41]]",155,45,159,45,200,200,314,86,196,204,0.49,0.49363057324840764,0.775,0.205,0.795,0.225,0.603112840466926
0.072,400,"[[155, 158], [45, 42]]",155,45,158,45,200,200,313,87,197,203,0.4925,0.4952076677316294,0.775,0.21,0.79,0.225,0.6042884990253412
0.073,400,"[[155, 158], [45, 42]]",155,45,158,45,200,200,313,87,197,203,0.4925,0.4952076677316294,0.775,0.21,0.79,0.225,0.6042884990253412
0.074,400,"[[155, 158], [45, 42]]",155,45,158,45,200,200,313,87,197,203,0.4925,0.4952076677316294,0.775,0.21,0.79,0.225,0.6042884990253412
0.075,400,"[[155, 158], [45, 42]]",155,45,158,45,200,200,313,87,197,203,0.4925,0.4952076677316294,0.775,0.21,0.79,0.225,0.6042884990253412
0.076,400,"[[155, 158], [45, 42]]",155,45,158,45,200,200,313,87,197,203,0.4925,0.4952076677316294,0.775,0.21,0.79,0.225,0.6042884990253412
0.077,400,"[[155, 158], [45, 42]]",155,45,158,45,200,200,313,87,197,203,0.4925,0.4952076677316294,0.775,0.21,0.79,0.225,0.6042884990253412
0.078,400,"[[155, 158], [45, 42]]",155,45,158,45,200,200,313,87,197,203,0.4925,0.4952076677316294,0.775,0.21,0.79,0.225,0.6042884990253412
0.079,400,"[[155, 158], [45, 42]]",155,45,158,45,200,200,313,87,197,203,0.4925,0.4952076677316294,0.775,0.21,0.79,0.225,0.6042884990253412
0.08,400,"[[155, 158], [45, 42]]",155,45,158,45,200,200,313,87,197,203,0.4925,0.4952076677316294,0.775,0.21,0.79,0.225,0.6042884990253412
0.081,400,"[[155, 158], [45, 42]]",155,45,158,45,200,200,313,87,197,203,0.4925,0.4952076677316294,0.775,0.21,0.79,0.225,0.6042884990253412
0.082,400,"[[155, 158], [45, 42]]",155,45,158,45,200,200,313,87,197,203,0.4925,0.4952076677316294,0.775,0.21,0.79,0.225,0.6042884990253412
0.083,400,"[[155, 158], [45, 42]]",155,45,158,45,200,200,313,87,197,203,0.4925,0.4952076677316294,0.775,0.21,0.79,0.225,0.6042884990253412
0.084,400,"[[155, 157], [45, 43]]",155,45,157,45,200,200,312,88,198,202,0.495,0.4967948717948718,0.775,0.215,0.785,0.225,0.6054687500000001
0.085,400,"[[155, 157], [45, 43]]",155,45,157,45,200,200,312,88,198,202,0.495,0.4967948717948718,0.775,0.215,0.785,0.225,0.6054687500000001
0.086,400,"[[154, 157], [46, 43]]",154,46,157,46,200,200,311,89,197,203,0.4925,0.49517684887459806,0.77,0.215,0.785,0.23,0.6027397260273973
0.087,400,"[[154, 156], [46, 44]]",154,46,156,46,200,200,310,90,198,202,0.495,0.4967741935483871,0.77,0.22,0.78,0.23,0.6039215686274509
0.088,400,"[[154, 156], [46, 44]]",154,46,156,46,200,200,310,90,198,202,0.495,0.4967741935483871,0.77,0.22,0.78,0.23,0.6039215686274509
0.089,400,"[[154, 156], [46, 44]]",154,46,156,46,200,200,310,90,198,202,0.495,0.4967741935483871,0.77,0.22,0.78,0.23,0.6039215686274509
0.09,400,"[[154, 156], [46, 44]]",154,46,156,46,200,200,310,90,198,202,0.495,0.4967741935483871,0.77,0.22,0.78,0.23,0.6039215686274509
0.091,400,"[[154, 156], [46, 44]]",154,46,156,46,200,200,310,90,198,202,0.495,0.4967741935483871,0.77,0.22,0.78,0.23,0.6039215686274509
0.092,400,"[[154, 156], [46, 44]]",154,46,156,46,200,200,310,90,198,202,0.495,0.4967741935483871,0.77,0.22,0.78,0.23,0.6039215686274509
0.093,400,"[[154, 156], [46, 44]]",154,46,156,46,200,200,310,90,198,202,0.495,0.4967741935483871,0.77,0.22,0.78,0.23,0.6039215686274509
0.094,400,"[[154, 154], [46, 46]]",154,46,154,46,200,200,308,92,200,200,0.5,0.5,0.77,0.23,0.77,0.23,0.6062992125984252
0.095,400,"[[153, 154], [47, 46]]",153,47,154,47,200,200,307,93,199,201,0.4975,0.498371335504886,0.765,0.23,0.77,0.235,0.6035502958579883
0.096,400,"[[153, 154], [47, 46]]",153,47,154,47,200,200,307,93,199,201,0.4975,0.498371335504886,0.765,0.23,0.77,0.235,0.6035502958579883
0.097,400,"[[153, 154], [47, 46]]",153,47,154,47,200,200,307,93,199,201,0.4975,0.498371335504886,0.765,0.23,0.77,0.235,0.6035502958579883
0.098,400,"[[153, 154], [47, 46]]",153,47,154,47,200,200,307,93,199,201,0.4975,0.498371335504886,0.765,0.23,0.77,0.235,0.6035502958579883
0.099,400,"[[153, 153], [47, 47]]",153,47,153,47,200,200,306,94,200,200,0.5,0.5,0.765,0.235,0.765,0.235,0.6047430830039525
0.1,400,"[[152, 153], [48, 47]]",152,48,153,48,200,200,305,95,199,201,0.4975,0.49836065573770494,0.76,0.235,0.765,0.24,0.601980198019802
0.101,400,"[[150, 153], [50, 47]]",150,50,153,50,200,200,303,97,197,203,0.4925,0.49504950495049505,0.75,0.235,0.765,0.25,0.5964214711729622
0.102,400,"[[150, 153], [50, 47]]",150,50,153,50,200,200,303,97,197,203,0.4925,0.49504950495049505,0.75,0.235,0.765,0.25,0.5964214711729622
0.103,400,"[[150, 153], [50, 47]]",150,50,153,50,200,200,303,97,197,203,0.4925,0.49504950495049505,0.75,0.235,0.765,0.25,0.5964214711729622
0.104,400,"[[150, 153], [50, 47]]",150,50,153,50,200,200,303,97,197,203,0.4925,0.49504950495049505,0.75,0.235,0.765,0.25,0.5964214711729622
0.105,400,"[[150, 153], [50, 47]]",150,50,153,50,200,200,303,97,197,203,0.4925,0.49504950495049505,0.75,0.235,0.765,0.25,0.5964214711729622
0.106,400,"[[150, 153], [50, 47]]",150,50,153,50,200,200,303,97,197,203,0.4925,0.49504950495049505,0.75,0.235,0.765,0.25,0.5964214711729622
0.107,400,"[[150, 153], [50, 47]]",150,50,153,50,200,200,303,97,197,203,0.4925,0.49504950495049505,0.75,0.235,0.765,0.25,0.5964214711729622
0.108,400,"[[150, 153], [50, 47]]",150,50,153,50,200,200,303,97,197,203,0.4925,0.49504950495049505,0.75,0.235,0.765,0.25,0.5964214711729622
0.109,400,"[[150, 153], [50, 47]]",150,50,153,50,200,200,303,97,197,203,0.4925,0.49504950495049505,0.75,0.235,0.765,0.25,0.5964214711729622
0.11,400,"[[150, 153], [50, 47]]",150,50,153,50,200,200,303,97,197,203,0.4925,0.49504950495049505,0.75,0.235,0.765,0.25,0.5964214711729622
0.111,400,"[[150, 153], [50, 47]]",150,50,153,50,200,200,303,97,197,203,0.4925,0.49504950495049505,0.75,0.235,0.765,0.25,0.5964214711729622
0.112,400,"[[150, 153], [50, 47]]",150,50,153,50,200,200,303,97,197,203,0.4925,0.49504950495049505,0.75,0.235,0.765,0.25,0.5964214711729622
0.113,400,"[[150, 153], [50, 47]]",150,50,153,50,200,200,303,97,197,203,0.4925,0.49504950495049505,0.75,0.235,0.765,0.25,0.5964214711729622
0.114,400,"[[150, 153], [50, 47]]",150,50,153,50,200,200,303,97,197,203,0.4925,0.49504950495049505,0.75,0.235,0.765,0.25,0.5964214711729622
0.115,400,"[[150, 153], [50, 47]]",150,50,153,50,200,200,303,97,197,203,0.4925,0.49504950495049505,0.75,0.235,0.765,0.25,0.5964214711729622
0.116,400,"[[150, 153], [50, 47]]",150,50,153,50,200,200,303,97,197,203,0.4925,0.49504950495049505,0.75,0.235,0.765,0.25,0.5964214711729622
0.117,400,"[[150, 153], [50, 47]]",150,50,153,50,200,200,303,97,197,203,0.4925,0.49504950495049505,0.75,0.235,0.765,0.25,0.5964214711729622
0.118,400,"[[150, 153], [50, 47]]",150,50,153,50,200,200,303,97,197,203,0.4925,0.49504950495049505,0.75,0.235,0.765,0.25,0.5964214711729622
0.119,400,"[[150, 153], [50, 47]]",150,50,153,50,200,200,303,97,197,203,0.4925,0.49504950495049505,0.75,0.235,0.765,0.25,0.5964214711729622
0.12,400,"[[150, 153], [50, 47]]",150,50,153,50,200,200,303,97,197,203,0.4925,0.49504950495049505,0.75,0.235,0.765,0.25,0.5964214711729622
0.121,400,"[[150, 152], [50, 48]]",150,50,152,50,200,200,302,98,198,202,0.495,0.4966887417218543,0.75,0.24,0.76,0.25,0.597609561752988
0.122,400,"[[150, 152], [50, 48]]",150,50,152,50,200,200,302,98,198,202,0.495,0.4966887417218543,0.75,0.24,0.76,0.25,0.597609561752988
0.123,400,"[[150, 152], [50, 48]]",150,50,152,50,200,200,302,98,198,202,0.495,0.4966887417218543,0.75,0.24,0.76,0.25,0.597609561752988
0.124,400,"[[150, 152], [50, 48]]",150,50,152,50,200,200,302,98,198,202,0.495,0.4966887417218543,0.75,0.24,0.76,0.25,0.597609561752988
0.125,400,"[[150, 152], [50, 48]]",150,50,152,50,200,200,302,98,198,202,0.495,0.4966887417218543,0.75,0.24,0.76,0.25,0.597609561752988
0.126,400,"[[149, 152], [51, 48]]",149,51,152,51,200,200,301,99,197,203,0.4925,0.4950166112956811,0.745,0.24,0.76,0.255,0.594810379241517
0.127,400,"[[149, 152], [51, 48]]",149,51,152,51,200,200,301,99,197,203,0.4925,0.4950166112956811,0.745,0.24,0.76,0.255,0.594810379241517
0.128,400,"[[149, 152], [51, 48]]",149,51,152,51,200,200,301,99,197,203,0.4925,0.4950166112956811,0.745,0.24,0.76,0.255,0.594810379241517
0.129,400,"[[149, 152], [51, 48]]",149,51,152,51,200,200,301,99,197,203,0.4925,0.4950166112956811,0.745,0.24,0.76,0.255,0.594810379241517
0.13,400,"[[149, 152], [51, 48]]",149,51,152,51,200,200,301,99,197,203,0.4925,0.4950166112956811,0.745,0.24,0.76,0.255,0.594810379241517
0.131,400,"[[149, 152], [51, 48]]",149,51,152,51,200,200,301,99,197,203,0.4925,0.4950166112956811,0.745,0.24,0.76,0.255,0.594810379241517
0.132,400,"[[149, 152], [51, 48]]",149,51,152,51,200,200,301,99,197,203,0.4925,0.4950166112956811,0.745,0.24,0.76,0.255,0.594810379241517
0.133,400,"[[149, 152], [51, 48]]",149,51,152,51,200,200,301,99,197,203,0.4925,0.4950166112956811,0.745,0.24,0.76,0.255,0.594810379241517
0.134,400,"[[149, 152], [51, 48]]",149,51,152,51,200,200,301,99,197,203,0.4925,0.4950166112956811,0.745,0.24,0.76,0.255,0.594810379241517
0.135,400,"[[149, 151], [51, 49]]",149,51,151,51,200,200,300,100,198,202,0.495,0.49666666666666665,0.745,0.245,0.755,0.255,0.596
0.136,400,"[[149, 151], [51, 49]]",149,51,151,51,200,200,300,100,198,202,0.495,0.49666666666666665,0.745,0.245,0.755,0.255,0.596
0.137,400,"[[149, 151], [51, 49]]",149,51,151,51,200,200,300,100,198,202,0.495,0.49666666666666665,0.745,0.245,0.755,0.255,0.596
0.138,400,"[[148, 151], [52, 49]]",148,52,151,52,200,200,299,101,197,203,0.4925,0.49498327759197325,0.74,0.245,0.755,0.26,0.593186372745491
0.139,400,"[[148, 151], [52, 49]]",148,52,151,52,200,200,299,101,197,203,0.4925,0.49498327759197325,0.74,0.245,0.755,0.26,0.593186372745491
0.14,400,"[[148, 151], [52, 49]]",148,52,151,52,200,200,299,101,197,203,0.4925,0.49498327759197325,0.74,0.245,0.755,0.26,0.593186372745491
0.141,400,"[[148, 151], [52, 49]]",148,52,151,52,200,200,299,101,197,203,0.4925,0.49498327759197325,0.74,0.245,0.755,0.26,0.593186372745491
0.142,400,"[[148, 151], [52, 49]]",148,52,151,52,200,200,299,101,197,203,0.4925,0.49498327759197325,0.74,0.245,0.755,0.26,0.593186372745491
0.143,400,"[[148, 151], [52, 49]]",148,52,151,52,200,200,299,101,197,203,0.4925,0.49498327759197325,0.74,0.245,0.755,0.26,0.593186372745491
0.144,400,"[[148, 151], [52, 49]]",148,52,151,52,200,200,299,101,197,203,0.4925,0.49498327759197325,0.74,0.245,0.755,0.26,0.593186372745491
0.145,400,"[[147, 151], [53, 49]]",147,53,151,53,200,200,298,102,196,204,0.49,0.49328859060402686,0.735,0.245,0.755,0.265,0.5903614457831325
0.146,400,"[[147, 151], [53, 49]]",147,53,151,53,200,200,298,102,196,204,0.49,0.49328859060402686,0.735,0.245,0.755,0.265,0.5903614457831325
0.147,400,"[[147, 151], [53, 49]]",147,53,151,53,200,200,298,102,196,204,0.49,0.49328859060402686,0.735,0.245,0.755,0.265,0.5903614457831325
0.148,400,"[[147, 151], [53, 49]]",147,53,151,53,200,200,298,102,196,204,0.49,0.49328859060402686,0.735,0.245,0.755,0.265,0.5903614457831325
0.149,400,"[[147, 151], [53, 49]]",147,53,151,53,200,200,298,102,196,204,0.49,0.49328859060402686,0.735,0.245,0.755,0.265,0.5903614457831325
0.15,400,"[[147, 151], [53, 49]]",147,53,151,53,200,200,298,102,196,204,0.49,0.49328859060402686,0.735,0.245,0.755,0.265,0.5903614457831325
0.151,400,"[[147, 151], [53, 49]]",147,53,151,53,200,200,298,102,196,204,0.49,0.49328859060402686,0.735,0.245,0.755,0.265,0.5903614457831325
0.152,400,"[[147, 151], [53, 49]]",147,53,151,53,200,200,298,102,196,204,0.49,0.49328859060402686,0.735,0.245,0.755,0.265,0.5903614457831325
0.153,400,"[[147, 151], [53, 49]]",147,53,151,53,200,200,298,102,196,204,0.49,0.49328859060402686,0.735,0.245,0.755,0.265,0.5903614457831325
0.154,400,"[[147, 151], [53, 49]]",147,53,151,53,200,200,298,102,196,204,0.49,0.49328859060402686,0.735,0.245,0.755,0.265,0.5903614457831325
0.155,400,"[[147, 151], [53, 49]]",147,53,151,53,200,200,298,102,196,204,0.49,0.49328859060402686,0.735,0.245,0.755,0.265,0.5903614457831325
0.156,400,"[[147, 151], [53, 49]]",147,53,151,53,200,200,298,102,196,204,0.49,0.49328859060402686,0.735,0.245,0.755,0.265,0.5903614457831325
0.157,400,"[[147, 151], [53, 49]]",147,53,151,53,200,200,298,102,196,204,0.49,0.49328859060402686,0.735,0.245,0.755,0.265,0.5903614457831325
0.158,400,"[[147, 151], [53, 49]]",147,53,151,53,200,200,298,102,196,204,0.49,0.49328859060402686,0.735,0.245,0.755,0.265,0.5903614457831325
0.159,400,"[[146, 151], [54, 49]]",146,54,151,54,200,200,297,103,195,205,0.4875,0.49158249158249157,0.73,0.245,0.755,0.27,0.5875251509054326
0.16,400,"[[146, 151], [54, 49]]",146,54,151,54,200,200,297,103,195,205,0.4875,0.49158249158249157,0.73,0.245,0.755,0.27,0.5875251509054326
0.161,400,"[[146, 151], [54, 49]]",146,54,151,54,200,200,297,103,195,205,0.4875,0.49158249158249157,0.73,0.245,0.755,0.27,0.5875251509054326
0.162,400,"[[145, 149], [55, 51]]",145,55,149,55,200,200,294,106,196,204,0.49,0.4931972789115646,0.725,0.255,0.745,0.275,0.5870445344129555
0.163,400,"[[145, 148], [55, 52]]",145,55,148,55,200,200,293,107,197,203,0.4925,0.4948805460750853,0.725,0.26,0.74,0.275,0.5882352941176471
0.164,400,"[[145, 148], [55, 52]]",145,55,148,55,200,200,293,107,197,203,0.4925,0.4948805460750853,0.725,0.26,0.74,0.275,0.5882352941176471
0.165,400,"[[145, 148], [55, 52]]",145,55,148,55,200,200,293,107,197,203,0.4925,0.4948805460750853,0.725,0.26,0.74,0.275,0.5882352941176471
0.166,400,"[[145, 147], [55, 53]]",145,55,147,55,200,200,292,108,198,202,0.495,0.4965753424657534,0.725,0.265,0.735,0.275,0.5894308943089431
0.167,400,"[[145, 147], [55, 53]]",145,55,147,55,200,200,292,108,198,202,0.495,0.4965753424657534,0.725,0.265,0.735,0.275,0.5894308943089431
0.168,400,"[[145, 146], [55, 54]]",145,55,146,55,200,200,291,109,199,201,0.4975,0.49828178694158076,0.725,0.27,0.73,0.275,0.5906313645621181
0.169,400,"[[145, 146], [55, 54]]",145,55,146,55,200,200,291,109,199,201,0.4975,0.49828178694158076,0.725,0.27,0.73,0.275,0.5906313645621181
0.17,400,"[[145, 145], [55, 55]]",145,55,145,55,200,200,290,110,200,200,0.5,0.5,0.725,0.275,0.725,0.275,0.5918367346938775
0.171,400,"[[145, 145], [55, 55]]",145,55,145,55,200,200,290,110,200,200,0.5,0.5,0.725,0.275,0.725,0.275,0.5918367346938775
0.172,400,"[[145, 145], [55, 55]]",145,55,145,55,200,200,290,110,200,200,0.5,0.5,0.725,0.275,0.725,0.275,0.5918367346938775
0.173,400,"[[145, 145], [55, 55]]",145,55,145,55,200,200,290,110,200,200,0.5,0.5,0.725,0.275,0.725,0.275,0.5918367346938775
0.174,400,"[[144, 144], [56, 56]]",144,56,144,56,200,200,288,112,200,200,0.5,0.5,0.72,0.28,0.72,0.28,0.5901639344262295
0.175,400,"[[144, 144], [56, 56]]",144,56,144,56,200,200,288,112,200,200,0.5,0.5,0.72,0.28,0.72,0.28,0.5901639344262295
0.176,400,"[[144, 144], [56, 56]]",144,56,144,56,200,200,288,112,200,200,0.5,0.5,0.72,0.28,0.72,0.28,0.5901639344262295
0.177,400,"[[144, 144], [56, 56]]",144,56,144,56,200,200,288,112,200,200,0.5,0.5,0.72,0.28,0.72,0.28,0.5901639344262295
0.178,400,"[[144, 144], [56, 56]]",144,56,144,56,200,200,288,112,200,200,0.5,0.5,0.72,0.28,0.72,0.28,0.5901639344262295
0.179,400,"[[144, 143], [56, 57]]",144,56,143,56,200,200,287,113,201,199,0.5025,0.5017421602787456,0.72,0.285,0.715,0.28,0.5913757700205338
0.18,400,"[[144, 142], [56, 58]]",144,56,142,56,200,200,286,114,202,198,0.505,0.5034965034965035,0.72,0.29,0.71,0.28,0.5925925925925927
0.181,400,"[[144, 142], [56, 58]]",144,56,142,56,200,200,286,114,202,198,0.505,0.5034965034965035,0.72,0.29,0.71,0.28,0.5925925925925927
0.182,400,"[[144, 142], [56, 58]]",144,56,142,56,200,200,286,114,202,198,0.505,0.5034965034965035,0.72,0.29,0.71,0.28,0.5925925925925927
0.183,400,"[[143, 142], [57, 58]]",143,57,142,57,200,200,285,115,201,199,0.5025,0.5017543859649123,0.715,0.29,0.71,0.285,0.5896907216494844
0.184,400,"[[142, 142], [58, 58]]",142,58,142,58,200,200,284,116,200,200,0.5,0.5,0.71,0.29,0.71,0.29,0.5867768595041322
0.185,400,"[[142, 141], [58, 59]]",142,58,141,58,200,200,283,117,201,199,0.5025,0.5017667844522968,0.71,0.295,0.705,0.29,0.5879917184265011
0.186,400,"[[141, 141], [59, 59]]",141,59,141,59,200,200,282,118,200,200,0.5,0.5,0.705,0.295,0.705,0.295,0.5850622406639003
0.187,400,"[[141, 141], [59, 59]]",141,59,141,59,200,200,282,118,200,200,0.5,0.5,0.705,0.295,0.705,0.295,0.5850622406639003
0.188,400,"[[141, 141], [59, 59]]",141,59,141,59,200,200,282,118,200,200,0.5,0.5,0.705,0.295,0.705,0.295,0.5850622406639003
0.189,400,"[[141, 141], [59, 59]]",141,59,141,59,200,200,282,118,200,200,0.5,0.5,0.705,0.295,0.705,0.295,0.5850622406639003
0.19,400,"[[141, 141], [59, 59]]",141,59,141,59,200,200,282,118,200,200,0.5,0.5,0.705,0.295,0.705,0.295,0.5850622406639003
0.191,400,"[[141, 141], [59, 59]]",141,59,141,59,200,200,282,118,200,200,0.5,0.5,0.705,0.295,0.705,0.295,0.5850622406639003
0.192,400,"[[140, 140], [60, 60]]",140,60,140,60,200,200,280,120,200,200,0.5,0.5,0.7,0.3,0.7,0.3,0.5833333333333334
0.193,400,"[[140, 139], [60, 61]]",140,60,139,60,200,200,279,121,201,199,0.5025,0.5017921146953405,0.7,0.305,0.695,0.3,0.5845511482254696
0.194,400,"[[140, 139], [60, 61]]",140,60,139,60,200,200,279,121,201,199,0.5025,0.5017921146953405,0.7,0.305,0.695,0.3,0.5845511482254696
0.195,400,"[[140, 139], [60, 61]]",140,60,139,60,200,200,279,121,201,199,0.5025,0.5017921146953405,0.7,0.305,0.695,0.3,0.5845511482254696
0.196,400,"[[140, 139], [60, 61]]",140,60,139,60,200,200,279,121,201,199,0.5025,0.5017921146953405,0.7,0.305,0.695,0.3,0.5845511482254696
0.197,400,"[[140, 139], [60, 61]]",140,60,139,60,200,200,279,121,201,199,0.5025,0.5017921146953405,0.7,0.305,0.695,0.3,0.5845511482254696
0.198,400,"[[140, 139], [60, 61]]",140,60,139,60,200,200,279,121,201,199,0.5025,0.5017921146953405,0.7,0.305,0.695,0.3,0.5845511482254696
0.199,400,"[[139, 139], [61, 61]]",139,61,139,61,200,200,278,122,200,200,0.5,0.5,0.695,0.305,0.695,0.305,0.5815899581589958
0.2,400,"[[139, 139], [61, 61]]",139,61,139,61,200,200,278,122,200,200,0.5,0.5,0.695,0.305,0.695,0.305,0.5815899581589958
0.201,400,"[[139, 139], [61, 61]]",139,61,139,61,200,200,278,122,200,200,0.5,0.5,0.695,0.305,0.695,0.305,0.5815899581589958
0.202,400,"[[139, 139], [61, 61]]",139,61,139,61,200,200,278,122,200,200,0.5,0.5,0.695,0.305,0.695,0.305,0.5815899581589958
0.203,400,"[[138, 139], [62, 61]]",138,62,139,62,200,200,277,123,199,201,0.4975,0.4981949458483754,0.69,0.305,0.695,0.31,0.5786163522012578
0.204,400,"[[138, 138], [62, 62]]",138,62,138,62,200,200,276,124,200,200,0.5,0.5,0.69,0.31,0.69,0.31,0.5798319327731092
0.205,400,"[[138, 138], [62, 62]]",138,62,138,62,200,200,276,124,200,200,0.5,0.5,0.69,0.31,0.69,0.31,0.5798319327731092
0.206,400,"[[138, 138], [62, 62]]",138,62,138,62,200,200,276,124,200,200,0.5,0.5,0.69,0.31,0.69,0.31,0.5798319327731092
0.207,400,"[[138, 138], [62, 62]]",138,62,138,62,200,200,276,124,200,200,0.5,0.5,0.69,0.31,0.69,0.31,0.5798319327731092
0.208,400,"[[138, 138], [62, 62]]",138,62,138,62,200,200,276,124,200,200,0.5,0.5,0.69,0.31,0.69,0.31,0.5798319327731092
0.209,400,"[[138, 138], [62, 62]]",138,62,138,62,200,200,276,124,200,200,0.5,0.5,0.69,0.31,0.69,0.31,0.5798319327731092
0.21,400,"[[138, 138], [62, 62]]",138,62,138,62,200,200,276,124,200,200,0.5,0.5,0.69,0.31,0.69,0.31,0.5798319327731092
0.211,400,"[[138, 138], [62, 62]]",138,62,138,62,200,200,276,124,200,200,0.5,0.5,0.69,0.31,0.69,0.31,0.5798319327731092
0.212,400,"[[138, 138], [62, 62]]",138,62,138,62,200,200,276,124,200,200,0.5,0.5,0.69,0.31,0.69,0.31,0.5798319327731092
0.213,400,"[[137, 138], [63, 62]]",137,63,138,63,200,200,275,125,199,201,0.4975,0.49818181818181817,0.685,0.31,0.69,0.315,0.5768421052631579
0.214,400,"[[137, 138], [63, 62]]",137,63,138,63,200,200,275,125,199,201,0.4975,0.49818181818181817,0.685,0.31,0.69,0.315,0.5768421052631579
0.215,400,"[[137, 138], [63, 62]]",137,63,138,63,200,200,275,125,199,201,0.4975,0.49818181818181817,0.685,0.31,0.69,0.315,0.5768421052631579
0.216,400,"[[136, 138], [64, 62]]",136,64,138,64,200,200,274,126,198,202,0.495,0.49635036496350365,0.68,0.31,0.69,0.32,0.5738396624472574
0.217,400,"[[136, 138], [64, 62]]",136,64,138,64,200,200,274,126,198,202,0.495,0.49635036496350365,0.68,0.31,0.69,0.32,0.5738396624472574
0.218,400,"[[129, 138], [71, 62]]",129,71,138,71,200,200,267,133,191,209,0.4775,0.48314606741573035,0.645,0.31,0.69,0.355,0.5524625267665952
0.219,400,"[[129, 137], [71, 63]]",129,71,137,71,200,200,266,134,192,208,0.48,0.4849624060150376,0.645,0.315,0.685,0.355,0.553648068669528
0.22,400,"[[129, 137], [71, 63]]",129,71,137,71,200,200,266,134,192,208,0.48,0.4849624060150376,0.645,0.315,0.685,0.355,0.553648068669528
0.221,400,"[[129, 137], [71, 63]]",129,71,137,71,200,200,266,134,192,208,0.48,0.4849624060150376,0.645,0.315,0.685,0.355,0.553648068669528
0.222,400,"[[129, 135], [71, 65]]",129,71,135,71,200,200,264,136,194,206,0.485,0.48863636363636365,0.645,0.325,0.675,0.355,0.5560344827586207
0.223,400,"[[122, 135], [78, 65]]",122,78,135,78,200,200,257,143,187,213,0.4675,0.47470817120622566,0.61,0.325,0.675,0.39,0.5339168490153172
0.224,400,"[[118, 134], [82, 66]]",118,82,134,82,200,200,252,148,184,216,0.46,0.46825396825396826,0.59,0.33,0.67,0.41,0.5221238938053098
0.225,400,"[[118, 133], [82, 67]]",118,82,133,82,200,200,251,149,185,215,0.4625,0.4701195219123506,0.59,0.335,0.665,0.41,0.5232815964523283
0.226,400,"[[117, 133], [83, 67]]",117,83,133,83,200,200,250,150,184,216,0.46,0.468,0.585,0.335,0.665,0.415,0.5200000000000001
0.227,400,"[[117, 133], [83, 67]]",117,83,133,83,200,200,250,150,184,216,0.46,0.468,0.585,0.335,0.665,0.415,0.5200000000000001
0.228,400,"[[116, 133], [84, 67]]",116,84,133,84,200,200,249,151,183,217,0.4575,0.46586345381526106,0.58,0.335,0.665,0.42,0.5167037861915367
0.229,400,"[[116, 133], [84, 67]]",116,84,133,84,200,200,249,151,183,217,0.4575,0.46586345381526106,0.58,0.335,0.665,0.42,0.5167037861915367
0.23,400,"[[116, 133], [84, 67]]",116,84,133,84,200,200,249,151,183,217,0.4575,0.46586345381526106,0.58,0.335,0.665,0.42,0.5167037861915367
0.231,400,"[[116, 132], [84, 68]]",116,84,132,84,200,200,248,152,184,216,0.46,0.46774193548387094,0.58,0.34,0.66,0.42,0.5178571428571428
0.232,400,"[[116, 132], [84, 68]]",116,84,132,84,200,200,248,152,184,216,0.46,0.46774193548387094,0.58,0.34,0.66,0.42,0.5178571428571428
0.233,400,"[[114, 132], [86, 68]]",114,86,132,86,200,200,246,154,182,218,0.455,0.4634146341463415,0.57,0.34,0.66,0.43,0.5112107623318386
0.234,400,"[[114, 131], [86, 69]]",114,86,131,86,200,200,245,155,183,217,0.4575,0.46530612244897956,0.57,0.345,0.655,0.43,0.5123595505617977
0.235,400,"[[114, 131], [86, 69]]",114,86,131,86,200,200,245,155,183,217,0.4575,0.46530612244897956,0.57,0.345,0.655,0.43,0.5123595505617977
0.236,400,"[[114, 130], [86, 70]]",114,86,130,86,200,200,244,156,184,216,0.46,0.4672131147540984,0.57,0.35,0.65,0.43,0.5135135135135135
0.237,400,"[[114, 129], [86, 71]]",114,86,129,86,200,200,243,157,185,215,0.4625,0.4691358024691358,0.57,0.355,0.645,0.43,0.5146726862302483
0.238,400,"[[114, 129], [86, 71]]",114,86,129,86,200,200,243,157,185,215,0.4625,0.4691358024691358,0.57,0.355,0.645,0.43,0.5146726862302483
0.239,400,"[[114, 129], [86, 71]]",114,86,129,86,200,200,243,157,185,215,0.4625,0.4691358024691358,0.57,0.355,0.645,0.43,0.5146726862302483
0.24,400,"[[114, 129], [86, 71]]",114,86,129,86,200,200,243,157,185,215,0.4625,0.4691358024691358,0.57,0.355,0.645,0.43,0.5146726862302483
0.241,400,"[[114, 129], [86, 71]]",114,86,129,86,200,200,243,157,185,215,0.4625,0.4691358024691358,0.57,0.355,0.645,0.43,0.5146726862302483
0.242,400,"[[114, 129], [86, 71]]",114,86,129,86,200,200,243,157,185,215,0.4625,0.4691358024691358,0.57,0.355,0.645,0.43,0.5146726862302483
0.243,400,"[[114, 129], [86, 71]]",114,86,129,86,200,200,243,157,185,215,0.4625,0.4691358024691358,0.57,0.355,0.645,0.43,0.5146726862302483
0.244,400,"[[114, 129], [86, 71]]",114,86,129,86,200,200,243,157,185,215,0.4625,0.4691358024691358,0.57,0.355,0.645,0.43,0.5146726862302483
0.245,400,"[[113, 129], [87, 71]]",113,87,129,87,200,200,242,158,184,216,0.46,0.4669421487603306,0.565,0.355,0.645,0.435,0.51131221719457
0.246,400,"[[112, 129], [88, 71]]",112,88,129,88,200,200,241,159,183,217,0.4575,0.46473029045643155,0.56,0.355,0.645,0.44,0.5079365079365079
0.247,400,"[[112, 129], [88, 71]]",112,88,129,88,200,200,241,159,183,217,0.4575,0.46473029045643155,0.56,0.355,0.645,0.44,0.5079365079365079
0.248,400,"[[112, 129], [88, 71]]",112,88,129,88,200,200,241,159,183,217,0.4575,0.46473029045643155,0.56,0.355,0.645,0.44,0.5079365079365079
0.249,400,"[[112, 129], [88, 71]]",112,88,129,88,200,200,241,159,183,217,0.4575,0.46473029045643155,0.56,0.355,0.645,0.44,0.5079365079365079
0.25,400,"[[112, 129], [88, 71]]",112,88,129,88,200,200,241,159,183,217,0.4575,0.46473029045643155,0.56,0.355,0.645,0.44,0.5079365079365079
0.251,400,"[[112, 129], [88, 71]]",112,88,129,88,200,200,241,159,183,217,0.4575,0.46473029045643155,0.56,0.355,0.645,0.44,0.5079365079365079
0.252,400,"[[112, 128], [88, 72]]",112,88,128,88,200,200,240,160,184,216,0.46,0.4666666666666667,0.56,0.36,0.64,0.44,0.509090909090909
0.253,400,"[[112, 128], [88, 72]]",112,88,128,88,200,200,240,160,184,216,0.46,0.4666666666666667,0.56,0.36,0.64,0.44,0.509090909090909
0.254,400,"[[112, 128], [88, 72]]",112,88,128,88,200,200,240,160,184,216,0.46,0.4666666666666667,0.56,0.36,0.64,0.44,0.509090909090909
0.255,400,"[[112, 127], [88, 73]]",112,88,127,88,200,200,239,161,185,215,0.4625,0.4686192468619247,0.56,0.365,0.635,0.44,0.510250569476082
0.256,400,"[[112, 127], [88, 73]]",112,88,127,88,200,200,239,161,185,215,0.4625,0.4686192468619247,0.56,0.365,0.635,0.44,0.510250569476082
0.257,400,"[[112, 127], [88, 73]]",112,88,127,88,200,200,239,161,185,215,0.4625,0.4686192468619247,0.56,0.365,0.635,0.44,0.510250569476082
0.258,400,"[[112, 126], [88, 74]]",112,88,126,88,200,200,238,162,186,214,0.465,0.47058823529411764,0.56,0.37,0.63,0.44,0.5114155251141552
0.259,400,"[[111, 126], [89, 74]]",111,89,126,89,200,200,237,163,185,215,0.4625,0.46835443037974683,0.555,0.37,0.63,0.445,0.5080091533180779
0.26,400,"[[111, 126], [89, 74]]",111,89,126,89,200,200,237,163,185,215,0.4625,0.46835443037974683,0.555,0.37,0.63,0.445,0.5080091533180779
0.261,400,"[[111, 125], [89, 75]]",111,89,125,89,200,200,236,164,186,214,0.465,0.4703389830508475,0.555,0.375,0.625,0.445,0.5091743119266056
0.262,400,"[[111, 125], [89, 75]]",111,89,125,89,200,200,236,164,186,214,0.465,0.4703389830508475,0.555,0.375,0.625,0.445,0.5091743119266056
0.263,400,"[[111, 124], [89, 76]]",111,89,124,89,200,200,235,165,187,213,0.4675,0.4723404255319149,0.555,0.38,0.62,0.445,0.5103448275862069
0.264,400,"[[110, 124], [90, 76]]",110,90,124,90,200,200,234,166,186,214,0.465,0.4700854700854701,0.55,0.38,0.62,0.45,0.5069124423963135
0.265,400,"[[106, 124], [94, 76]]",106,94,124,94,200,200,230,170,182,218,0.455,0.4608695652173913,0.53,0.38,0.62,0.47,0.49302325581395345
0.266,400,"[[106, 124], [94, 76]]",106,94,124,94,200,200,230,170,182,218,0.455,0.4608695652173913,0.53,0.38,0.62,0.47,0.49302325581395345
0.267,400,"[[106, 124], [94, 76]]",106,94,124,94,200,200,230,170,182,218,0.455,0.4608695652173913,0.53,0.38,0.62,0.47,0.49302325581395345
0.268,400,"[[106, 124], [94, 76]]",106,94,124,94,200,200,230,170,182,218,0.455,0.4608695652173913,0.53,0.38,0.62,0.47,0.49302325581395345
0.269,400,"[[106, 124], [94, 76]]",106,94,124,94,200,200,230,170,182,218,0.455,0.4608695652173913,0.53,0.38,0.62,0.47,0.49302325581395345
0.27,400,"[[106, 123], [94, 77]]",106,94,123,94,200,200,229,171,183,217,0.4575,0.462882096069869,0.53,0.385,0.615,0.47,0.4941724941724942
0.271,400,"[[106, 123], [94, 77]]",106,94,123,94,200,200,229,171,183,217,0.4575,0.462882096069869,0.53,0.385,0.615,0.47,0.4941724941724942
0.272,400,"[[106, 123], [94, 77]]",106,94,123,94,200,200,229,171,183,217,0.4575,0.462882096069869,0.53,0.385,0.615,0.47,0.4941724941724942
0.273,400,"[[106, 123], [94, 77]]",106,94,123,94,200,200,229,171,183,217,0.4575,0.462882096069869,0.53,0.385,0.615,0.47,0.4941724941724942
0.274,400,"[[106, 123], [94, 77]]",106,94,123,94,200,200,229,171,183,217,0.4575,0.462882096069869,0.53,0.385,0.615,0.47,0.4941724941724942
0.275,400,"[[106, 123], [94, 77]]",106,94,123,94,200,200,229,171,183,217,0.4575,0.462882096069869,0.53,0.385,0.615,0.47,0.4941724941724942
0.276,400,"[[106, 123], [94, 77]]",106,94,123,94,200,200,229,171,183,217,0.4575,0.462882096069869,0.53,0.385,0.615,0.47,0.4941724941724942
0.277,400,"[[106, 123], [94, 77]]",106,94,123,94,200,200,229,171,183,217,0.4575,0.462882096069869,0.53,0.385,0.615,0.47,0.4941724941724942
0.278,400,"[[106, 123], [94, 77]]",106,94,123,94,200,200,229,171,183,217,0.4575,0.462882096069869,0.53,0.385,0.615,0.47,0.4941724941724942
0.279,400,"[[106, 123], [94, 77]]",106,94,123,94,200,200,229,171,183,217,0.4575,0.462882096069869,0.53,0.385,0.615,0.47,0.4941724941724942
0.28,400,"[[106, 123], [94, 77]]",106,94,123,94,200,200,229,171,183,217,0.4575,0.462882096069869,0.53,0.385,0.615,0.47,0.4941724941724942
0.281,400,"[[106, 123], [94, 77]]",106,94,123,94,200,200,229,171,183,217,0.4575,0.462882096069869,0.53,0.385,0.615,0.47,0.4941724941724942
0.282,400,"[[106, 122], [94, 78]]",106,94,122,94,200,200,228,172,184,216,0.46,0.4649122807017544,0.53,0.39,0.61,0.47,0.4953271028037384
0.283,400,"[[106, 122], [94, 78]]",106,94,122,94,200,200,228,172,184,216,0.46,0.4649122807017544,0.53,0.39,0.61,0.47,0.4953271028037384
0.284,400,"[[106, 122], [94, 78]]",106,94,122,94,200,200,228,172,184,216,0.46,0.4649122807017544,0.53,0.39,0.61,0.47,0.4953271028037384
0.285,400,"[[106, 122], [94, 78]]",106,94,122,94,200,200,228,172,184,216,0.46,0.4649122807017544,0.53,0.39,0.61,0.47,0.4953271028037384
0.286,400,"[[106, 122], [94, 78]]",106,94,122,94,200,200,228,172,184,216,0.46,0.4649122807017544,0.53,0.39,0.61,0.47,0.4953271028037384
0.287,400,"[[106, 122], [94, 78]]",106,94,122,94,200,200,228,172,184,216,0.46,0.4649122807017544,0.53,0.39,0.61,0.47,0.4953271028037384
0.288,400,"[[106, 122], [94, 78]]",106,94,122,94,200,200,228,172,184,216,0.46,0.4649122807017544,0.53,0.39,0.61,0.47,0.4953271028037384
0.289,400,"[[106, 122], [94, 78]]",106,94,122,94,200,200,228,172,184,216,0.46,0.4649122807017544,0.53,0.39,0.61,0.47,0.4953271028037384
0.29,400,"[[106, 122], [94, 78]]",106,94,122,94,200,200,228,172,184,216,0.46,0.4649122807017544,0.53,0.39,0.61,0.47,0.4953271028037384
0.291,400,"[[106, 122], [94, 78]]",106,94,122,94,200,200,228,172,184,216,0.46,0.4649122807017544,0.53,0.39,0.61,0.47,0.4953271028037384
0.292,400,"[[106, 122], [94, 78]]",106,94,122,94,200,200,228,172,184,216,0.46,0.4649122807017544,0.53,0.39,0.61,0.47,0.4953271028037384
0.293,400,"[[105, 122], [95, 78]]",105,95,122,95,200,200,227,173,183,217,0.4575,0.46255506607929514,0.525,0.39,0.61,0.475,0.49180327868852464
0.294,400,"[[105, 122], [95, 78]]",105,95,122,95,200,200,227,173,183,217,0.4575,0.46255506607929514,0.525,0.39,0.61,0.475,0.49180327868852464
0.295,400,"[[105, 121], [95, 79]]",105,95,121,95,200,200,226,174,184,216,0.46,0.4646017699115044,0.525,0.395,0.605,0.475,0.4929577464788732
0.296,400,"[[105, 121], [95, 79]]",105,95,121,95,200,200,226,174,184,216,0.46,0.4646017699115044,0.525,0.395,0.605,0.475,0.4929577464788732
0.297,400,"[[105, 121], [95, 79]]",105,95,121,95,200,200,226,174,184,216,0.46,0.4646017699115044,0.525,0.395,0.605,0.475,0.4929577464788732
0.298,400,"[[105, 120], [95, 80]]",105,95,120,95,200,200,225,175,185,215,0.4625,0.4666666666666667,0.525,0.4,0.6,0.475,0.49411764705882355
0.299,400,"[[104, 120], [96, 80]]",104,96,120,96,200,200,224,176,184,216,0.46,0.4642857142857143,0.52,0.4,0.6,0.48,0.49056603773584906
0.3,400,"[[104, 120], [96, 80]]",104,96,120,96,200,200,224,176,184,216,0.46,0.4642857142857143,0.52,0.4,0.6,0.48,0.49056603773584906
0.301,400,"[[103, 120], [97, 80]]",103,97,120,97,200,200,223,177,183,217,0.4575,0.4618834080717489,0.515,0.4,0.6,0.485,0.48699763593380613
0.302,400,"[[103, 120], [97, 80]]",103,97,120,97,200,200,223,177,183,217,0.4575,0.4618834080717489,0.515,0.4,0.6,0.485,0.48699763593380613
0.303,400,"[[103, 120], [97, 80]]",103,97,120,97,200,200,223,177,183,217,0.4575,0.4618834080717489,0.515,0.4,0.6,0.485,0.48699763593380613
0.304,400,"[[103, 120], [97, 80]]",103,97,120,97,200,200,223,177,183,217,0.4575,0.4618834080717489,0.515,0.4,0.6,0.485,0.48699763593380613
0.305,400,"[[103, 120], [97, 80]]",103,97,120,97,200,200,223,177,183,217,0.4575,0.4618834080717489,0.515,0.4,0.6,0.485,0.48699763593380613
0.306,400,"[[103, 120], [97, 80]]",103,97,120,97,200,200,223,177,183,217,0.4575,0.4618834080717489,0.515,0.4,0.6,0.485,0.48699763593380613
0.307,400,"[[103, 117], [97, 83]]",103,97,117,97,200,200,220,180,186,214,0.465,0.4681818181818182,0.515,0.415,0.585,0.485,0.49047619047619057
0.308,400,"[[103, 117], [97, 83]]",103,97,117,97,200,200,220,180,186,214,0.465,0.4681818181818182,0.515,0.415,0.585,0.485,0.49047619047619057
0.309,400,"[[102, 117], [98, 83]]",102,98,117,98,200,200,219,181,185,215,0.4625,0.4657534246575342,0.51,0.415,0.585,0.49,0.4868735083532219
0.31,400,"[[102, 117], [98, 83]]",102,98,117,98,200,200,219,181,185,215,0.4625,0.4657534246575342,0.51,0.415,0.585,0.49,0.4868735083532219
0.311,400,"[[102, 117], [98, 83]]",102,98,117,98,200,200,219,181,185,215,0.4625,0.4657534246575342,0.51,0.415,0.585,0.49,0.4868735083532219
0.312,400,"[[102, 117], [98, 83]]",102,98,117,98,200,200,219,181,185,215,0.4625,0.4657534246575342,0.51,0.415,0.585,0.49,0.4868735083532219
0.313,400,"[[102, 117], [98, 83]]",102,98,117,98,200,200,219,181,185,215,0.4625,0.4657534246575342,0.51,0.415,0.585,0.49,0.4868735083532219
0.314,400,"[[102, 117], [98, 83]]",102,98,117,98,200,200,219,181,185,215,0.4625,0.4657534246575342,0.51,0.415,0.585,0.49,0.4868735083532219
0.315,400,"[[102, 117], [98, 83]]",102,98,117,98,200,200,219,181,185,215,0.4625,0.4657534246575342,0.51,0.415,0.585,0.49,0.4868735083532219
0.316,400,"[[102, 116], [98, 84]]",102,98,116,98,200,200,218,182,186,214,0.465,0.46788990825688076,0.51,0.42,0.58,0.49,0.48803827751196166
0.317,400,"[[102, 115], [98, 85]]",102,98,115,98,200,200,217,183,187,213,0.4675,0.4700460829493088,0.51,0.425,0.575,0.49,0.48920863309352525
0.318,400,"[[102, 115], [98, 85]]",102,98,115,98,200,200,217,183,187,213,0.4675,0.4700460829493088,0.51,0.425,0.575,0.49,0.48920863309352525
0.319,400,"[[102, 114], [98, 86]]",102,98,114,98,200,200,216,184,188,212,0.47,0.4722222222222222,0.51,0.43,0.57,0.49,0.4903846153846154
0.32,400,"[[102, 114], [98, 86]]",102,98,114,98,200,200,216,184,188,212,0.47,0.4722222222222222,0.51,0.43,0.57,0.49,0.4903846153846154
0.321,400,"[[102, 114], [98, 86]]",102,98,114,98,200,200,216,184,188,212,0.47,0.4722222222222222,0.51,0.43,0.57,0.49,0.4903846153846154
0.322,400,"[[102, 113], [98, 87]]",102,98,113,98,200,200,215,185,189,211,0.4725,0.4744186046511628,0.51,0.435,0.565,0.49,0.491566265060241
0.323,400,"[[102, 113], [98, 87]]",102,98,113,98,200,200,215,185,189,211,0.4725,0.4744186046511628,0.51,0.435,0.565,0.49,0.491566265060241
0.324,400,"[[102, 113], [98, 87]]",102,98,113,98,200,200,215,185,189,211,0.4725,0.4744186046511628,0.51,0.435,0.565,0.49,0.491566265060241
0.325,400,"[[102, 113], [98, 87]]",102,98,113,98,200,200,215,185,189,211,0.4725,0.4744186046511628,0.51,0.435,0.565,0.49,0.491566265060241
0.326,400,"[[102, 112], [98, 88]]",102,98,112,98,200,200,214,186,190,210,0.475,0.4766355140186916,0.51,0.44,0.56,0.49,0.4927536231884058
0.327,400,"[[102, 112], [98, 88]]",102,98,112,98,200,200,214,186,190,210,0.475,0.4766355140186916,0.51,0.44,0.56,0.49,0.4927536231884058
0.328,400,"[[102, 112], [98, 88]]",102,98,112,98,200,200,214,186,190,210,0.475,0.4766355140186916,0.51,0.44,0.56,0.49,0.4927536231884058
0.329,400,"[[102, 112], [98, 88]]",102,98,112,98,200,200,214,186,190,210,0.475,0.4766355140186916,0.51,0.44,0.56,0.49,0.4927536231884058
0.33,400,"[[102, 112], [98, 88]]",102,98,112,98,200,200,214,186,190,210,0.475,0.4766355140186916,0.51,0.44,0.56,0.49,0.4927536231884058
0.331,400,"[[102, 112], [98, 88]]",102,98,112,98,200,200,214,186,190,210,0.475,0.4766355140186916,0.51,0.44,0.56,0.49,0.4927536231884058
0.332,400,"[[101, 112], [99, 88]]",101,99,112,99,200,200,213,187,189,211,0.4725,0.47417840375586856,0.505,0.44,0.56,0.495,0.4891041162227603
0.333,400,"[[101, 112], [99, 88]]",101,99,112,99,200,200,213,187,189,211,0.4725,0.47417840375586856,0.505,0.44,0.56,0.495,0.4891041162227603
0.334,400,"[[101, 112], [99, 88]]",101,99,112,99,200,200,213,187,189,211,0.4725,0.47417840375586856,0.505,0.44,0.56,0.495,0.4891041162227603
0.335,400,"[[101, 112], [99, 88]]",101,99,112,99,200,200,213,187,189,211,0.4725,0.47417840375586856,0.505,0.44,0.56,0.495,0.4891041162227603
0.336,400,"[[101, 112], [99, 88]]",101,99,112,99,200,200,213,187,189,211,0.4725,0.47417840375586856,0.505,0.44,0.56,0.495,0.4891041162227603
0.337,400,"[[101, 112], [99, 88]]",101,99,112,99,200,200,213,187,189,211,0.4725,0.47417840375586856,0.505,0.44,0.56,0.495,0.4891041162227603
0.338,400,"[[100, 112], [100, 88]]",100,100,112,100,200,200,212,188,188,212,0.47,0.4716981132075472,0.5,0.44,0.56,0.5,0.4854368932038835
0.339,400,"[[100, 112], [100, 88]]",100,100,112,100,200,200,212,188,188,212,0.47,0.4716981132075472,0.5,0.44,0.56,0.5,0.4854368932038835
0.34,400,"[[100, 112], [100, 88]]",100,100,112,100,200,200,212,188,188,212,0.47,0.4716981132075472,0.5,0.44,0.56,0.5,0.4854368932038835
0.341,400,"[[100, 112], [100, 88]]",100,100,112,100,200,200,212,188,188,212,0.47,0.4716981132075472,0.5,0.44,0.56,0.5,0.4854368932038835
0.342,400,"[[99, 112], [101, 88]]",99,101,112,101,200,200,211,189,187,213,0.4675,0.46919431279620855,0.495,0.44,0.56,0.505,0.48175182481751827
0.343,400,"[[99, 112], [101, 88]]",99,101,112,101,200,200,211,189,187,213,0.4675,0.46919431279620855,0.495,0.44,0.56,0.505,0.48175182481751827
0.344,400,"[[99, 112], [101, 88]]",99,101,112,101,200,200,211,189,187,213,0.4675,0.46919431279620855,0.495,0.44,0.56,0.505,0.48175182481751827
0.345,400,"[[99, 112], [101, 88]]",99,101,112,101,200,200,211,189,187,213,0.4675,0.46919431279620855,0.495,0.44,0.56,0.505,0.48175182481751827
0.346,400,"[[99, 112], [101, 88]]",99,101,112,101,200,200,211,189,187,213,0.4675,0.46919431279620855,0.495,0.44,0.56,0.505,0.48175182481751827
0.347,400,"[[99, 111], [101, 89]]",99,101,111,101,200,200,210,190,188,212,0.47,0.4714285714285714,0.495,0.445,0.555,0.505,0.48292682926829267
0.348,400,"[[99, 111], [101, 89]]",99,101,111,101,200,200,210,190,188,212,0.47,0.4714285714285714,0.495,0.445,0.555,0.505,0.48292682926829267
0.349,400,"[[99, 110], [101, 90]]",99,101,110,101,200,200,209,191,189,211,0.4725,0.47368421052631576,0.495,0.45,0.55,0.505,0.48410757946210264
0.35,400,"[[99, 110], [101, 90]]",99,101,110,101,200,200,209,191,189,211,0.4725,0.47368421052631576,0.495,0.45,0.55,0.505,0.48410757946210264
0.351,400,"[[99, 110], [101, 90]]",99,101,110,101,200,200,209,191,189,211,0.4725,0.47368421052631576,0.495,0.45,0.55,0.505,0.48410757946210264
0.352,400,"[[99, 109], [101, 91]]",99,101,109,101,200,200,208,192,190,210,0.475,0.47596153846153844,0.495,0.455,0.545,0.505,0.4852941176470588
0.353,400,"[[99, 109], [101, 91]]",99,101,109,101,200,200,208,192,190,210,0.475,0.47596153846153844,0.495,0.455,0.545,0.505,0.4852941176470588
0.354,400,"[[99, 109], [101, 91]]",99,101,109,101,200,200,208,192,190,210,0.475,0.47596153846153844,0.495,0.455,0.545,0.505,0.4852941176470588
0.355,400,"[[99, 109], [101, 91]]",99,101,109,101,200,200,208,192,190,210,0.475,0.47596153846153844,0.495,0.455,0.545,0.505,0.4852941176470588
0.356,400,"[[99, 109], [101, 91]]",99,101,109,101,200,200,208,192,190,210,0.475,0.47596153846153844,0.495,0.455,0.545,0.505,0.4852941176470588
0.357,400,"[[99, 109], [101, 91]]",99,101,109,101,200,200,208,192,190,210,0.475,0.47596153846153844,0.495,0.455,0.545,0.505,0.4852941176470588
0.358,400,"[[99, 109], [101, 91]]",99,101,109,101,200,200,208,192,190,210,0.475,0.47596153846153844,0.495,0.455,0.545,0.505,0.4852941176470588
0.359,400,"[[99, 109], [101, 91]]",99,101,109,101,200,200,208,192,190,210,0.475,0.47596153846153844,0.495,0.455,0.545,0.505,0.4852941176470588
0.36,400,"[[99, 109], [101, 91]]",99,101,109,101,200,200,208,192,190,210,0.475,0.47596153846153844,0.495,0.455,0.545,0.505,0.4852941176470588
0.361,400,"[[99, 109], [101, 91]]",99,101,109,101,200,200,208,192,190,210,0.475,0.47596153846153844,0.495,0.455,0.545,0.505,0.4852941176470588
0.362,400,"[[99, 109], [101, 91]]",99,101,109,101,200,200,208,192,190,210,0.475,0.47596153846153844,0.495,0.455,0.545,0.505,0.4852941176470588
0.363,400,"[[99, 109], [101, 91]]",99,101,109,101,200,200,208,192,190,210,0.475,0.47596153846153844,0.495,0.455,0.545,0.505,0.4852941176470588
0.364,400,"[[99, 109], [101, 91]]",99,101,109,101,200,200,208,192,190,210,0.475,0.47596153846153844,0.495,0.455,0.545,0.505,0.4852941176470588
0.365,400,"[[99, 109], [101, 91]]",99,101,109,101,200,200,208,192,190,210,0.475,0.47596153846153844,0.495,0.455,0.545,0.505,0.4852941176470588
0.366,400,"[[99, 109], [101, 91]]",99,101,109,101,200,200,208,192,190,210,0.475,0.47596153846153844,0.495,0.455,0.545,0.505,0.4852941176470588
0.367,400,"[[99, 109], [101, 91]]",99,101,109,101,200,200,208,192,190,210,0.475,0.47596153846153844,0.495,0.455,0.545,0.505,0.4852941176470588
0.368,400,"[[99, 109], [101, 91]]",99,101,109,101,200,200,208,192,190,210,0.475,0.47596153846153844,0.495,0.455,0.545,0.505,0.4852941176470588
0.369,400,"[[99, 109], [101, 91]]",99,101,109,101,200,200,208,192,190,210,0.475,0.47596153846153844,0.495,0.455,0.545,0.505,0.4852941176470588
0.37,400,"[[99, 109], [101, 91]]",99,101,109,101,200,200,208,192,190,210,0.475,0.47596153846153844,0.495,0.455,0.545,0.505,0.4852941176470588
0.371,400,"[[99, 108], [101, 92]]",99,101,108,101,200,200,207,193,191,209,0.4775,0.4782608695652174,0.495,0.46,0.54,0.505,0.4864864864864865
0.372,400,"[[99, 108], [101, 92]]",99,101,108,101,200,200,207,193,191,209,0.4775,0.4782608695652174,0.495,0.46,0.54,0.505,0.4864864864864865
0.373,400,"[[99, 108], [101, 92]]",99,101,108,101,200,200,207,193,191,209,0.4775,0.4782608695652174,0.495,0.46,0.54,0.505,0.4864864864864865
0.374,400,"[[99, 108], [101, 92]]",99,101,108,101,200,200,207,193,191,209,0.4775,0.4782608695652174,0.495,0.46,0.54,0.505,0.4864864864864865
0.375,400,"[[99, 108], [101, 92]]",99,101,108,101,200,200,207,193,191,209,0.4775,0.4782608695652174,0.495,0.46,0.54,0.505,0.4864864864864865
0.376,400,"[[99, 107], [101, 93]]",99,101,107,101,200,200,206,194,192,208,0.48,0.48058252427184467,0.495,0.465,0.535,0.505,0.4876847290640394
0.377,400,"[[99, 107], [101, 93]]",99,101,107,101,200,200,206,194,192,208,0.48,0.48058252427184467,0.495,0.465,0.535,0.505,0.4876847290640394
0.378,400,"[[99, 107], [101, 93]]",99,101,107,101,200,200,206,194,192,208,0.48,0.48058252427184467,0.495,0.465,0.535,0.505,0.4876847290640394
0.379,400,"[[99, 107], [101, 93]]",99,101,107,101,200,200,206,194,192,208,0.48,0.48058252427184467,0.495,0.465,0.535,0.505,0.4876847290640394
0.38,400,"[[99, 107], [101, 93]]",99,101,107,101,200,200,206,194,192,208,0.48,0.48058252427184467,0.495,0.465,0.535,0.505,0.4876847290640394
0.381,400,"[[99, 107], [101, 93]]",99,101,107,101,200,200,206,194,192,208,0.48,0.48058252427184467,0.495,0.465,0.535,0.505,0.4876847290640394
0.382,400,"[[99, 107], [101, 93]]",99,101,107,101,200,200,206,194,192,208,0.48,0.48058252427184467,0.495,0.465,0.535,0.505,0.4876847290640394
0.383,400,"[[99, 107], [101, 93]]",99,101,107,101,200,200,206,194,192,208,0.48,0.48058252427184467,0.495,0.465,0.535,0.505,0.4876847290640394
0.384,400,"[[99, 107], [101, 93]]",99,101,107,101,200,200,206,194,192,208,0.48,0.48058252427184467,0.495,0.465,0.535,0.505,0.4876847290640394
0.385,400,"[[99, 107], [101, 93]]",99,101,107,101,200,200,206,194,192,208,0.48,0.48058252427184467,0.495,0.465,0.535,0.505,0.4876847290640394
0.386,400,"[[99, 107], [101, 93]]",99,101,107,101,200,200,206,194,192,208,0.48,0.48058252427184467,0.495,0.465,0.535,0.505,0.4876847290640394
0.387,400,"[[99, 106], [101, 94]]",99,101,106,101,200,200,205,195,193,207,0.4825,0.48292682926829267,0.495,0.47,0.53,0.505,0.4888888888888889
0.388,400,"[[99, 106], [101, 94]]",99,101,106,101,200,200,205,195,193,207,0.4825,0.48292682926829267,0.495,0.47,0.53,0.505,0.4888888888888889
0.389,400,"[[99, 106], [101, 94]]",99,101,106,101,200,200,205,195,193,207,0.4825,0.48292682926829267,0.495,0.47,0.53,0.505,0.4888888888888889
0.39,400,"[[99, 105], [101, 95]]",99,101,105,101,200,200,204,196,194,206,0.485,0.4852941176470588,0.495,0.475,0.525,0.505,0.4900990099009901
0.391,400,"[[99, 104], [101, 96]]",99,101,104,101,200,200,203,197,195,205,0.4875,0.4876847290640394,0.495,0.48,0.52,0.505,0.4913151364764268
0.392,400,"[[99, 104], [101, 96]]",99,101,104,101,200,200,203,197,195,205,0.4875,0.4876847290640394,0.495,0.48,0.52,0.505,0.4913151364764268
0.393,400,"[[99, 104], [101, 96]]",99,101,104,101,200,200,203,197,195,205,0.4875,0.4876847290640394,0.495,0.48,0.52,0.505,0.4913151364764268
0.394,400,"[[99, 103], [101, 97]]",99,101,103,101,200,200,202,198,196,204,0.49,0.4900990099009901,0.495,0.485,0.515,0.505,0.4925373134328358
0.395,400,"[[99, 103], [101, 97]]",99,101,103,101,200,200,202,198,196,204,0.49,0.4900990099009901,0.495,0.485,0.515,0.505,0.4925373134328358
0.396,400,"[[99, 103], [101, 97]]",99,101,103,101,200,200,202,198,196,204,0.49,0.4900990099009901,0.495,0.485,0.515,0.505,0.4925373134328358
0.397,400,"[[99, 102], [101, 98]]",99,101,102,101,200,200,201,199,197,203,0.4925,0.4925373134328358,0.495,0.49,0.51,0.505,0.4937655860349127
0.398,400,"[[99, 102], [101, 98]]",99,101,102,101,200,200,201,199,197,203,0.4925,0.4925373134328358,0.495,0.49,0.51,0.505,0.4937655860349127
0.399,400,"[[99, 102], [101, 98]]",99,101,102,101,200,200,201,199,197,203,0.4925,0.4925373134328358,0.495,0.49,0.51,0.505,0.4937655860349127
0.4,400,"[[99, 102], [101, 98]]",99,101,102,101,200,200,201,199,197,203,0.4925,0.4925373134328358,0.495,0.49,0.51,0.505,0.4937655860349127
0.401,400,"[[98, 101], [102, 99]]",98,102,101,102,200,200,199,201,197,203,0.4925,0.49246231155778897,0.49,0.495,0.505,0.51,0.49122807017543857
0.402,400,"[[98, 101], [102, 99]]",98,102,101,102,200,200,199,201,197,203,0.4925,0.49246231155778897,0.49,0.495,0.505,0.51,0.49122807017543857
0.403,400,"[[98, 101], [102, 99]]",98,102,101,102,200,200,199,201,197,203,0.4925,0.49246231155778897,0.49,0.495,0.505,0.51,0.49122807017543857
0.404,400,"[[98, 101], [102, 99]]",98,102,101,102,200,200,199,201,197,203,0.4925,0.49246231155778897,0.49,0.495,0.505,0.51,0.49122807017543857
0.405,400,"[[98, 100], [102, 100]]",98,102,100,102,200,200,198,202,198,202,0.495,0.494949494949495,0.49,0.5,0.5,0.51,0.4924623115577889
0.406,400,"[[97, 100], [103, 100]]",97,103,100,103,200,200,197,203,197,203,0.4925,0.49238578680203043,0.485,0.5,0.5,0.515,0.48866498740554154
0.407,400,"[[97, 100], [103, 100]]",97,103,100,103,200,200,197,203,197,203,0.4925,0.49238578680203043,0.485,0.5,0.5,0.515,0.48866498740554154
0.408,400,"[[97, 100], [103, 100]]",97,103,100,103,200,200,197,203,197,203,0.4925,0.49238578680203043,0.485,0.5,0.5,0.515,0.48866498740554154
0.409,400,"[[97, 100], [103, 100]]",97,103,100,103,200,200,197,203,197,203,0.4925,0.49238578680203043,0.485,0.5,0.5,0.515,0.48866498740554154
0.41,400,"[[97, 100], [103, 100]]",97,103,100,103,200,200,197,203,197,203,0.4925,0.49238578680203043,0.485,0.5,0.5,0.515,0.48866498740554154
0.411,400,"[[97, 100], [103, 100]]",97,103,100,103,200,200,197,203,197,203,0.4925,0.49238578680203043,0.485,0.5,0.5,0.515,0.48866498740554154
0.412,400,"[[96, 100], [104, 100]]",96,104,100,104,200,200,196,204,196,204,0.49,0.4897959183673469,0.48,0.5,0.5,0.52,0.48484848484848486
0.413,400,"[[96, 100], [104, 100]]",96,104,100,104,200,200,196,204,196,204,0.49,0.4897959183673469,0.48,0.5,0.5,0.52,0.48484848484848486
0.414,400,"[[96, 100], [104, 100]]",96,104,100,104,200,200,196,204,196,204,0.49,0.4897959183673469,0.48,0.5,0.5,0.52,0.48484848484848486
0.415,400,"[[96, 99], [104, 101]]",96,104,99,104,200,200,195,205,197,203,0.4925,0.49230769230769234,0.48,0.505,0.495,0.52,0.4860759493670886
0.416,400,"[[96, 99], [104, 101]]",96,104,99,104,200,200,195,205,197,203,0.4925,0.49230769230769234,0.48,0.505,0.495,0.52,0.4860759493670886
0.417,400,"[[96, 99], [104, 101]]",96,104,99,104,200,200,195,205,197,203,0.4925,0.49230769230769234,0.48,0.505,0.495,0.52,0.4860759493670886
0.418,400,"[[95, 99], [105, 101]]",95,105,99,105,200,200,194,206,196,204,0.49,0.4896907216494845,0.475,0.505,0.495,0.525,0.48223350253807107
0.419,400,"[[95, 99], [105, 101]]",95,105,99,105,200,200,194,206,196,204,0.49,0.4896907216494845,0.475,0.505,0.495,0.525,0.48223350253807107
0.42,400,"[[95, 99], [105, 101]]",95,105,99,105,200,200,194,206,196,204,0.49,0.4896907216494845,0.475,0.505,0.495,0.525,0.48223350253807107
0.421,400,"[[95, 98], [105, 102]]",95,105,98,105,200,200,193,207,197,203,0.4925,0.49222797927461137,0.475,0.51,0.49,0.525,0.48346055979643765
0.422,400,"[[95, 98], [105, 102]]",95,105,98,105,200,200,193,207,197,203,0.4925,0.49222797927461137,0.475,0.51,0.49,0.525,0.48346055979643765
0.423,400,"[[95, 98], [105, 102]]",95,105,98,105,200,200,193,207,197,203,0.4925,0.49222797927461137,0.475,0.51,0.49,0.525,0.48346055979643765
0.424,400,"[[95, 97], [105, 103]]",95,105,97,105,200,200,192,208,198,202,0.495,0.4947916666666667,0.475,0.515,0.485,0.525,0.4846938775510204
0.425,400,"[[95, 97], [105, 103]]",95,105,97,105,200,200,192,208,198,202,0.495,0.4947916666666667,0.475,0.515,0.485,0.525,0.4846938775510204
0.426,400,"[[93, 97], [107, 103]]",93,107,97,107,200,200,190,210,196,204,0.49,0.48947368421052634,0.465,0.515,0.485,0.535,0.47692307692307695
0.427,400,"[[93, 97], [107, 103]]",93,107,97,107,200,200,190,210,196,204,0.49,0.48947368421052634,0.465,0.515,0.485,0.535,0.47692307692307695
0.428,400,"[[93, 97], [107, 103]]",93,107,97,107,200,200,190,210,196,204,0.49,0.48947368421052634,0.465,0.515,0.485,0.535,0.47692307692307695
0.429,400,"[[93, 97], [107, 103]]",93,107,97,107,200,200,190,210,196,204,0.49,0.48947368421052634,0.465,0.515,0.485,0.535,0.47692307692307695
0.43,400,"[[93, 97], [107, 103]]",93,107,97,107,200,200,190,210,196,204,0.49,0.48947368421052634,0.465,0.515,0.485,0.535,0.47692307692307695
0.431,400,"[[93, 97], [107, 103]]",93,107,97,107,200,200,190,210,196,204,0.49,0.48947368421052634,0.465,0.515,0.485,0.535,0.47692307692307695
0.432,400,"[[93, 97], [107, 103]]",93,107,97,107,200,200,190,210,196,204,0.49,0.48947368421052634,0.465,0.515,0.485,0.535,0.47692307692307695
0.433,400,"[[92, 97], [108, 103]]",92,108,97,108,200,200,189,211,195,205,0.4875,0.48677248677248675,0.46,0.515,0.485,0.54,0.4730077120822622
0.434,400,"[[92, 97], [108, 103]]",92,108,97,108,200,200,189,211,195,205,0.4875,0.48677248677248675,0.46,0.515,0.485,0.54,0.4730077120822622
0.435,400,"[[92, 97], [108, 103]]",92,108,97,108,200,200,189,211,195,205,0.4875,0.48677248677248675,0.46,0.515,0.485,0.54,0.4730077120822622
0.436,400,"[[92, 97], [108, 103]]",92,108,97,108,200,200,189,211,195,205,0.4875,0.48677248677248675,0.46,0.515,0.485,0.54,0.4730077120822622
0.437,400,"[[91, 96], [109, 104]]",91,109,96,109,200,200,187,213,195,205,0.4875,0.48663101604278075,0.455,0.52,0.48,0.545,0.47028423772609823
0.438,400,"[[90, 96], [110, 104]]",90,110,96,110,200,200,186,214,194,206,0.485,0.4838709677419355,0.45,0.52,0.48,0.55,0.46632124352331605
0.439,400,"[[90, 95], [110, 105]]",90,110,95,110,200,200,185,215,195,205,0.4875,0.4864864864864865,0.45,0.525,0.475,0.55,0.4675324675324675
0.44,400,"[[90, 95], [110, 105]]",90,110,95,110,200,200,185,215,195,205,0.4875,0.4864864864864865,0.45,0.525,0.475,0.55,0.4675324675324675
0.441,400,"[[90, 95], [110, 105]]",90,110,95,110,200,200,185,215,195,205,0.4875,0.4864864864864865,0.45,0.525,0.475,0.55,0.4675324675324675
0.442,400,"[[90, 95], [110, 105]]",90,110,95,110,200,200,185,215,195,205,0.4875,0.4864864864864865,0.45,0.525,0.475,0.55,0.4675324675324675
0.443,400,"[[90, 94], [110, 106]]",90,110,94,110,200,200,184,216,196,204,0.49,0.4891304347826087,0.45,0.53,0.47,0.55,0.46875
0.444,400,"[[90, 94], [110, 106]]",90,110,94,110,200,200,184,216,196,204,0.49,0.4891304347826087,0.45,0.53,0.47,0.55,0.46875
0.445,400,"[[90, 94], [110, 106]]",90,110,94,110,200,200,184,216,196,204,0.49,0.4891304347826087,0.45,0.53,0.47,0.55,0.46875
0.446,400,"[[90, 94], [110, 106]]",90,110,94,110,200,200,184,216,196,204,0.49,0.4891304347826087,0.45,0.53,0.47,0.55,0.46875
0.447,400,"[[90, 94], [110, 106]]",90,110,94,110,200,200,184,216,196,204,0.49,0.4891304347826087,0.45,0.53,0.47,0.55,0.46875
0.448,400,"[[90, 94], [110, 106]]",90,110,94,110,200,200,184,216,196,204,0.49,0.4891304347826087,0.45,0.53,0.47,0.55,0.46875
0.449,400,"[[90, 94], [110, 106]]",90,110,94,110,200,200,184,216,196,204,0.49,0.4891304347826087,0.45,0.53,0.47,0.55,0.46875
0.45,400,"[[90, 93], [110, 107]]",90,110,93,110,200,200,183,217,197,203,0.4925,0.4918032786885246,0.45,0.535,0.465,0.55,0.46997389033942555
0.451,400,"[[90, 93], [110, 107]]",90,110,93,110,200,200,183,217,197,203,0.4925,0.4918032786885246,0.45,0.535,0.465,0.55,0.46997389033942555
0.452,400,"[[90, 93], [110, 107]]",90,110,93,110,200,200,183,217,197,203,0.4925,0.4918032786885246,0.45,0.535,0.465,0.55,0.46997389033942555
0.453,400,"[[89, 93], [111, 107]]",89,111,93,111,200,200,182,218,196,204,0.49,0.489010989010989,0.445,0.535,0.465,0.555,0.46596858638743455
0.454,400,"[[89, 93], [111, 107]]",89,111,93,111,200,200,182,218,196,204,0.49,0.489010989010989,0.445,0.535,0.465,0.555,0.46596858638743455
0.455,400,"[[89, 92], [111, 108]]",89,111,92,111,200,200,181,219,197,203,0.4925,0.49171270718232046,0.445,0.54,0.46,0.555,0.4671916010498688
0.456,400,"[[89, 92], [111, 108]]",89,111,92,111,200,200,181,219,197,203,0.4925,0.49171270718232046,0.445,0.54,0.46,0.555,0.4671916010498688
0.457,400,"[[89, 92], [111, 108]]",89,111,92,111,200,200,181,219,197,203,0.4925,0.49171270718232046,0.445,0.54,0.46,0.555,0.4671916010498688
0.458,400,"[[89, 92], [111, 108]]",89,111,92,111,200,200,181,219,197,203,0.4925,0.49171270718232046,0.445,0.54,0.46,0.555,0.4671916010498688
0.459,400,"[[89, 91], [111, 109]]",89,111,91,111,200,200,180,220,198,202,0.495,0.49444444444444446,0.445,0.545,0.455,0.555,0.46842105263157896
0.46,400,"[[89, 90], [111, 110]]",89,111,90,111,200,200,179,221,199,201,0.4975,0.4972067039106145,0.445,0.55,0.45,0.555,0.4696569920844327
0.461,400,"[[89, 90], [111, 110]]",89,111,90,111,200,200,179,221,199,201,0.4975,0.4972067039106145,0.445,0.55,0.45,0.555,0.4696569920844327
0.462,400,"[[89, 90], [111, 110]]",89,111,90,111,200,200,179,221,199,201,0.4975,0.4972067039106145,0.445,0.55,0.45,0.555,0.4696569920844327
0.463,400,"[[89, 90], [111, 110]]",89,111,90,111,200,200,179,221,199,201,0.4975,0.4972067039106145,0.445,0.55,0.45,0.555,0.4696569920844327
0.464,400,"[[89, 90], [111, 110]]",89,111,90,111,200,200,179,221,199,201,0.4975,0.4972067039106145,0.445,0.55,0.45,0.555,0.4696569920844327
0.465,400,"[[88, 90], [112, 110]]",88,112,90,112,200,200,178,222,198,202,0.495,0.4943820224719101,0.44,0.55,0.45,0.56,0.4656084656084656
0.466,400,"[[88, 90], [112, 110]]",88,112,90,112,200,200,178,222,198,202,0.495,0.4943820224719101,0.44,0.55,0.45,0.56,0.4656084656084656
0.467,400,"[[88, 90], [112, 110]]",88,112,90,112,200,200,178,222,198,202,0.495,0.4943820224719101,0.44,0.55,0.45,0.56,0.4656084656084656
0.468,400,"[[88, 90], [112, 110]]",88,112,90,112,200,200,178,222,198,202,0.495,0.4943820224719101,0.44,0.55,0.45,0.56,0.4656084656084656
0.469,400,"[[88, 89], [112, 111]]",88,112,89,112,200,200,177,223,199,201,0.4975,0.4971751412429379,0.44,0.555,0.445,0.56,0.46684350132625996
0.47,400,"[[86, 89], [114, 111]]",86,114,89,114,200,200,175,225,197,203,0.4925,0.49142857142857144,0.43,0.555,0.445,0.57,0.4586666666666666
0.471,400,"[[86, 89], [114, 111]]",86,114,89,114,200,200,175,225,197,203,0.4925,0.49142857142857144,0.43,0.555,0.445,0.57,0.4586666666666666
0.472,400,"[[86, 89], [114, 111]]",86,114,89,114,200,200,175,225,197,203,0.4925,0.49142857142857144,0.43,0.555,0.445,0.57,0.4586666666666666
0.473,400,"[[86, 89], [114, 111]]",86,114,89,114,200,200,175,225,197,203,0.4925,0.49142857142857144,0.43,0.555,0.445,0.57,0.4586666666666666
0.474,400,"[[86, 89], [114, 111]]",86,114,89,114,200,200,175,225,197,203,0.4925,0.49142857142857144,0.43,0.555,0.445,0.57,0.4586666666666666
0.475,400,"[[86, 89], [114, 111]]",86,114,89,114,200,200,175,225,197,203,0.4925,0.49142857142857144,0.43,0.555,0.445,0.57,0.4586666666666666
0.476,400,"[[85, 88], [115, 112]]",85,115,88,115,200,200,173,227,197,203,0.4925,0.4913294797687861,0.425,0.56,0.44,0.575,0.4557640750670241
0.477,400,"[[84, 88], [116, 112]]",84,116,88,116,200,200,172,228,196,204,0.49,0.4883720930232558,0.42,0.56,0.44,0.58,0.45161290322580644
0.478,400,"[[83, 87], [117, 113]]",83,117,87,117,200,200,170,230,196,204,0.49,0.48823529411764705,0.415,0.565,0.435,0.585,0.4486486486486486
0.479,400,"[[83, 87], [117, 113]]",83,117,87,117,200,200,170,230,196,204,0.49,0.48823529411764705,0.415,0.565,0.435,0.585,0.4486486486486486
0.48,400,"[[83, 87], [117, 113]]",83,117,87,117,200,200,170,230,196,204,0.49,0.48823529411764705,0.415,0.565,0.435,0.585,0.4486486486486486
0.481,400,"[[83, 86], [117, 114]]",83,117,86,117,200,200,169,231,197,203,0.4925,0.4911242603550296,0.415,0.57,0.43,0.585,0.44986449864498645
0.482,400,"[[83, 86], [117, 114]]",83,117,86,117,200,200,169,231,197,203,0.4925,0.4911242603550296,0.415,0.57,0.43,0.585,0.44986449864498645
0.483,400,"[[83, 86], [117, 114]]",83,117,86,117,200,200,169,231,197,203,0.4925,0.4911242603550296,0.415,0.57,0.43,0.585,0.44986449864498645
0.484,400,"[[83, 86], [117, 114]]",83,117,86,117,200,200,169,231,197,203,0.4925,0.4911242603550296,0.415,0.57,0.43,0.585,0.44986449864498645
0.485,400,"[[83, 85], [117, 115]]",83,117,85,117,200,200,168,232,198,202,0.495,0.49404761904761907,0.415,0.575,0.425,0.585,0.45108695652173914
0.486,400,"[[83, 85], [117, 115]]",83,117,85,117,200,200,168,232,198,202,0.495,0.49404761904761907,0.415,0.575,0.425,0.585,0.45108695652173914
0.487,400,"[[83, 85], [117, 115]]",83,117,85,117,200,200,168,232,198,202,0.495,0.49404761904761907,0.415,0.575,0.425,0.585,0.45108695652173914
0.488,400,"[[83, 84], [117, 116]]",83,117,84,117,200,200,167,233,199,201,0.4975,0.49700598802395207,0.415,0.58,0.42,0.585,0.4523160762942779
0.489,400,"[[81, 84], [119, 116]]",81,119,84,119,200,200,165,235,197,203,0.4925,0.4909090909090909,0.405,0.58,0.42,0.595,0.4438356164383562
0.49,400,"[[81, 84], [119, 116]]",81,119,84,119,200,200,165,235,197,203,0.4925,0.4909090909090909,0.405,0.58,0.42,0.595,0.4438356164383562
0.491,400,"[[81, 84], [119, 116]]",81,119,84,119,200,200,165,235,197,203,0.4925,0.4909090909090909,0.405,0.58,0.42,0.595,0.4438356164383562
0.492,400,"[[80, 83], [120, 117]]",80,120,83,120,200,200,163,237,197,203,0.4925,0.49079754601226994,0.4,0.585,0.415,0.6,0.44077134986225897
0.493,400,"[[80, 82], [120, 118]]",80,120,82,120,200,200,162,238,198,202,0.495,0.49382716049382713,0.4,0.59,0.41,0.6,0.4419889502762431
0.494,400,"[[80, 81], [120, 119]]",80,120,81,120,200,200,161,239,199,201,0.4975,0.4968944099378882,0.4,0.595,0.405,0.6,0.443213296398892
0.495,400,"[[80, 80], [120, 120]]",80,120,80,120,200,200,160,240,200,200,0.5,0.5,0.4,0.6,0.4,0.6,0.4444444444444445
0.496,400,"[[80, 80], [120, 120]]",80,120,80,120,200,200,160,240,200,200,0.5,0.5,0.4,0.6,0.4,0.6,0.4444444444444445
0.497,400,"[[80, 79], [120, 121]]",80,120,79,120,200,200,159,241,201,199,0.5025,0.5031446540880503,0.4,0.605,0.395,0.6,0.4456824512534819
0.498,400,"[[78, 79], [122, 121]]",78,122,79,122,200,200,157,243,199,201,0.4975,0.4968152866242038,0.39,0.605,0.395,0.61,0.4369747899159664
0.499,400,"[[78, 79], [122, 121]]",78,122,79,122,200,200,157,243,199,201,0.4975,0.4968152866242038,0.39,0.605,0.395,0.61,0.4369747899159664
0.5,400,"[[78, 78], [122, 122]]",78,122,78,122,200,200,156,244,200,200,0.5,0.5,0.39,0.61,0.39,0.61,0.43820224719101125
0.501,400,"[[78, 78], [122, 122]]",78,122,78,122,200,200,156,244,200,200,0.5,0.5,0.39,0.61,0.39,0.61,0.43820224719101125
0.502,400,"[[78, 78], [122, 122]]",78,122,78,122,200,200,156,244,200,200,0.5,0.5,0.39,0.61,0.39,0.61,0.43820224719101125
0.503,400,"[[78, 78], [122, 122]]",78,122,78,122,200,200,156,244,200,200,0.5,0.5,0.39,0.61,0.39,0.61,0.43820224719101125
0.504,400,"[[75, 78], [125, 122]]",75,125,78,125,200,200,153,247,197,203,0.4925,0.49019607843137253,0.375,0.61,0.39,0.625,0.4249291784702549
0.505,400,"[[75, 77], [125, 123]]",75,125,77,125,200,200,152,248,198,202,0.495,0.4934210526315789,0.375,0.615,0.385,0.625,0.4261363636363636
0.506,400,"[[75, 77], [125, 123]]",75,125,77,125,200,200,152,248,198,202,0.495,0.4934210526315789,0.375,0.615,0.385,0.625,0.4261363636363636
0.507,400,"[[75, 77], [125, 123]]",75,125,77,125,200,200,152,248,198,202,0.495,0.4934210526315789,0.375,0.615,0.385,0.625,0.4261363636363636
0.508,400,"[[73, 77], [127, 123]]",73,127,77,127,200,200,150,250,196,204,0.49,0.4866666666666667,0.365,0.615,0.385,0.635,0.41714285714285715
0.509,400,"[[73, 77], [127, 123]]",73,127,77,127,200,200,150,250,196,204,0.49,0.4866666666666667,0.365,0.615,0.385,0.635,0.41714285714285715
0.51,400,"[[73, 77], [127, 123]]",73,127,77,127,200,200,150,250,196,204,0.49,0.4866666666666667,0.365,0.615,0.385,0.635,0.41714285714285715
0.511,400,"[[72, 77], [128, 123]]",72,128,77,128,200,200,149,251,195,205,0.4875,0.48322147651006714,0.36,0.615,0.385,0.64,0.4126074498567335
0.512,400,"[[72, 77], [128, 123]]",72,128,77,128,200,200,149,251,195,205,0.4875,0.48322147651006714,0.36,0.615,0.385,0.64,0.4126074498567335
0.513,400,"[[72, 77], [128, 123]]",72,128,77,128,200,200,149,251,195,205,0.4875,0.48322147651006714,0.36,0.615,0.385,0.64,0.4126074498567335
0.514,400,"[[72, 77], [128, 123]]",72,128,77,128,200,200,149,251,195,205,0.4875,0.48322147651006714,0.36,0.615,0.385,0.64,0.4126074498567335
0.515,400,"[[72, 77], [128, 123]]",72,128,77,128,200,200,149,251,195,205,0.4875,0.48322147651006714,0.36,0.615,0.385,0.64,0.4126074498567335
0.516,400,"[[72, 77], [128, 123]]",72,128,77,128,200,200,149,251,195,205,0.4875,0.48322147651006714,0.36,0.615,0.385,0.64,0.4126074498567335
0.517,400,"[[72, 77], [128, 123]]",72,128,77,128,200,200,149,251,195,205,0.4875,0.48322147651006714,0.36,0.615,0.385,0.64,0.4126074498567335
0.518,400,"[[72, 77], [128, 123]]",72,128,77,128,200,200,149,251,195,205,0.4875,0.48322147651006714,0.36,0.615,0.385,0.64,0.4126074498567335
0.519,400,"[[72, 77], [128, 123]]",72,128,77,128,200,200,149,251,195,205,0.4875,0.48322147651006714,0.36,0.615,0.385,0.64,0.4126074498567335
0.52,400,"[[72, 77], [128, 123]]",72,128,77,128,200,200,149,251,195,205,0.4875,0.48322147651006714,0.36,0.615,0.385,0.64,0.4126074498567335
0.521,400,"[[72, 77], [128, 123]]",72,128,77,128,200,200,149,251,195,205,0.4875,0.48322147651006714,0.36,0.615,0.385,0.64,0.4126074498567335
0.522,400,"[[72, 77], [128, 123]]",72,128,77,128,200,200,149,251,195,205,0.4875,0.48322147651006714,0.36,0.615,0.385,0.64,0.4126074498567335
0.523,400,"[[72, 77], [128, 123]]",72,128,77,128,200,200,149,251,195,205,0.4875,0.48322147651006714,0.36,0.615,0.385,0.64,0.4126074498567335
0.524,400,"[[72, 77], [128, 123]]",72,128,77,128,200,200,149,251,195,205,0.4875,0.48322147651006714,0.36,0.615,0.385,0.64,0.4126074498567335
0.525,400,"[[72, 77], [128, 123]]",72,128,77,128,200,200,149,251,195,205,0.4875,0.48322147651006714,0.36,0.615,0.385,0.64,0.4126074498567335
0.526,400,"[[72, 77], [128, 123]]",72,128,77,128,200,200,149,251,195,205,0.4875,0.48322147651006714,0.36,0.615,0.385,0.64,0.4126074498567335
0.527,400,"[[72, 77], [128, 123]]",72,128,77,128,200,200,149,251,195,205,0.4875,0.48322147651006714,0.36,0.615,0.385,0.64,0.4126074498567335
0.528,400,"[[72, 77], [128, 123]]",72,128,77,128,200,200,149,251,195,205,0.4875,0.48322147651006714,0.36,0.615,0.385,0.64,0.4126074498567335
0.529,400,"[[72, 77], [128, 123]]",72,128,77,128,200,200,149,251,195,205,0.4875,0.48322147651006714,0.36,0.615,0.385,0.64,0.4126074498567335
0.53,400,"[[71, 77], [129, 123]]",71,129,77,129,200,200,148,252,194,206,0.485,0.4797297297297297,0.355,0.615,0.385,0.645,0.40804597701149425
0.531,400,"[[70, 77], [130, 123]]",70,130,77,130,200,200,147,253,193,207,0.4825,0.47619047619047616,0.35,0.615,0.385,0.65,0.4034582132564842
0.532,400,"[[70, 77], [130, 123]]",70,130,77,130,200,200,147,253,193,207,0.4825,0.47619047619047616,0.35,0.615,0.385,0.65,0.4034582132564842
0.533,400,"[[70, 77], [130, 123]]",70,130,77,130,200,200,147,253,193,207,0.4825,0.47619047619047616,0.35,0.615,0.385,0.65,0.4034582132564842
0.534,400,"[[70, 77], [130, 123]]",70,130,77,130,200,200,147,253,193,207,0.4825,0.47619047619047616,0.35,0.615,0.385,0.65,0.4034582132564842
0.535,400,"[[70, 77], [130, 123]]",70,130,77,130,200,200,147,253,193,207,0.4825,0.47619047619047616,0.35,0.615,0.385,0.65,0.4034582132564842
0.536,400,"[[70, 76], [130, 124]]",70,130,76,130,200,200,146,254,194,206,0.485,0.4794520547945205,0.35,0.62,0.38,0.65,0.40462427745664736
0.537,400,"[[70, 76], [130, 124]]",70,130,76,130,200,200,146,254,194,206,0.485,0.4794520547945205,0.35,0.62,0.38,0.65,0.40462427745664736
0.538,400,"[[70, 76], [130, 124]]",70,130,76,130,200,200,146,254,194,206,0.485,0.4794520547945205,0.35,0.62,0.38,0.65,0.40462427745664736
0.539,400,"[[68, 76], [132, 124]]",68,132,76,132,200,200,144,256,192,208,0.48,0.4722222222222222,0.34,0.62,0.38,0.66,0.39534883720930236
0.54,400,"[[68, 76], [132, 124]]",68,132,76,132,200,200,144,256,192,208,0.48,0.4722222222222222,0.34,0.62,0.38,0.66,0.39534883720930236
0.541,400,"[[68, 75], [132, 125]]",68,132,75,132,200,200,143,257,193,207,0.4825,0.4755244755244755,0.34,0.625,0.375,0.66,0.3965014577259476
0.542,400,"[[67, 75], [133, 125]]",67,133,75,133,200,200,142,258,192,208,0.48,0.47183098591549294,0.335,0.625,0.375,0.665,0.39181286549707606
0.543,400,"[[67, 75], [133, 125]]",67,133,75,133,200,200,142,258,192,208,0.48,0.47183098591549294,0.335,0.625,0.375,0.665,0.39181286549707606
0.544,400,"[[67, 75], [133, 125]]",67,133,75,133,200,200,142,258,192,208,0.48,0.47183098591549294,0.335,0.625,0.375,0.665,0.39181286549707606
0.545,400,"[[66, 74], [134, 126]]",66,134,74,134,200,200,140,260,192,208,0.48,0.4714285714285714,0.33,0.63,0.37,0.67,0.3882352941176471
0.546,400,"[[66, 73], [134, 127]]",66,134,73,134,200,200,139,261,193,207,0.4825,0.4748201438848921,0.33,0.635,0.365,0.67,0.3893805309734513
0.547,400,"[[66, 73], [134, 127]]",66,134,73,134,200,200,139,261,193,207,0.4825,0.4748201438848921,0.33,0.635,0.365,0.67,0.3893805309734513
0.548,400,"[[66, 73], [134, 127]]",66,134,73,134,200,200,139,261,193,207,0.4825,0.4748201438848921,0.33,0.635,0.365,0.67,0.3893805309734513
0.549,400,"[[66, 73], [134, 127]]",66,134,73,134,200,200,139,261,193,207,0.4825,0.4748201438848921,0.33,0.635,0.365,0.67,0.3893805309734513
0.55,400,"[[66, 73], [134, 127]]",66,134,73,134,200,200,139,261,193,207,0.4825,0.4748201438848921,0.33,0.635,0.365,0.67,0.3893805309734513
0.551,400,"[[65, 73], [135, 127]]",65,135,73,135,200,200,138,262,192,208,0.48,0.47101449275362317,0.325,0.635,0.365,0.675,0.3846153846153846
0.552,400,"[[65, 73], [135, 127]]",65,135,73,135,200,200,138,262,192,208,0.48,0.47101449275362317,0.325,0.635,0.365,0.675,0.3846153846153846
0.553,400,"[[65, 73], [135, 127]]",65,135,73,135,200,200,138,262,192,208,0.48,0.47101449275362317,0.325,0.635,0.365,0.675,0.3846153846153846
0.554,400,"[[65, 72], [135, 128]]",65,135,72,135,200,200,137,263,193,207,0.4825,0.4744525547445255,0.325,0.64,0.36,0.675,0.3857566765578635
0.555,400,"[[65, 72], [135, 128]]",65,135,72,135,200,200,137,263,193,207,0.4825,0.4744525547445255,0.325,0.64,0.36,0.675,0.3857566765578635
0.556,400,"[[65, 72], [135, 128]]",65,135,72,135,200,200,137,263,193,207,0.4825,0.4744525547445255,0.325,0.64,0.36,0.675,0.3857566765578635
0.557,400,"[[65, 72], [135, 128]]",65,135,72,135,200,200,137,263,193,207,0.4825,0.4744525547445255,0.325,0.64,0.36,0.675,0.3857566765578635
0.558,400,"[[64, 72], [136, 128]]",64,136,72,136,200,200,136,264,192,208,0.48,0.47058823529411764,0.32,0.64,0.36,0.68,0.38095238095238104
0.559,400,"[[64, 72], [136, 128]]",64,136,72,136,200,200,136,264,192,208,0.48,0.47058823529411764,0.32,0.64,0.36,0.68,0.38095238095238104
0.56,400,"[[64, 72], [136, 128]]",64,136,72,136,200,200,136,264,192,208,0.48,0.47058823529411764,0.32,0.64,0.36,0.68,0.38095238095238104
0.561,400,"[[64, 72], [136, 128]]",64,136,72,136,200,200,136,264,192,208,0.48,0.47058823529411764,0.32,0.64,0.36,0.68,0.38095238095238104
0.562,400,"[[63, 72], [137, 128]]",63,137,72,137,200,200,135,265,191,209,0.4775,0.4666666666666667,0.315,0.64,0.36,0.685,0.37611940298507457
0.563,400,"[[63, 72], [137, 128]]",63,137,72,137,200,200,135,265,191,209,0.4775,0.4666666666666667,0.315,0.64,0.36,0.685,0.37611940298507457
0.564,400,"[[63, 72], [137, 128]]",63,137,72,137,200,200,135,265,191,209,0.4775,0.4666666666666667,0.315,0.64,0.36,0.685,0.37611940298507457
0.565,400,"[[63, 72], [137, 128]]",63,137,72,137,200,200,135,265,191,209,0.4775,0.4666666666666667,0.315,0.64,0.36,0.685,0.37611940298507457
0.566,400,"[[63, 71], [137, 129]]",63,137,71,137,200,200,134,266,192,208,0.48,0.4701492537313433,0.315,0.645,0.355,0.685,0.3772455089820359
0.567,400,"[[63, 71], [137, 129]]",63,137,71,137,200,200,134,266,192,208,0.48,0.4701492537313433,0.315,0.645,0.355,0.685,0.3772455089820359
0.568,400,"[[63, 71], [137, 129]]",63,137,71,137,200,200,134,266,192,208,0.48,0.4701492537313433,0.315,0.645,0.355,0.685,0.3772455089820359
0.569,400,"[[63, 71], [137, 129]]",63,137,71,137,200,200,134,266,192,208,0.48,0.4701492537313433,0.315,0.645,0.355,0.685,0.3772455089820359
0.57,400,"[[61, 71], [139, 129]]",61,139,71,139,200,200,132,268,190,210,0.475,0.4621212121212121,0.305,0.645,0.355,0.695,0.36746987951807225
0.571,400,"[[61, 71], [139, 129]]",61,139,71,139,200,200,132,268,190,210,0.475,0.4621212121212121,0.305,0.645,0.355,0.695,0.36746987951807225
0.572,400,"[[61, 70], [139, 130]]",61,139,70,139,200,200,131,269,191,209,0.4775,0.46564885496183206,0.305,0.65,0.35,0.695,0.36858006042296076
0.573,400,"[[60, 70], [140, 130]]",60,140,70,140,200,200,130,270,190,210,0.475,0.46153846153846156,0.3,0.65,0.35,0.7,0.3636363636363637
0.574,400,"[[60, 69], [140, 131]]",60,140,69,140,200,200,129,271,191,209,0.4775,0.46511627906976744,0.3,0.655,0.345,0.7,0.364741641337386
0.575,400,"[[59, 69], [141, 131]]",59,141,69,141,200,200,128,272,190,210,0.475,0.4609375,0.295,0.655,0.345,0.705,0.3597560975609756
0.576,400,"[[59, 69], [141, 131]]",59,141,69,141,200,200,128,272,190,210,0.475,0.4609375,0.295,0.655,0.345,0.705,0.3597560975609756
0.577,400,"[[57, 69], [143, 131]]",57,143,69,143,200,200,126,274,188,212,0.47,0.4523809523809524,0.285,0.655,0.345,0.715,0.3496932515337423
0.578,400,"[[56, 69], [144, 131]]",56,144,69,144,200,200,125,275,187,213,0.4675,0.448,0.28,0.655,0.345,0.72,0.3446153846153847
0.579,400,"[[55, 69], [145, 131]]",55,145,69,145,200,200,124,276,186,214,0.465,0.4435483870967742,0.275,0.655,0.345,0.725,0.3395061728395062
0.58,400,"[[51, 69], [149, 131]]",51,149,69,149,200,200,120,280,182,218,0.455,0.425,0.255,0.655,0.345,0.745,0.31875000000000003
0.581,400,"[[51, 69], [149, 131]]",51,149,69,149,200,200,120,280,182,218,0.455,0.425,0.255,0.655,0.345,0.745,0.31875000000000003
0.582,400,"[[51, 69], [149, 131]]",51,149,69,149,200,200,120,280,182,218,0.455,0.425,0.255,0.655,0.345,0.745,0.31875000000000003
0.583,400,"[[50, 69], [150, 131]]",50,150,69,150,200,200,119,281,181,219,0.4525,0.42016806722689076,0.25,0.655,0.345,0.75,0.3134796238244514
0.584,400,"[[50, 69], [150, 131]]",50,150,69,150,200,200,119,281,181,219,0.4525,0.42016806722689076,0.25,0.655,0.345,0.75,0.3134796238244514
0.585,400,"[[50, 69], [150, 131]]",50,150,69,150,200,200,119,281,181,219,0.4525,0.42016806722689076,0.25,0.655,0.345,0.75,0.3134796238244514
0.586,400,"[[50, 69], [150, 131]]",50,150,69,150,200,200,119,281,181,219,0.4525,0.42016806722689076,0.25,0.655,0.345,0.75,0.3134796238244514
0.587,400,"[[50, 69], [150, 131]]",50,150,69,150,200,200,119,281,181,219,0.4525,0.42016806722689076,0.25,0.655,0.345,0.75,0.3134796238244514
0.588,400,"[[50, 69], [150, 131]]",50,150,69,150,200,200,119,281,181,219,0.4525,0.42016806722689076,0.25,0.655,0.345,0.75,0.3134796238244514
0.589,400,"[[50, 69], [150, 131]]",50,150,69,150,200,200,119,281,181,219,0.4525,0.42016806722689076,0.25,0.655,0.345,0.75,0.3134796238244514
0.59,400,"[[50, 68], [150, 132]]",50,150,68,150,200,200,118,282,182,218,0.455,0.423728813559322,0.25,0.66,0.34,0.75,0.31446540880503143
0.591,400,"[[50, 68], [150, 132]]",50,150,68,150,200,200,118,282,182,218,0.455,0.423728813559322,0.25,0.66,0.34,0.75,0.31446540880503143
0.592,400,"[[50, 68], [150, 132]]",50,150,68,150,200,200,118,282,182,218,0.455,0.423728813559322,0.25,0.66,0.34,0.75,0.31446540880503143
0.593,400,"[[50, 68], [150, 132]]",50,150,68,150,200,200,118,282,182,218,0.455,0.423728813559322,0.25,0.66,0.34,0.75,0.31446540880503143
0.594,400,"[[50, 67], [150, 133]]",50,150,67,150,200,200,117,283,183,217,0.4575,0.42735042735042733,0.25,0.665,0.335,0.75,0.31545741324921134
0.595,400,"[[50, 66], [150, 134]]",50,150,66,150,200,200,116,284,184,216,0.46,0.43103448275862066,0.25,0.67,0.33,0.75,0.3164556962025316
0.596,400,"[[50, 66], [150, 134]]",50,150,66,150,200,200,116,284,184,216,0.46,0.43103448275862066,0.25,0.67,0.33,0.75,0.3164556962025316
0.597,400,"[[50, 66], [150, 134]]",50,150,66,150,200,200,116,284,184,216,0.46,0.43103448275862066,0.25,0.67,0.33,0.75,0.3164556962025316
0.598,400,"[[50, 66], [150, 134]]",50,150,66,150,200,200,116,284,184,216,0.46,0.43103448275862066,0.25,0.67,0.33,0.75,0.3164556962025316
0.599,400,"[[50, 66], [150, 134]]",50,150,66,150,200,200,116,284,184,216,0.46,0.43103448275862066,0.25,0.67,0.33,0.75,0.3164556962025316
0.6,400,"[[50, 66], [150, 134]]",50,150,66,150,200,200,116,284,184,216,0.46,0.43103448275862066,0.25,0.67,0.33,0.75,0.3164556962025316
0.601,400,"[[50, 66], [150, 134]]",50,150,66,150,200,200,116,284,184,216,0.46,0.43103448275862066,0.25,0.67,0.33,0.75,0.3164556962025316
0.602,400,"[[50, 66], [150, 134]]",50,150,66,150,200,200,116,284,184,216,0.46,0.43103448275862066,0.25,0.67,0.33,0.75,0.3164556962025316
0.603,400,"[[50, 66], [150, 134]]",50,150,66,150,200,200,116,284,184,216,0.46,0.43103448275862066,0.25,0.67,0.33,0.75,0.3164556962025316
0.604,400,"[[50, 66], [150, 134]]",50,150,66,150,200,200,116,284,184,216,0.46,0.43103448275862066,0.25,0.67,0.33,0.75,0.3164556962025316
0.605,400,"[[50, 66], [150, 134]]",50,150,66,150,200,200,116,284,184,216,0.46,0.43103448275862066,0.25,0.67,0.33,0.75,0.3164556962025316
0.606,400,"[[50, 66], [150, 134]]",50,150,66,150,200,200,116,284,184,216,0.46,0.43103448275862066,0.25,0.67,0.33,0.75,0.3164556962025316
0.607,400,"[[49, 66], [151, 134]]",49,151,66,151,200,200,115,285,183,217,0.4575,0.4260869565217391,0.245,0.67,0.33,0.755,0.3111111111111111
0.608,400,"[[47, 66], [153, 134]]",47,153,66,153,200,200,113,287,181,219,0.4525,0.415929203539823,0.235,0.67,0.33,0.765,0.3003194888178914
0.609,400,"[[47, 66], [153, 134]]",47,153,66,153,200,200,113,287,181,219,0.4525,0.415929203539823,0.235,0.67,0.33,0.765,0.3003194888178914
0.61,400,"[[47, 65], [153, 135]]",47,153,65,153,200,200,112,288,182,218,0.455,0.41964285714285715,0.235,0.675,0.325,0.765,0.3012820512820513
0.611,400,"[[47, 65], [153, 135]]",47,153,65,153,200,200,112,288,182,218,0.455,0.41964285714285715,0.235,0.675,0.325,0.765,0.3012820512820513
0.612,400,"[[47, 65], [153, 135]]",47,153,65,153,200,200,112,288,182,218,0.455,0.41964285714285715,0.235,0.675,0.325,0.765,0.3012820512820513
0.613,400,"[[47, 65], [153, 135]]",47,153,65,153,200,200,112,288,182,218,0.455,0.41964285714285715,0.235,0.675,0.325,0.765,0.3012820512820513
0.614,400,"[[47, 65], [153, 135]]",47,153,65,153,200,200,112,288,182,218,0.455,0.41964285714285715,0.235,0.675,0.325,0.765,0.3012820512820513
0.615,400,"[[47, 65], [153, 135]]",47,153,65,153,200,200,112,288,182,218,0.455,0.41964285714285715,0.235,0.675,0.325,0.765,0.3012820512820513
0.616,400,"[[47, 65], [153, 135]]",47,153,65,153,200,200,112,288,182,218,0.455,0.41964285714285715,0.235,0.675,0.325,0.765,0.3012820512820513
0.617,400,"[[47, 64], [153, 136]]",47,153,64,153,200,200,111,289,183,217,0.4575,0.42342342342342343,0.235,0.68,0.32,0.765,0.3022508038585209
0.618,400,"[[47, 64], [153, 136]]",47,153,64,153,200,200,111,289,183,217,0.4575,0.42342342342342343,0.235,0.68,0.32,0.765,0.3022508038585209
0.619,400,"[[47, 64], [153, 136]]",47,153,64,153,200,200,111,289,183,217,0.4575,0.42342342342342343,0.235,0.68,0.32,0.765,0.3022508038585209
0.62,400,"[[46, 64], [154, 136]]",46,154,64,154,200,200,110,290,182,218,0.455,0.41818181818181815,0.23,0.68,0.32,0.77,0.2967741935483871
0.621,400,"[[46, 64], [154, 136]]",46,154,64,154,200,200,110,290,182,218,0.455,0.41818181818181815,0.23,0.68,0.32,0.77,0.2967741935483871
0.622,400,"[[46, 64], [154, 136]]",46,154,64,154,200,200,110,290,182,218,0.455,0.41818181818181815,0.23,0.68,0.32,0.77,0.2967741935483871
0.623,400,"[[46, 64], [154, 136]]",46,154,64,154,200,200,110,290,182,218,0.455,0.41818181818181815,0.23,0.68,0.32,0.77,0.2967741935483871
0.624,400,"[[46, 64], [154, 136]]",46,154,64,154,200,200,110,290,182,218,0.455,0.41818181818181815,0.23,0.68,0.32,0.77,0.2967741935483871
0.625,400,"[[46, 64], [154, 136]]",46,154,64,154,200,200,110,290,182,218,0.455,0.41818181818181815,0.23,0.68,0.32,0.77,0.2967741935483871
0.626,400,"[[46, 64], [154, 136]]",46,154,64,154,200,200,110,290,182,218,0.455,0.41818181818181815,0.23,0.68,0.32,0.77,0.2967741935483871
0.627,400,"[[46, 64], [154, 136]]",46,154,64,154,200,200,110,290,182,218,0.455,0.41818181818181815,0.23,0.68,0.32,0.77,0.2967741935483871
0.628,400,"[[46, 64], [154, 136]]",46,154,64,154,200,200,110,290,182,218,0.455,0.41818181818181815,0.23,0.68,0.32,0.77,0.2967741935483871
0.629,400,"[[46, 64], [154, 136]]",46,154,64,154,200,200,110,290,182,218,0.455,0.41818181818181815,0.23,0.68,0.32,0.77,0.2967741935483871
0.63,400,"[[43, 64], [157, 136]]",43,157,64,157,200,200,107,293,179,221,0.4475,0.40186915887850466,0.215,0.68,0.32,0.785,0.2801302931596091
0.631,400,"[[43, 64], [157, 136]]",43,157,64,157,200,200,107,293,179,221,0.4475,0.40186915887850466,0.215,0.68,0.32,0.785,0.2801302931596091
0.632,400,"[[42, 64], [158, 136]]",42,158,64,158,200,200,106,294,178,222,0.445,0.39622641509433965,0.21,0.68,0.32,0.79,0.27450980392156865
0.633,400,"[[42, 64], [158, 136]]",42,158,64,158,200,200,106,294,178,222,0.445,0.39622641509433965,0.21,0.68,0.32,0.79,0.27450980392156865
0.634,400,"[[42, 64], [158, 136]]",42,158,64,158,200,200,106,294,178,222,0.445,0.39622641509433965,0.21,0.68,0.32,0.79,0.27450980392156865
0.635,400,"[[42, 64], [158, 136]]",42,158,64,158,200,200,106,294,178,222,0.445,0.39622641509433965,0.21,0.68,0.32,0.79,0.27450980392156865
0.636,400,"[[42, 64], [158, 136]]",42,158,64,158,200,200,106,294,178,222,0.445,0.39622641509433965,0.21,0.68,0.32,0.79,0.27450980392156865
0.637,400,"[[42, 64], [158, 136]]",42,158,64,158,200,200,106,294,178,222,0.445,0.39622641509433965,0.21,0.68,0.32,0.79,0.27450980392156865
0.638,400,"[[42, 64], [158, 136]]",42,158,64,158,200,200,106,294,178,222,0.445,0.39622641509433965,0.21,0.68,0.32,0.79,0.27450980392156865
0.639,400,"[[41, 64], [159, 136]]",41,159,64,159,200,200,105,295,177,223,0.4425,0.3904761904761905,0.205,0.68,0.32,0.795,0.26885245901639343
0.64,400,"[[41, 63], [159, 137]]",41,159,63,159,200,200,104,296,178,222,0.445,0.3942307692307692,0.205,0.685,0.315,0.795,0.26973684210526316
0.641,400,"[[41, 63], [159, 137]]",41,159,63,159,200,200,104,296,178,222,0.445,0.3942307692307692,0.205,0.685,0.315,0.795,0.26973684210526316
0.642,400,"[[41, 63], [159, 137]]",41,159,63,159,200,200,104,296,178,222,0.445,0.3942307692307692,0.205,0.685,0.315,0.795,0.26973684210526316
0.643,400,"[[41, 63], [159, 137]]",41,159,63,159,200,200,104,296,178,222,0.445,0.3942307692307692,0.205,0.685,0.315,0.795,0.26973684210526316
0.644,400,"[[41, 63], [159, 137]]",41,159,63,159,200,200,104,296,178,222,0.445,0.3942307692307692,0.205,0.685,0.315,0.795,0.26973684210526316
0.645,400,"[[40, 63], [160, 137]]",40,160,63,160,200,200,103,297,177,223,0.4425,0.3883495145631068,0.2,0.685,0.315,0.8,0.26402640264026406
0.646,400,"[[40, 63], [160, 137]]",40,160,63,160,200,200,103,297,177,223,0.4425,0.3883495145631068,0.2,0.685,0.315,0.8,0.26402640264026406
0.647,400,"[[40, 63], [160, 137]]",40,160,63,160,200,200,103,297,177,223,0.4425,0.3883495145631068,0.2,0.685,0.315,0.8,0.26402640264026406
0.648,400,"[[40, 63], [160, 137]]",40,160,63,160,200,200,103,297,177,223,0.4425,0.3883495145631068,0.2,0.685,0.315,0.8,0.26402640264026406
0.649,400,"[[40, 63], [160, 137]]",40,160,63,160,200,200,103,297,177,223,0.4425,0.3883495145631068,0.2,0.685,0.315,0.8,0.26402640264026406
0.65,400,"[[40, 63], [160, 137]]",40,160,63,160,200,200,103,297,177,223,0.4425,0.3883495145631068,0.2,0.685,0.315,0.8,0.26402640264026406
0.651,400,"[[39, 63], [161, 137]]",39,161,63,161,200,200,102,298,176,224,0.44,0.38235294117647056,0.195,0.685,0.315,0.805,0.2582781456953642
0.652,400,"[[39, 63], [161, 137]]",39,161,63,161,200,200,102,298,176,224,0.44,0.38235294117647056,0.195,0.685,0.315,0.805,0.2582781456953642
0.653,400,"[[39, 63], [161, 137]]",39,161,63,161,200,200,102,298,176,224,0.44,0.38235294117647056,0.195,0.685,0.315,0.805,0.2582781456953642
0.654,400,"[[38, 63], [162, 137]]",38,162,63,162,200,200,101,299,175,225,0.4375,0.37623762376237624,0.19,0.685,0.315,0.81,0.25249169435215946
0.655,400,"[[38, 62], [162, 138]]",38,162,62,162,200,200,100,300,176,224,0.44,0.38,0.19,0.69,0.31,0.81,0.2533333333333333
0.656,400,"[[38, 62], [162, 138]]",38,162,62,162,200,200,100,300,176,224,0.44,0.38,0.19,0.69,0.31,0.81,0.2533333333333333
0.657,400,"[[38, 62], [162, 138]]",38,162,62,162,200,200,100,300,176,224,0.44,0.38,0.19,0.69,0.31,0.81,0.2533333333333333
0.658,400,"[[38, 62], [162, 138]]",38,162,62,162,200,200,100,300,176,224,0.44,0.38,0.19,0.69,0.31,0.81,0.2533333333333333
0.659,400,"[[37, 62], [163, 138]]",37,163,62,163,200,200,99,301,175,225,0.4375,0.37373737373737376,0.185,0.69,0.31,0.815,0.24749163879598662
0.66,400,"[[37, 62], [163, 138]]",37,163,62,163,200,200,99,301,175,225,0.4375,0.37373737373737376,0.185,0.69,0.31,0.815,0.24749163879598662
0.661,400,"[[37, 62], [163, 138]]",37,163,62,163,200,200,99,301,175,225,0.4375,0.37373737373737376,0.185,0.69,0.31,0.815,0.24749163879598662
0.662,400,"[[36, 62], [164, 138]]",36,164,62,164,200,200,98,302,174,226,0.435,0.3673469387755102,0.18,0.69,0.31,0.82,0.24161073825503357
0.663,400,"[[36, 61], [164, 139]]",36,164,61,164,200,200,97,303,175,225,0.4375,0.3711340206185567,0.18,0.695,0.305,0.82,0.24242424242424243
0.664,400,"[[36, 61], [164, 139]]",36,164,61,164,200,200,97,303,175,225,0.4375,0.3711340206185567,0.18,0.695,0.305,0.82,0.24242424242424243
0.665,400,"[[36, 60], [164, 140]]",36,164,60,164,200,200,96,304,176,224,0.44,0.375,0.18,0.7,0.3,0.82,0.24324324324324328
0.666,400,"[[36, 60], [164, 140]]",36,164,60,164,200,200,96,304,176,224,0.44,0.375,0.18,0.7,0.3,0.82,0.24324324324324328
0.667,400,"[[35, 60], [165, 140]]",35,165,60,165,200,200,95,305,175,225,0.4375,0.3684210526315789,0.175,0.7,0.3,0.825,0.23728813559322032
0.668,400,"[[35, 59], [165, 141]]",35,165,59,165,200,200,94,306,176,224,0.44,0.3723404255319149,0.175,0.705,0.295,0.825,0.23809523809523808
0.669,400,"[[35, 59], [165, 141]]",35,165,59,165,200,200,94,306,176,224,0.44,0.3723404255319149,0.175,0.705,0.295,0.825,0.23809523809523808
0.67,400,"[[35, 59], [165, 141]]",35,165,59,165,200,200,94,306,176,224,0.44,0.3723404255319149,0.175,0.705,0.295,0.825,0.23809523809523808
0.671,400,"[[35, 59], [165, 141]]",35,165,59,165,200,200,94,306,176,224,0.44,0.3723404255319149,0.175,0.705,0.295,0.825,0.23809523809523808
0.672,400,"[[35, 59], [165, 141]]",35,165,59,165,200,200,94,306,176,224,0.44,0.3723404255319149,0.175,0.705,0.295,0.825,0.23809523809523808
0.673,400,"[[35, 59], [165, 141]]",35,165,59,165,200,200,94,306,176,224,0.44,0.3723404255319149,0.175,0.705,0.295,0.825,0.23809523809523808
0.674,400,"[[33, 59], [167, 141]]",33,167,59,167,200,200,92,308,174,226,0.435,0.358695652173913,0.165,0.705,0.295,0.835,0.226027397260274
0.675,400,"[[33, 59], [167, 141]]",33,167,59,167,200,200,92,308,174,226,0.435,0.358695652173913,0.165,0.705,0.295,0.835,0.226027397260274
0.676,400,"[[33, 58], [167, 142]]",33,167,58,167,200,200,91,309,175,225,0.4375,0.3626373626373626,0.165,0.71,0.29,0.835,0.22680412371134023
0.677,400,"[[33, 57], [167, 143]]",33,167,57,167,200,200,90,310,176,224,0.44,0.36666666666666664,0.165,0.715,0.285,0.835,0.22758620689655173
0.678,400,"[[32, 57], [168, 143]]",32,168,57,168,200,200,89,311,175,225,0.4375,0.3595505617977528,0.16,0.715,0.285,0.84,0.22145328719723184
0.679,400,"[[32, 57], [168, 143]]",32,168,57,168,200,200,89,311,175,225,0.4375,0.3595505617977528,0.16,0.715,0.285,0.84,0.22145328719723184
0.68,400,"[[32, 57], [168, 143]]",32,168,57,168,200,200,89,311,175,225,0.4375,0.3595505617977528,0.16,0.715,0.285,0.84,0.22145328719723184
0.681,400,"[[31, 56], [169, 144]]",31,169,56,169,200,200,87,313,175,225,0.4375,0.3563218390804598,0.155,0.72,0.28,0.845,0.2160278745644599
0.682,400,"[[31, 56], [169, 144]]",31,169,56,169,200,200,87,313,175,225,0.4375,0.3563218390804598,0.155,0.72,0.28,0.845,0.2160278745644599
0.683,400,"[[31, 56], [169, 144]]",31,169,56,169,200,200,87,313,175,225,0.4375,0.3563218390804598,0.155,0.72,0.28,0.845,0.2160278745644599
0.684,400,"[[31, 56], [169, 144]]",31,169,56,169,200,200,87,313,175,225,0.4375,0.3563218390804598,0.155,0.72,0.28,0.845,0.2160278745644599
0.685,400,"[[31, 56], [169, 144]]",31,169,56,169,200,200,87,313,175,225,0.4375,0.3563218390804598,0.155,0.72,0.28,0.845,0.2160278745644599
0.686,400,"[[31, 56], [169, 144]]",31,169,56,169,200,200,87,313,175,225,0.4375,0.3563218390804598,0.155,0.72,0.28,0.845,0.2160278745644599
0.687,400,"[[31, 56], [169, 144]]",31,169,56,169,200,200,87,313,175,225,0.4375,0.3563218390804598,0.155,0.72,0.28,0.845,0.2160278745644599
0.688,400,"[[31, 56], [169, 144]]",31,169,56,169,200,200,87,313,175,225,0.4375,0.3563218390804598,0.155,0.72,0.28,0.845,0.2160278745644599
0.689,400,"[[30, 56], [170, 144]]",30,170,56,170,200,200,86,314,174,226,0.435,0.3488372093023256,0.15,0.72,0.28,0.85,0.20979020979020982
0.69,400,"[[29, 56], [171, 144]]",29,171,56,171,200,200,85,315,173,227,0.4325,0.3411764705882353,0.145,0.72,0.28,0.855,0.20350877192982453
0.691,400,"[[29, 55], [171, 145]]",29,171,55,171,200,200,84,316,174,226,0.435,0.34523809523809523,0.145,0.725,0.275,0.855,0.20422535211267603
0.692,400,"[[29, 55], [171, 145]]",29,171,55,171,200,200,84,316,174,226,0.435,0.34523809523809523,0.145,0.725,0.275,0.855,0.20422535211267603
0.693,400,"[[29, 55], [171, 145]]",29,171,55,171,200,200,84,316,174,226,0.435,0.34523809523809523,0.145,0.725,0.275,0.855,0.20422535211267603
0.694,400,"[[29, 55], [171, 145]]",29,171,55,171,200,200,84,316,174,226,0.435,0.34523809523809523,0.145,0.725,0.275,0.855,0.20422535211267603
0.695,400,"[[29, 55], [171, 145]]",29,171,55,171,200,200,84,316,174,226,0.435,0.34523809523809523,0.145,0.725,0.275,0.855,0.20422535211267603
0.696,400,"[[29, 55], [171, 145]]",29,171,55,171,200,200,84,316,174,226,0.435,0.34523809523809523,0.145,0.725,0.275,0.855,0.20422535211267603
0.697,400,"[[29, 54], [171, 146]]",29,171,54,171,200,200,83,317,175,225,0.4375,0.3493975903614458,0.145,0.73,0.27,0.855,0.20494699646643108
0.698,400,"[[29, 54], [171, 146]]",29,171,54,171,200,200,83,317,175,225,0.4375,0.3493975903614458,0.145,0.73,0.27,0.855,0.20494699646643108
0.699,400,"[[29, 53], [171, 147]]",29,171,53,171,200,200,82,318,176,224,0.44,0.35365853658536583,0.145,0.735,0.265,0.855,0.20567375886524822
0.7,400,"[[29, 53], [171, 147]]",29,171,53,171,200,200,82,318,176,224,0.44,0.35365853658536583,0.145,0.735,0.265,0.855,0.20567375886524822
0.701,400,"[[29, 52], [171, 148]]",29,171,52,171,200,200,81,319,177,223,0.4425,0.35802469135802467,0.145,0.74,0.26,0.855,0.20640569395017794
0.702,400,"[[29, 52], [171, 148]]",29,171,52,171,200,200,81,319,177,223,0.4425,0.35802469135802467,0.145,0.74,0.26,0.855,0.20640569395017794
0.703,400,"[[29, 52], [171, 148]]",29,171,52,171,200,200,81,319,177,223,0.4425,0.35802469135802467,0.145,0.74,0.26,0.855,0.20640569395017794
0.704,400,"[[29, 52], [171, 148]]",29,171,52,171,200,200,81,319,177,223,0.4425,0.35802469135802467,0.145,0.74,0.26,0.855,0.20640569395017794
0.705,400,"[[27, 51], [173, 149]]",27,173,51,173,200,200,78,322,176,224,0.44,0.34615384615384615,0.135,0.745,0.255,0.865,0.19424460431654678
0.706,400,"[[26, 51], [174, 149]]",26,174,51,174,200,200,77,323,175,225,0.4375,0.33766233766233766,0.13,0.745,0.255,0.87,0.18772563176895307
0.707,400,"[[26, 51], [174, 149]]",26,174,51,174,200,200,77,323,175,225,0.4375,0.33766233766233766,0.13,0.745,0.255,0.87,0.18772563176895307
0.708,400,"[[26, 51], [174, 149]]",26,174,51,174,200,200,77,323,175,225,0.4375,0.33766233766233766,0.13,0.745,0.255,0.87,0.18772563176895307
0.709,400,"[[26, 51], [174, 149]]",26,174,51,174,200,200,77,323,175,225,0.4375,0.33766233766233766,0.13,0.745,0.255,0.87,0.18772563176895307
0.71,400,"[[26, 51], [174, 149]]",26,174,51,174,200,200,77,323,175,225,0.4375,0.33766233766233766,0.13,0.745,0.255,0.87,0.18772563176895307
0.711,400,"[[26, 51], [174, 149]]",26,174,51,174,200,200,77,323,175,225,0.4375,0.33766233766233766,0.13,0.745,0.255,0.87,0.18772563176895307
0.712,400,"[[26, 51], [174, 149]]",26,174,51,174,200,200,77,323,175,225,0.4375,0.33766233766233766,0.13,0.745,0.255,0.87,0.18772563176895307
0.713,400,"[[25, 51], [175, 149]]",25,175,51,175,200,200,76,324,174,226,0.435,0.32894736842105265,0.125,0.745,0.255,0.875,0.18115942028985507
0.714,400,"[[25, 51], [175, 149]]",25,175,51,175,200,200,76,324,174,226,0.435,0.32894736842105265,0.125,0.745,0.255,0.875,0.18115942028985507
0.715,400,"[[25, 51], [175, 149]]",25,175,51,175,200,200,76,324,174,226,0.435,0.32894736842105265,0.125,0.745,0.255,0.875,0.18115942028985507
0.716,400,"[[25, 50], [175, 150]]",25,175,50,175,200,200,75,325,175,225,0.4375,0.3333333333333333,0.125,0.75,0.25,0.875,0.18181818181818182
0.717,400,"[[25, 50], [175, 150]]",25,175,50,175,200,200,75,325,175,225,0.4375,0.3333333333333333,0.125,0.75,0.25,0.875,0.18181818181818182
0.718,400,"[[25, 50], [175, 150]]",25,175,50,175,200,200,75,325,175,225,0.4375,0.3333333333333333,0.125,0.75,0.25,0.875,0.18181818181818182
0.719,400,"[[25, 50], [175, 150]]",25,175,50,175,200,200,75,325,175,225,0.4375,0.3333333333333333,0.125,0.75,0.25,0.875,0.18181818181818182
0.72,400,"[[25, 50], [175, 150]]",25,175,50,175,200,200,75,325,175,225,0.4375,0.3333333333333333,0.125,0.75,0.25,0.875,0.18181818181818182
0.721,400,"[[25, 49], [175, 151]]",25,175,49,175,200,200,74,326,176,224,0.44,0.33783783783783783,0.125,0.755,0.245,0.875,0.18248175182481752
0.722,400,"[[25, 48], [175, 152]]",25,175,48,175,200,200,73,327,177,223,0.4425,0.3424657534246575,0.125,0.76,0.24,0.875,0.18315018315018314
0.723,400,"[[25, 48], [175, 152]]",25,175,48,175,200,200,73,327,177,223,0.4425,0.3424657534246575,0.125,0.76,0.24,0.875,0.18315018315018314
0.724,400,"[[25, 48], [175, 152]]",25,175,48,175,200,200,73,327,177,223,0.4425,0.3424657534246575,0.125,0.76,0.24,0.875,0.18315018315018314
0.725,400,"[[24, 48], [176, 152]]",24,176,48,176,200,200,72,328,176,224,0.44,0.3333333333333333,0.12,0.76,0.24,0.88,0.1764705882352941
0.726,400,"[[24, 48], [176, 152]]",24,176,48,176,200,200,72,328,176,224,0.44,0.3333333333333333,0.12,0.76,0.24,0.88,0.1764705882352941
0.727,400,"[[24, 47], [176, 153]]",24,176,47,176,200,200,71,329,177,223,0.4425,0.3380281690140845,0.12,0.765,0.235,0.88,0.17712177121771217
0.728,400,"[[24, 47], [176, 153]]",24,176,47,176,200,200,71,329,177,223,0.4425,0.3380281690140845,0.12,0.765,0.235,0.88,0.17712177121771217
0.729,400,"[[24, 47], [176, 153]]",24,176,47,176,200,200,71,329,177,223,0.4425,0.3380281690140845,0.12,0.765,0.235,0.88,0.17712177121771217
0.73,400,"[[24, 47], [176, 153]]",24,176,47,176,200,200,71,329,177,223,0.4425,0.3380281690140845,0.12,0.765,0.235,0.88,0.17712177121771217
0.731,400,"[[23, 47], [177, 153]]",23,177,47,177,200,200,70,330,176,224,0.44,0.32857142857142857,0.115,0.765,0.235,0.885,0.1703703703703704
0.732,400,"[[23, 47], [177, 153]]",23,177,47,177,200,200,70,330,176,224,0.44,0.32857142857142857,0.115,0.765,0.235,0.885,0.1703703703703704
0.733,400,"[[23, 47], [177, 153]]",23,177,47,177,200,200,70,330,176,224,0.44,0.32857142857142857,0.115,0.765,0.235,0.885,0.1703703703703704
0.734,400,"[[23, 47], [177, 153]]",23,177,47,177,200,200,70,330,176,224,0.44,0.32857142857142857,0.115,0.765,0.235,0.885,0.1703703703703704
0.735,400,"[[23, 46], [177, 154]]",23,177,46,177,200,200,69,331,177,223,0.4425,0.3333333333333333,0.115,0.77,0.23,0.885,0.17100371747211895
0.736,400,"[[23, 45], [177, 155]]",23,177,45,177,200,200,68,332,178,222,0.445,0.3382352941176471,0.115,0.775,0.225,0.885,0.17164179104477614
0.737,400,"[[23, 45], [177, 155]]",23,177,45,177,200,200,68,332,178,222,0.445,0.3382352941176471,0.115,0.775,0.225,0.885,0.17164179104477614
0.738,400,"[[23, 44], [177, 156]]",23,177,44,177,200,200,67,333,179,221,0.4475,0.34328358208955223,0.115,0.78,0.22,0.885,0.17228464419475656
0.739,400,"[[22, 44], [178, 156]]",22,178,44,178,200,200,66,334,178,222,0.445,0.3333333333333333,0.11,0.78,0.22,0.89,0.16541353383458648
0.74,400,"[[22, 44], [178, 156]]",22,178,44,178,200,200,66,334,178,222,0.445,0.3333333333333333,0.11,0.78,0.22,0.89,0.16541353383458648
0.741,400,"[[22, 44], [178, 156]]",22,178,44,178,200,200,66,334,178,222,0.445,0.3333333333333333,0.11,0.78,0.22,0.89,0.16541353383458648
0.742,400,"[[22, 44], [178, 156]]",22,178,44,178,200,200,66,334,178,222,0.445,0.3333333333333333,0.11,0.78,0.22,0.89,0.16541353383458648
0.743,400,"[[22, 43], [178, 157]]",22,178,43,178,200,200,65,335,179,221,0.4475,0.3384615384615385,0.11,0.785,0.215,0.89,0.16603773584905662
0.744,400,"[[22, 43], [178, 157]]",22,178,43,178,200,200,65,335,179,221,0.4475,0.3384615384615385,0.11,0.785,0.215,0.89,0.16603773584905662
0.745,400,"[[22, 42], [178, 158]]",22,178,42,178,200,200,64,336,180,220,0.45,0.34375,0.11,0.79,0.21,0.89,0.16666666666666666
0.746,400,"[[22, 40], [178, 160]]",22,178,40,178,200,200,62,338,182,218,0.455,0.3548387096774194,0.11,0.8,0.2,0.89,0.16793893129770993
0.747,400,"[[22, 39], [178, 161]]",22,178,39,178,200,200,61,339,183,217,0.4575,0.36065573770491804,0.11,0.805,0.195,0.89,0.1685823754789272
0.748,400,"[[22, 39], [178, 161]]",22,178,39,178,200,200,61,339,183,217,0.4575,0.36065573770491804,0.11,0.805,0.195,0.89,0.1685823754789272
0.749,400,"[[20, 39], [180, 161]]",20,180,39,180,200,200,59,341,181,219,0.4525,0.3389830508474576,0.1,0.805,0.195,0.9,0.15444015444015446
0.75,400,"[[20, 36], [180, 164]]",20,180,36,180,200,200,56,344,184,216,0.46,0.35714285714285715,0.1,0.82,0.18,0.9,0.15625
0.751,400,"[[20, 36], [180, 164]]",20,180,36,180,200,200,56,344,184,216,0.46,0.35714285714285715,0.1,0.82,0.18,0.9,0.15625
0.752,400,"[[20, 35], [180, 165]]",20,180,35,180,200,200,55,345,185,215,0.4625,0.36363636363636365,0.1,0.825,0.175,0.9,0.15686274509803924
0.753,400,"[[20, 35], [180, 165]]",20,180,35,180,200,200,55,345,185,215,0.4625,0.36363636363636365,0.1,0.825,0.175,0.9,0.15686274509803924
0.754,400,"[[19, 34], [181, 166]]",19,181,34,181,200,200,53,347,185,215,0.4625,0.3584905660377358,0.095,0.83,0.17,0.905,0.15019762845849802
0.755,400,"[[19, 34], [181, 166]]",19,181,34,181,200,200,53,347,185,215,0.4625,0.3584905660377358,0.095,0.83,0.17,0.905,0.15019762845849802
0.756,400,"[[19, 34], [181, 166]]",19,181,34,181,200,200,53,347,185,215,0.4625,0.3584905660377358,0.095,0.83,0.17,0.905,0.15019762845849802
0.757,400,"[[17, 34], [183, 166]]",17,183,34,183,200,200,51,349,183,217,0.4575,0.3333333333333333,0.085,0.83,0.17,0.915,0.1354581673306773
0.758,400,"[[17, 33], [183, 167]]",17,183,33,183,200,200,50,350,184,216,0.46,0.34,0.085,0.835,0.165,0.915,0.136
0.759,400,"[[17, 33], [183, 167]]",17,183,33,183,200,200,50,350,184,216,0.46,0.34,0.085,0.835,0.165,0.915,0.136
0.76,400,"[[17, 33], [183, 167]]",17,183,33,183,200,200,50,350,184,216,0.46,0.34,0.085,0.835,0.165,0.915,0.136
0.761,400,"[[17, 33], [183, 167]]",17,183,33,183,200,200,50,350,184,216,0.46,0.34,0.085,0.835,0.165,0.915,0.136
0.762,400,"[[15, 33], [185, 167]]",15,185,33,185,200,200,48,352,182,218,0.455,0.3125,0.075,0.835,0.165,0.925,0.12096774193548386
0.763,400,"[[15, 33], [185, 167]]",15,185,33,185,200,200,48,352,182,218,0.455,0.3125,0.075,0.835,0.165,0.925,0.12096774193548386
0.764,400,"[[15, 33], [185, 167]]",15,185,33,185,200,200,48,352,182,218,0.455,0.3125,0.075,0.835,0.165,0.925,0.12096774193548386
0.765,400,"[[15, 33], [185, 167]]",15,185,33,185,200,200,48,352,182,218,0.455,0.3125,0.075,0.835,0.165,0.925,0.12096774193548386
0.766,400,"[[15, 32], [185, 168]]",15,185,32,185,200,200,47,353,183,217,0.4575,0.3191489361702128,0.075,0.84,0.16,0.925,0.1214574898785425
0.767,400,"[[14, 32], [186, 168]]",14,186,32,186,200,200,46,354,182,218,0.455,0.30434782608695654,0.07,0.84,0.16,0.93,0.11382113821138212
0.768,400,"[[14, 32], [186, 168]]",14,186,32,186,200,200,46,354,182,218,0.455,0.30434782608695654,0.07,0.84,0.16,0.93,0.11382113821138212
0.769,400,"[[14, 32], [186, 168]]",14,186,32,186,200,200,46,354,182,218,0.455,0.30434782608695654,0.07,0.84,0.16,0.93,0.11382113821138212
0.77,400,"[[14, 32], [186, 168]]",14,186,32,186,200,200,46,354,182,218,0.455,0.30434782608695654,0.07,0.84,0.16,0.93,0.11382113821138212
0.771,400,"[[14, 32], [186, 168]]",14,186,32,186,200,200,46,354,182,218,0.455,0.30434782608695654,0.07,0.84,0.16,0.93,0.11382113821138212
0.772,400,"[[14, 32], [186, 168]]",14,186,32,186,200,200,46,354,182,218,0.455,0.30434782608695654,0.07,0.84,0.16,0.93,0.11382113821138212
0.773,400,"[[14, 32], [186, 168]]",14,186,32,186,200,200,46,354,182,218,0.455,0.30434782608695654,0.07,0.84,0.16,0.93,0.11382113821138212
0.774,400,"[[13, 32], [187, 168]]",13,187,32,187,200,200,45,355,181,219,0.4525,0.28888888888888886,0.065,0.84,0.16,0.935,0.10612244897959183
0.775,400,"[[13, 31], [187, 169]]",13,187,31,187,200,200,44,356,182,218,0.455,0.29545454545454547,0.065,0.845,0.155,0.935,0.10655737704918034
0.776,400,"[[13, 31], [187, 169]]",13,187,31,187,200,200,44,356,182,218,0.455,0.29545454545454547,0.065,0.845,0.155,0.935,0.10655737704918034
0.777,400,"[[13, 31], [187, 169]]",13,187,31,187,200,200,44,356,182,218,0.455,0.29545454545454547,0.065,0.845,0.155,0.935,0.10655737704918034
0.778,400,"[[13, 30], [187, 170]]",13,187,30,187,200,200,43,357,183,217,0.4575,0.3023255813953488,0.065,0.85,0.15,0.935,0.10699588477366255
0.779,400,"[[13, 30], [187, 170]]",13,187,30,187,200,200,43,357,183,217,0.4575,0.3023255813953488,0.065,0.85,0.15,0.935,0.10699588477366255
0.78,400,"[[13, 30], [187, 170]]",13,187,30,187,200,200,43,357,183,217,0.4575,0.3023255813953488,0.065,0.85,0.15,0.935,0.10699588477366255
0.781,400,"[[13, 30], [187, 170]]",13,187,30,187,200,200,43,357,183,217,0.4575,0.3023255813953488,0.065,0.85,0.15,0.935,0.10699588477366255
0.782,400,"[[13, 30], [187, 170]]",13,187,30,187,200,200,43,357,183,217,0.4575,0.3023255813953488,0.065,0.85,0.15,0.935,0.10699588477366255
0.783,400,"[[13, 30], [187, 170]]",13,187,30,187,200,200,43,357,183,217,0.4575,0.3023255813953488,0.065,0.85,0.15,0.935,0.10699588477366255
0.784,400,"[[13, 30], [187, 170]]",13,187,30,187,200,200,43,357,183,217,0.4575,0.3023255813953488,0.065,0.85,0.15,0.935,0.10699588477366255
0.785,400,"[[13, 30], [187, 170]]",13,187,30,187,200,200,43,357,183,217,0.4575,0.3023255813953488,0.065,0.85,0.15,0.935,0.10699588477366255
0.786,400,"[[13, 30], [187, 170]]",13,187,30,187,200,200,43,357,183,217,0.4575,0.3023255813953488,0.065,0.85,0.15,0.935,0.10699588477366255
0.787,400,"[[13, 30], [187, 170]]",13,187,30,187,200,200,43,357,183,217,0.4575,0.3023255813953488,0.065,0.85,0.15,0.935,0.10699588477366255
0.788,400,"[[13, 30], [187, 170]]",13,187,30,187,200,200,43,357,183,217,0.4575,0.3023255813953488,0.065,0.85,0.15,0.935,0.10699588477366255
0.789,400,"[[12, 29], [188, 171]]",12,188,29,188,200,200,41,359,183,217,0.4575,0.2926829268292683,0.06,0.855,0.145,0.94,0.0995850622406639
0.79,400,"[[12, 29], [188, 171]]",12,188,29,188,200,200,41,359,183,217,0.4575,0.2926829268292683,0.06,0.855,0.145,0.94,0.0995850622406639
0.791,400,"[[12, 29], [188, 171]]",12,188,29,188,200,200,41,359,183,217,0.4575,0.2926829268292683,0.06,0.855,0.145,0.94,0.0995850622406639
0.792,400,"[[12, 29], [188, 171]]",12,188,29,188,200,200,41,359,183,217,0.4575,0.2926829268292683,0.06,0.855,0.145,0.94,0.0995850622406639
0.793,400,"[[12, 29], [188, 171]]",12,188,29,188,200,200,41,359,183,217,0.4575,0.2926829268292683,0.06,0.855,0.145,0.94,0.0995850622406639
0.794,400,"[[12, 29], [188, 171]]",12,188,29,188,200,200,41,359,183,217,0.4575,0.2926829268292683,0.06,0.855,0.145,0.94,0.0995850622406639
0.795,400,"[[12, 29], [188, 171]]",12,188,29,188,200,200,41,359,183,217,0.4575,0.2926829268292683,0.06,0.855,0.145,0.94,0.0995850622406639
0.796,400,"[[12, 29], [188, 171]]",12,188,29,188,200,200,41,359,183,217,0.4575,0.2926829268292683,0.06,0.855,0.145,0.94,0.0995850622406639
0.797,400,"[[12, 29], [188, 171]]",12,188,29,188,200,200,41,359,183,217,0.4575,0.2926829268292683,0.06,0.855,0.145,0.94,0.0995850622406639
0.798,400,"[[12, 29], [188, 171]]",12,188,29,188,200,200,41,359,183,217,0.4575,0.2926829268292683,0.06,0.855,0.145,0.94,0.0995850622406639
0.799,400,"[[12, 28], [188, 172]]",12,188,28,188,200,200,40,360,184,216,0.46,0.3,0.06,0.86,0.14,0.94,0.09999999999999999
0.8,400,"[[12, 28], [188, 172]]",12,188,28,188,200,200,40,360,184,216,0.46,0.3,0.06,0.86,0.14,0.94,0.09999999999999999
0.801,400,"[[12, 28], [188, 172]]",12,188,28,188,200,200,40,360,184,216,0.46,0.3,0.06,0.86,0.14,0.94,0.09999999999999999
0.802,400,"[[12, 26], [188, 174]]",12,188,26,188,200,200,38,362,186,214,0.465,0.3157894736842105,0.06,0.87,0.13,0.94,0.10084033613445377
0.803,400,"[[12, 26], [188, 174]]",12,188,26,188,200,200,38,362,186,214,0.465,0.3157894736842105,0.06,0.87,0.13,0.94,0.10084033613445377
0.804,400,"[[12, 26], [188, 174]]",12,188,26,188,200,200,38,362,186,214,0.465,0.3157894736842105,0.06,0.87,0.13,0.94,0.10084033613445377
0.805,400,"[[12, 26], [188, 174]]",12,188,26,188,200,200,38,362,186,214,0.465,0.3157894736842105,0.06,0.87,0.13,0.94,0.10084033613445377
0.806,400,"[[12, 26], [188, 174]]",12,188,26,188,200,200,38,362,186,214,0.465,0.3157894736842105,0.06,0.87,0.13,0.94,0.10084033613445377
0.807,400,"[[10, 26], [190, 174]]",10,190,26,190,200,200,36,364,184,216,0.46,0.2777777777777778,0.05,0.87,0.13,0.95,0.08474576271186442
0.808,400,"[[10, 26], [190, 174]]",10,190,26,190,200,200,36,364,184,216,0.46,0.2777777777777778,0.05,0.87,0.13,0.95,0.08474576271186442
0.809,400,"[[10, 26], [190, 174]]",10,190,26,190,200,200,36,364,184,216,0.46,0.2777777777777778,0.05,0.87,0.13,0.95,0.08474576271186442
0.81,400,"[[10, 26], [190, 174]]",10,190,26,190,200,200,36,364,184,216,0.46,0.2777777777777778,0.05,0.87,0.13,0.95,0.08474576271186442
0.811,400,"[[10, 26], [190, 174]]",10,190,26,190,200,200,36,364,184,216,0.46,0.2777777777777778,0.05,0.87,0.13,0.95,0.08474576271186442
0.812,400,"[[10, 26], [190, 174]]",10,190,26,190,200,200,36,364,184,216,0.46,0.2777777777777778,0.05,0.87,0.13,0.95,0.08474576271186442
0.813,400,"[[10, 26], [190, 174]]",10,190,26,190,200,200,36,364,184,216,0.46,0.2777777777777778,0.05,0.87,0.13,0.95,0.08474576271186442
0.814,400,"[[10, 26], [190, 174]]",10,190,26,190,200,200,36,364,184,216,0.46,0.2777777777777778,0.05,0.87,0.13,0.95,0.08474576271186442
0.815,400,"[[10, 25], [190, 175]]",10,190,25,190,200,200,35,365,185,215,0.4625,0.2857142857142857,0.05,0.875,0.125,0.95,0.0851063829787234
0.816,400,"[[10, 25], [190, 175]]",10,190,25,190,200,200,35,365,185,215,0.4625,0.2857142857142857,0.05,0.875,0.125,0.95,0.0851063829787234
0.817,400,"[[10, 25], [190, 175]]",10,190,25,190,200,200,35,365,185,215,0.4625,0.2857142857142857,0.05,0.875,0.125,0.95,0.0851063829787234
0.818,400,"[[10, 25], [190, 175]]",10,190,25,190,200,200,35,365,185,215,0.4625,0.2857142857142857,0.05,0.875,0.125,0.95,0.0851063829787234
0.819,400,"[[10, 25], [190, 175]]",10,190,25,190,200,200,35,365,185,215,0.4625,0.2857142857142857,0.05,0.875,0.125,0.95,0.0851063829787234
0.82,400,"[[10, 25], [190, 175]]",10,190,25,190,200,200,35,365,185,215,0.4625,0.2857142857142857,0.05,0.875,0.125,0.95,0.0851063829787234
0.821,400,"[[10, 25], [190, 175]]",10,190,25,190,200,200,35,365,185,215,0.4625,0.2857142857142857,0.05,0.875,0.125,0.95,0.0851063829787234
0.822,400,"[[10, 25], [190, 175]]",10,190,25,190,200,200,35,365,185,215,0.4625,0.2857142857142857,0.05,0.875,0.125,0.95,0.0851063829787234
0.823,400,"[[10, 25], [190, 175]]",10,190,25,190,200,200,35,365,185,215,0.4625,0.2857142857142857,0.05,0.875,0.125,0.95,0.0851063829787234
0.824,400,"[[10, 25], [190, 175]]",10,190,25,190,200,200,35,365,185,215,0.4625,0.2857142857142857,0.05,0.875,0.125,0.95,0.0851063829787234
0.825,400,"[[10, 25], [190, 175]]",10,190,25,190,200,200,35,365,185,215,0.4625,0.2857142857142857,0.05,0.875,0.125,0.95,0.0851063829787234
0.826,400,"[[10, 25], [190, 175]]",10,190,25,190,200,200,35,365,185,215,0.4625,0.2857142857142857,0.05,0.875,0.125,0.95,0.0851063829787234
0.827,400,"[[10, 25], [190, 175]]",10,190,25,190,200,200,35,365,185,215,0.4625,0.2857142857142857,0.05,0.875,0.125,0.95,0.0851063829787234
0.828,400,"[[10, 25], [190, 175]]",10,190,25,190,200,200,35,365,185,215,0.4625,0.2857142857142857,0.05,0.875,0.125,0.95,0.0851063829787234
0.829,400,"[[10, 25], [190, 175]]",10,190,25,190,200,200,35,365,185,215,0.4625,0.2857142857142857,0.05,0.875,0.125,0.95,0.0851063829787234
0.83,400,"[[10, 25], [190, 175]]",10,190,25,190,200,200,35,365,185,215,0.4625,0.2857142857142857,0.05,0.875,0.125,0.95,0.0851063829787234
0.831,400,"[[10, 24], [190, 176]]",10,190,24,190,200,200,34,366,186,214,0.465,0.29411764705882354,0.05,0.88,0.12,0.95,0.08547008547008549
0.832,400,"[[10, 24], [190, 176]]",10,190,24,190,200,200,34,366,186,214,0.465,0.29411764705882354,0.05,0.88,0.12,0.95,0.08547008547008549
0.833,400,"[[9, 23], [191, 177]]",9,191,23,191,200,200,32,368,186,214,0.465,0.28125,0.045,0.885,0.115,0.955,0.07758620689655173
0.834,400,"[[9, 23], [191, 177]]",9,191,23,191,200,200,32,368,186,214,0.465,0.28125,0.045,0.885,0.115,0.955,0.07758620689655173
0.835,400,"[[9, 21], [191, 179]]",9,191,21,191,200,200,30,370,188,212,0.47,0.3,0.045,0.895,0.105,0.955,0.0782608695652174
0.836,400,"[[9, 21], [191, 179]]",9,191,21,191,200,200,30,370,188,212,0.47,0.3,0.045,0.895,0.105,0.955,0.0782608695652174
0.837,400,"[[9, 21], [191, 179]]",9,191,21,191,200,200,30,370,188,212,0.47,0.3,0.045,0.895,0.105,0.955,0.0782608695652174
0.838,400,"[[9, 21], [191, 179]]",9,191,21,191,200,200,30,370,188,212,0.47,0.3,0.045,0.895,0.105,0.955,0.0782608695652174
0.839,400,"[[9, 21], [191, 179]]",9,191,21,191,200,200,30,370,188,212,0.47,0.3,0.045,0.895,0.105,0.955,0.0782608695652174
0.84,400,"[[9, 21], [191, 179]]",9,191,21,191,200,200,30,370,188,212,0.47,0.3,0.045,0.895,0.105,0.955,0.0782608695652174
0.841,400,"[[9, 21], [191, 179]]",9,191,21,191,200,200,30,370,188,212,0.47,0.3,0.045,0.895,0.105,0.955,0.0782608695652174
0.842,400,"[[9, 21], [191, 179]]",9,191,21,191,200,200,30,370,188,212,0.47,0.3,0.045,0.895,0.105,0.955,0.0782608695652174
0.843,400,"[[9, 21], [191, 179]]",9,191,21,191,200,200,30,370,188,212,0.47,0.3,0.045,0.895,0.105,0.955,0.0782608695652174
0.844,400,"[[9, 21], [191, 179]]",9,191,21,191,200,200,30,370,188,212,0.47,0.3,0.045,0.895,0.105,0.955,0.0782608695652174
0.845,400,"[[9, 21], [191, 179]]",9,191,21,191,200,200,30,370,188,212,0.47,0.3,0.045,0.895,0.105,0.955,0.0782608695652174
0.846,400,"[[9, 20], [191, 180]]",9,191,20,191,200,200,29,371,189,211,0.4725,0.3103448275862069,0.045,0.9,0.1,0.955,0.07860262008733625
0.847,400,"[[9, 20], [191, 180]]",9,191,20,191,200,200,29,371,189,211,0.4725,0.3103448275862069,0.045,0.9,0.1,0.955,0.07860262008733625
0.848,400,"[[9, 20], [191, 180]]",9,191,20,191,200,200,29,371,189,211,0.4725,0.3103448275862069,0.045,0.9,0.1,0.955,0.07860262008733625
0.849,400,"[[9, 20], [191, 180]]",9,191,20,191,200,200,29,371,189,211,0.4725,0.3103448275862069,0.045,0.9,0.1,0.955,0.07860262008733625
0.85,400,"[[9, 20], [191, 180]]",9,191,20,191,200,200,29,371,189,211,0.4725,0.3103448275862069,0.045,0.9,0.1,0.955,0.07860262008733625
0.851,400,"[[9, 20], [191, 180]]",9,191,20,191,200,200,29,371,189,211,0.4725,0.3103448275862069,0.045,0.9,0.1,0.955,0.07860262008733625
0.852,400,"[[9, 20], [191, 180]]",9,191,20,191,200,200,29,371,189,211,0.4725,0.3103448275862069,0.045,0.9,0.1,0.955,0.07860262008733625
0.853,400,"[[9, 20], [191, 180]]",9,191,20,191,200,200,29,371,189,211,0.4725,0.3103448275862069,0.045,0.9,0.1,0.955,0.07860262008733625
0.854,400,"[[9, 20], [191, 180]]",9,191,20,191,200,200,29,371,189,211,0.4725,0.3103448275862069,0.045,0.9,0.1,0.955,0.07860262008733625
0.855,400,"[[9, 20], [191, 180]]",9,191,20,191,200,200,29,371,189,211,0.4725,0.3103448275862069,0.045,0.9,0.1,0.955,0.07860262008733625
0.856,400,"[[9, 20], [191, 180]]",9,191,20,191,200,200,29,371,189,211,0.4725,0.3103448275862069,0.045,0.9,0.1,0.955,0.07860262008733625
0.857,400,"[[9, 20], [191, 180]]",9,191,20,191,200,200,29,371,189,211,0.4725,0.3103448275862069,0.045,0.9,0.1,0.955,0.07860262008733625
0.858,400,"[[9, 20], [191, 180]]",9,191,20,191,200,200,29,371,189,211,0.4725,0.3103448275862069,0.045,0.9,0.1,0.955,0.07860262008733625
0.859,400,"[[9, 20], [191, 180]]",9,191,20,191,200,200,29,371,189,211,0.4725,0.3103448275862069,0.045,0.9,0.1,0.955,0.07860262008733625
0.86,400,"[[9, 20], [191, 180]]",9,191,20,191,200,200,29,371,189,211,0.4725,0.3103448275862069,0.045,0.9,0.1,0.955,0.07860262008733625
0.861,400,"[[9, 20], [191, 180]]",9,191,20,191,200,200,29,371,189,211,0.4725,0.3103448275862069,0.045,0.9,0.1,0.955,0.07860262008733625
0.862,400,"[[9, 20], [191, 180]]",9,191,20,191,200,200,29,371,189,211,0.4725,0.3103448275862069,0.045,0.9,0.1,0.955,0.07860262008733625
0.863,400,"[[7, 20], [193, 180]]",7,193,20,193,200,200,27,373,187,213,0.4675,0.25925925925925924,0.035,0.9,0.1,0.965,0.0616740088105727
0.864,400,"[[7, 20], [193, 180]]",7,193,20,193,200,200,27,373,187,213,0.4675,0.25925925925925924,0.035,0.9,0.1,0.965,0.0616740088105727
0.865,400,"[[7, 20], [193, 180]]",7,193,20,193,200,200,27,373,187,213,0.4675,0.25925925925925924,0.035,0.9,0.1,0.965,0.0616740088105727
0.866,400,"[[7, 20], [193, 180]]",7,193,20,193,200,200,27,373,187,213,0.4675,0.25925925925925924,0.035,0.9,0.1,0.965,0.0616740088105727
0.867,400,"[[7, 20], [193, 180]]",7,193,20,193,200,200,27,373,187,213,0.4675,0.25925925925925924,0.035,0.9,0.1,0.965,0.0616740088105727
0.868,400,"[[7, 19], [193, 181]]",7,193,19,193,200,200,26,374,188,212,0.47,0.2692307692307692,0.035,0.905,0.095,0.965,0.06194690265486726
0.869,400,"[[7, 19], [193, 181]]",7,193,19,193,200,200,26,374,188,212,0.47,0.2692307692307692,0.035,0.905,0.095,0.965,0.06194690265486726
0.87,400,"[[7, 19], [193, 181]]",7,193,19,193,200,200,26,374,188,212,0.47,0.2692307692307692,0.035,0.905,0.095,0.965,0.06194690265486726
0.871,400,"[[7, 19], [193, 181]]",7,193,19,193,200,200,26,374,188,212,0.47,0.2692307692307692,0.035,0.905,0.095,0.965,0.06194690265486726
0.872,400,"[[7, 19], [193, 181]]",7,193,19,193,200,200,26,374,188,212,0.47,0.2692307692307692,0.035,0.905,0.095,0.965,0.06194690265486726
0.873,400,"[[7, 19], [193, 181]]",7,193,19,193,200,200,26,374,188,212,0.47,0.2692307692307692,0.035,0.905,0.095,0.965,0.06194690265486726
0.874,400,"[[7, 19], [193, 181]]",7,193,19,193,200,200,26,374,188,212,0.47,0.2692307692307692,0.035,0.905,0.095,0.965,0.06194690265486726
0.875,400,"[[7, 19], [193, 181]]",7,193,19,193,200,200,26,374,188,212,0.47,0.2692307692307692,0.035,0.905,0.095,0.965,0.06194690265486726
0.876,400,"[[7, 19], [193, 181]]",7,193,19,193,200,200,26,374,188,212,0.47,0.2692307692307692,0.035,0.905,0.095,0.965,0.06194690265486726
0.877,400,"[[7, 19], [193, 181]]",7,193,19,193,200,200,26,374,188,212,0.47,0.2692307692307692,0.035,0.905,0.095,0.965,0.06194690265486726
0.878,400,"[[7, 19], [193, 181]]",7,193,19,193,200,200,26,374,188,212,0.47,0.2692307692307692,0.035,0.905,0.095,0.965,0.06194690265486726
0.879,400,"[[7, 19], [193, 181]]",7,193,19,193,200,200,26,374,188,212,0.47,0.2692307692307692,0.035,0.905,0.095,0.965,0.06194690265486726
0.88,400,"[[7, 19], [193, 181]]",7,193,19,193,200,200,26,374,188,212,0.47,0.2692307692307692,0.035,0.905,0.095,0.965,0.06194690265486726
0.881,400,"[[7, 19], [193, 181]]",7,193,19,193,200,200,26,374,188,212,0.47,0.2692307692307692,0.035,0.905,0.095,0.965,0.06194690265486726
0.882,400,"[[7, 19], [193, 181]]",7,193,19,193,200,200,26,374,188,212,0.47,0.2692307692307692,0.035,0.905,0.095,0.965,0.06194690265486726
0.883,400,"[[7, 19], [193, 181]]",7,193,19,193,200,200,26,374,188,212,0.47,0.2692307692307692,0.035,0.905,0.095,0.965,0.06194690265486726
0.884,400,"[[6, 19], [194, 181]]",6,194,19,194,200,200,25,375,187,213,0.4675,0.24,0.03,0.905,0.095,0.97,0.05333333333333333
0.885,400,"[[6, 19], [194, 181]]",6,194,19,194,200,200,25,375,187,213,0.4675,0.24,0.03,0.905,0.095,0.97,0.05333333333333333
0.886,400,"[[6, 19], [194, 181]]",6,194,19,194,200,200,25,375,187,213,0.4675,0.24,0.03,0.905,0.095,0.97,0.05333333333333333
0.887,400,"[[5, 19], [195, 181]]",5,195,19,195,200,200,24,376,186,214,0.465,0.20833333333333334,0.025,0.905,0.095,0.975,0.044642857142857144
0.888,400,"[[5, 19], [195, 181]]",5,195,19,195,200,200,24,376,186,214,0.465,0.20833333333333334,0.025,0.905,0.095,0.975,0.044642857142857144
0.889,400,"[[5, 19], [195, 181]]",5,195,19,195,200,200,24,376,186,214,0.465,0.20833333333333334,0.025,0.905,0.095,0.975,0.044642857142857144
0.89,400,"[[5, 19], [195, 181]]",5,195,19,195,200,200,24,376,186,214,0.465,0.20833333333333334,0.025,0.905,0.095,0.975,0.044642857142857144
0.891,400,"[[5, 19], [195, 181]]",5,195,19,195,200,200,24,376,186,214,0.465,0.20833333333333334,0.025,0.905,0.095,0.975,0.044642857142857144
0.892,400,"[[5, 18], [195, 182]]",5,195,18,195,200,200,23,377,187,213,0.4675,0.21739130434782608,0.025,0.91,0.09,0.975,0.04484304932735426
0.893,400,"[[5, 17], [195, 183]]",5,195,17,195,200,200,22,378,188,212,0.47,0.22727272727272727,0.025,0.915,0.085,0.975,0.04504504504504505
0.894,400,"[[5, 17], [195, 183]]",5,195,17,195,200,200,22,378,188,212,0.47,0.22727272727272727,0.025,0.915,0.085,0.975,0.04504504504504505
0.895,400,"[[5, 17], [195, 183]]",5,195,17,195,200,200,22,378,188,212,0.47,0.22727272727272727,0.025,0.915,0.085,0.975,0.04504504504504505
0.896,400,"[[5, 17], [195, 183]]",5,195,17,195,200,200,22,378,188,212,0.47,0.22727272727272727,0.025,0.915,0.085,0.975,0.04504504504504505
0.897,400,"[[5, 16], [195, 184]]",5,195,16,195,200,200,21,379,189,211,0.4725,0.23809523809523808,0.025,0.92,0.08,0.975,0.04524886877828054
0.898,400,"[[5, 16], [195, 184]]",5,195,16,195,200,200,21,379,189,211,0.4725,0.23809523809523808,0.025,0.92,0.08,0.975,0.04524886877828054
0.899,400,"[[5, 16], [195, 184]]",5,195,16,195,200,200,21,379,189,211,0.4725,0.23809523809523808,0.025,0.92,0.08,0.975,0.04524886877828054
0.9,400,"[[5, 16], [195, 184]]",5,195,16,195,200,200,21,379,189,211,0.4725,0.23809523809523808,0.025,0.92,0.08,0.975,0.04524886877828054
0.901,400,"[[5, 16], [195, 184]]",5,195,16,195,200,200,21,379,189,211,0.4725,0.23809523809523808,0.025,0.92,0.08,0.975,0.04524886877828054
0.902,400,"[[5, 16], [195, 184]]",5,195,16,195,200,200,21,379,189,211,0.4725,0.23809523809523808,0.025,0.92,0.08,0.975,0.04524886877828054
0.903,400,"[[5, 15], [195, 185]]",5,195,15,195,200,200,20,380,190,210,0.475,0.25,0.025,0.925,0.075,0.975,0.045454545454545456
0.904,400,"[[4, 15], [196, 185]]",4,196,15,196,200,200,19,381,189,211,0.4725,0.21052631578947367,0.02,0.925,0.075,0.98,0.03652968036529681
0.905,400,"[[4, 15], [196, 185]]",4,196,15,196,200,200,19,381,189,211,0.4725,0.21052631578947367,0.02,0.925,0.075,0.98,0.03652968036529681
0.906,400,"[[4, 15], [196, 185]]",4,196,15,196,200,200,19,381,189,211,0.4725,0.21052631578947367,0.02,0.925,0.075,0.98,0.03652968036529681
0.907,400,"[[4, 15], [196, 185]]",4,196,15,196,200,200,19,381,189,211,0.4725,0.21052631578947367,0.02,0.925,0.075,0.98,0.03652968036529681
0.908,400,"[[4, 15], [196, 185]]",4,196,15,196,200,200,19,381,189,211,0.4725,0.21052631578947367,0.02,0.925,0.075,0.98,0.03652968036529681
0.909,400,"[[4, 15], [196, 185]]",4,196,15,196,200,200,19,381,189,211,0.4725,0.21052631578947367,0.02,0.925,0.075,0.98,0.03652968036529681
0.91,400,"[[4, 15], [196, 185]]",4,196,15,196,200,200,19,381,189,211,0.4725,0.21052631578947367,0.02,0.925,0.075,0.98,0.03652968036529681
0.911,400,"[[4, 15], [196, 185]]",4,196,15,196,200,200,19,381,189,211,0.4725,0.21052631578947367,0.02,0.925,0.075,0.98,0.03652968036529681
0.912,400,"[[4, 15], [196, 185]]",4,196,15,196,200,200,19,381,189,211,0.4725,0.21052631578947367,0.02,0.925,0.075,0.98,0.03652968036529681
0.913,400,"[[4, 15], [196, 185]]",4,196,15,196,200,200,19,381,189,211,0.4725,0.21052631578947367,0.02,0.925,0.075,0.98,0.03652968036529681
0.914,400,"[[4, 15], [196, 185]]",4,196,15,196,200,200,19,381,189,211,0.4725,0.21052631578947367,0.02,0.925,0.075,0.98,0.03652968036529681
0.915,400,"[[4, 15], [196, 185]]",4,196,15,196,200,200,19,381,189,211,0.4725,0.21052631578947367,0.02,0.925,0.075,0.98,0.03652968036529681
0.916,400,"[[4, 15], [196, 185]]",4,196,15,196,200,200,19,381,189,211,0.4725,0.21052631578947367,0.02,0.925,0.075,0.98,0.03652968036529681
0.917,400,"[[4, 15], [196, 185]]",4,196,15,196,200,200,19,381,189,211,0.4725,0.21052631578947367,0.02,0.925,0.075,0.98,0.03652968036529681
0.918,400,"[[4, 15], [196, 185]]",4,196,15,196,200,200,19,381,189,211,0.4725,0.21052631578947367,0.02,0.925,0.075,0.98,0.03652968036529681
0.919,400,"[[4, 15], [196, 185]]",4,196,15,196,200,200,19,381,189,211,0.4725,0.21052631578947367,0.02,0.925,0.075,0.98,0.03652968036529681
0.92,400,"[[4, 15], [196, 185]]",4,196,15,196,200,200,19,381,189,211,0.4725,0.21052631578947367,0.02,0.925,0.075,0.98,0.03652968036529681
0.921,400,"[[4, 15], [196, 185]]",4,196,15,196,200,200,19,381,189,211,0.4725,0.21052631578947367,0.02,0.925,0.075,0.98,0.03652968036529681
0.922,400,"[[4, 15], [196, 185]]",4,196,15,196,200,200,19,381,189,211,0.4725,0.21052631578947367,0.02,0.925,0.075,0.98,0.03652968036529681
0.923,400,"[[4, 15], [196, 185]]",4,196,15,196,200,200,19,381,189,211,0.4725,0.21052631578947367,0.02,0.925,0.075,0.98,0.03652968036529681
0.924,400,"[[4, 15], [196, 185]]",4,196,15,196,200,200,19,381,189,211,0.4725,0.21052631578947367,0.02,0.925,0.075,0.98,0.03652968036529681
0.925,400,"[[4, 15], [196, 185]]",4,196,15,196,200,200,19,381,189,211,0.4725,0.21052631578947367,0.02,0.925,0.075,0.98,0.03652968036529681
0.926,400,"[[4, 15], [196, 185]]",4,196,15,196,200,200,19,381,189,211,0.4725,0.21052631578947367,0.02,0.925,0.075,0.98,0.03652968036529681
0.927,400,"[[4, 14], [196, 186]]",4,196,14,196,200,200,18,382,190,210,0.475,0.2222222222222222,0.02,0.93,0.07,0.98,0.03669724770642202
0.928,400,"[[4, 14], [196, 186]]",4,196,14,196,200,200,18,382,190,210,0.475,0.2222222222222222,0.02,0.93,0.07,0.98,0.03669724770642202
0.929,400,"[[4, 13], [196, 187]]",4,196,13,196,200,200,17,383,191,209,0.4775,0.23529411764705882,0.02,0.935,0.065,0.98,0.03686635944700461
0.93,400,"[[4, 13], [196, 187]]",4,196,13,196,200,200,17,383,191,209,0.4775,0.23529411764705882,0.02,0.935,0.065,0.98,0.03686635944700461
0.931,400,"[[4, 13], [196, 187]]",4,196,13,196,200,200,17,383,191,209,0.4775,0.23529411764705882,0.02,0.935,0.065,0.98,0.03686635944700461
0.932,400,"[[4, 13], [196, 187]]",4,196,13,196,200,200,17,383,191,209,0.4775,0.23529411764705882,0.02,0.935,0.065,0.98,0.03686635944700461
0.933,400,"[[4, 13], [196, 187]]",4,196,13,196,200,200,17,383,191,209,0.4775,0.23529411764705882,0.02,0.935,0.065,0.98,0.03686635944700461
0.934,400,"[[4, 13], [196, 187]]",4,196,13,196,200,200,17,383,191,209,0.4775,0.23529411764705882,0.02,0.935,0.065,0.98,0.03686635944700461
0.935,400,"[[4, 13], [196, 187]]",4,196,13,196,200,200,17,383,191,209,0.4775,0.23529411764705882,0.02,0.935,0.065,0.98,0.03686635944700461
0.936,400,"[[4, 13], [196, 187]]",4,196,13,196,200,200,17,383,191,209,0.4775,0.23529411764705882,0.02,0.935,0.065,0.98,0.03686635944700461
0.937,400,"[[4, 13], [196, 187]]",4,196,13,196,200,200,17,383,191,209,0.4775,0.23529411764705882,0.02,0.935,0.065,0.98,0.03686635944700461
0.938,400,"[[4, 13], [196, 187]]",4,196,13,196,200,200,17,383,191,209,0.4775,0.23529411764705882,0.02,0.935,0.065,0.98,0.03686635944700461
0.939,400,"[[4, 13], [196, 187]]",4,196,13,196,200,200,17,383,191,209,0.4775,0.23529411764705882,0.02,0.935,0.065,0.98,0.03686635944700461
0.94,400,"[[4, 12], [196, 188]]",4,196,12,196,200,200,16,384,192,208,0.48,0.25,0.02,0.94,0.06,0.98,0.037037037037037035
0.941,400,"[[4, 12], [196, 188]]",4,196,12,196,200,200,16,384,192,208,0.48,0.25,0.02,0.94,0.06,0.98,0.037037037037037035
0.942,400,"[[4, 12], [196, 188]]",4,196,12,196,200,200,16,384,192,208,0.48,0.25,0.02,0.94,0.06,0.98,0.037037037037037035
0.943,400,"[[4, 12], [196, 188]]",4,196,12,196,200,200,16,384,192,208,0.48,0.25,0.02,0.94,0.06,0.98,0.037037037037037035
0.944,400,"[[4, 12], [196, 188]]",4,196,12,196,200,200,16,384,192,208,0.48,0.25,0.02,0.94,0.06,0.98,0.037037037037037035
0.945,400,"[[4, 12], [196, 188]]",4,196,12,196,200,200,16,384,192,208,0.48,0.25,0.02,0.94,0.06,0.98,0.037037037037037035
0.946,400,"[[4, 12], [196, 188]]",4,196,12,196,200,200,16,384,192,208,0.48,0.25,0.02,0.94,0.06,0.98,0.037037037037037035
0.947,400,"[[4, 12], [196, 188]]",4,196,12,196,200,200,16,384,192,208,0.48,0.25,0.02,0.94,0.06,0.98,0.037037037037037035
0.948,400,"[[4, 12], [196, 188]]",4,196,12,196,200,200,16,384,192,208,0.48,0.25,0.02,0.94,0.06,0.98,0.037037037037037035
0.949,400,"[[4, 12], [196, 188]]",4,196,12,196,200,200,16,384,192,208,0.48,0.25,0.02,0.94,0.06,0.98,0.037037037037037035
0.95,400,"[[4, 12], [196, 188]]",4,196,12,196,200,200,16,384,192,208,0.48,0.25,0.02,0.94,0.06,0.98,0.037037037037037035
0.951,400,"[[4, 12], [196, 188]]",4,196,12,196,200,200,16,384,192,208,0.48,0.25,0.02,0.94,0.06,0.98,0.037037037037037035
0.952,400,"[[4, 11], [196, 189]]",4,196,11,196,200,200,15,385,193,207,0.4825,0.26666666666666666,0.02,0.945,0.055,0.98,0.037209302325581395
0.953,400,"[[4, 10], [196, 190]]",4,196,10,196,200,200,14,386,194,206,0.485,0.2857142857142857,0.02,0.95,0.05,0.98,0.037383177570093455
0.954,400,"[[4, 10], [196, 190]]",4,196,10,196,200,200,14,386,194,206,0.485,0.2857142857142857,0.02,0.95,0.05,0.98,0.037383177570093455
0.955,400,"[[4, 10], [196, 190]]",4,196,10,196,200,200,14,386,194,206,0.485,0.2857142857142857,0.02,0.95,0.05,0.98,0.037383177570093455
0.956,400,"[[4, 10], [196, 190]]",4,196,10,196,200,200,14,386,194,206,0.485,0.2857142857142857,0.02,0.95,0.05,0.98,0.037383177570093455
0.957,400,"[[4, 10], [196, 190]]",4,196,10,196,200,200,14,386,194,206,0.485,0.2857142857142857,0.02,0.95,0.05,0.98,0.037383177570093455
0.958,400,"[[4, 10], [196, 190]]",4,196,10,196,200,200,14,386,194,206,0.485,0.2857142857142857,0.02,0.95,0.05,0.98,0.037383177570093455
0.959,400,"[[4, 10], [196, 190]]",4,196,10,196,200,200,14,386,194,206,0.485,0.2857142857142857,0.02,0.95,0.05,0.98,0.037383177570093455
0.96,400,"[[4, 9], [196, 191]]",4,196,9,196,200,200,13,387,195,205,0.4875,0.3076923076923077,0.02,0.955,0.045,0.98,0.03755868544600939
0.961,400,"[[4, 9], [196, 191]]",4,196,9,196,200,200,13,387,195,205,0.4875,0.3076923076923077,0.02,0.955,0.045,0.98,0.03755868544600939
0.962,400,"[[4, 9], [196, 191]]",4,196,9,196,200,200,13,387,195,205,0.4875,0.3076923076923077,0.02,0.955,0.045,0.98,0.03755868544600939
0.963,400,"[[4, 8], [196, 192]]",4,196,8,196,200,200,12,388,196,204,0.49,0.3333333333333333,0.02,0.96,0.04,0.98,0.03773584905660377
0.964,400,"[[4, 7], [196, 193]]",4,196,7,196,200,200,11,389,197,203,0.4925,0.36363636363636365,0.02,0.965,0.035,0.98,0.03791469194312796
0.965,400,"[[4, 7], [196, 193]]",4,196,7,196,200,200,11,389,197,203,0.4925,0.36363636363636365,0.02,0.965,0.035,0.98,0.03791469194312796
0.966,400,"[[4, 7], [196, 193]]",4,196,7,196,200,200,11,389,197,203,0.4925,0.36363636363636365,0.02,0.965,0.035,0.98,0.03791469194312796
0.967,400,"[[4, 6], [196, 194]]",4,196,6,196,200,200,10,390,198,202,0.495,0.4,0.02,0.97,0.03,0.98,0.03809523809523809
0.968,400,"[[4, 6], [196, 194]]",4,196,6,196,200,200,10,390,198,202,0.495,0.4,0.02,0.97,0.03,0.98,0.03809523809523809
0.969,400,"[[4, 6], [196, 194]]",4,196,6,196,200,200,10,390,198,202,0.495,0.4,0.02,0.97,0.03,0.98,0.03809523809523809
0.97,400,"[[4, 6], [196, 194]]",4,196,6,196,200,200,10,390,198,202,0.495,0.4,0.02,0.97,0.03,0.98,0.03809523809523809
0.971,400,"[[4, 6], [196, 194]]",4,196,6,196,200,200,10,390,198,202,0.495,0.4,0.02,0.97,0.03,0.98,0.03809523809523809
0.972,400,"[[4, 6], [196, 194]]",4,196,6,196,200,200,10,390,198,202,0.495,0.4,0.02,0.97,0.03,0.98,0.03809523809523809
0.973,400,"[[4, 6], [196, 194]]",4,196,6,196,200,200,10,390,198,202,0.495,0.4,0.02,0.97,0.03,0.98,0.03809523809523809
0.974,400,"[[4, 6], [196, 194]]",4,196,6,196,200,200,10,390,198,202,0.495,0.4,0.02,0.97,0.03,0.98,0.03809523809523809
0.975,400,"[[4, 6], [196, 194]]",4,196,6,196,200,200,10,390,198,202,0.495,0.4,0.02,0.97,0.03,0.98,0.03809523809523809
0.976,400,"[[4, 5], [196, 195]]",4,196,5,196,200,200,9,391,199,201,0.4975,0.4444444444444444,0.02,0.975,0.025,0.98,0.03827751196172249
0.977,400,"[[4, 5], [196, 195]]",4,196,5,196,200,200,9,391,199,201,0.4975,0.4444444444444444,0.02,0.975,0.025,0.98,0.03827751196172249
0.978,400,"[[4, 5], [196, 195]]",4,196,5,196,200,200,9,391,199,201,0.4975,0.4444444444444444,0.02,0.975,0.025,0.98,0.03827751196172249
0.979,400,"[[4, 5], [196, 195]]",4,196,5,196,200,200,9,391,199,201,0.4975,0.4444444444444444,0.02,0.975,0.025,0.98,0.03827751196172249
0.98,400,"[[4, 5], [196, 195]]",4,196,5,196,200,200,9,391,199,201,0.4975,0.4444444444444444,0.02,0.975,0.025,0.98,0.03827751196172249
0.981,400,"[[4, 5], [196, 195]]",4,196,5,196,200,200,9,391,199,201,0.4975,0.4444444444444444,0.02,0.975,0.025,0.98,0.03827751196172249
0.982,400,"[[4, 4], [196, 196]]",4,196,4,196,200,200,8,392,200,200,0.5,0.5,0.02,0.98,0.02,0.98,0.038461538461538464
0.983,400,"[[4, 4], [196, 196]]",4,196,4,196,200,200,8,392,200,200,0.5,0.5,0.02,0.98,0.02,0.98,0.038461538461538464
0.984,400,"[[4, 4], [196, 196]]",4,196,4,196,200,200,8,392,200,200,0.5,0.5,0.02,0.98,0.02,0.98,0.038461538461538464
0.985,400,"[[4, 4], [196, 196]]",4,196,4,196,200,200,8,392,200,200,0.5,0.5,0.02,0.98,0.02,0.98,0.038461538461538464
0.986,400,"[[3, 4], [197, 196]]",3,197,4,197,200,200,7,393,199,201,0.4975,0.42857142857142855,0.015,0.98,0.02,0.985,0.02898550724637681
0.987,400,"[[3, 4], [197, 196]]",3,197,4,197,200,200,7,393,199,201,0.4975,0.42857142857142855,0.015,0.98,0.02,0.985,0.02898550724637681
0.988,400,"[[3, 4], [197, 196]]",3,197,4,197,200,200,7,393,199,201,0.4975,0.42857142857142855,0.015,0.98,0.02,0.985,0.02898550724637681
0.989,400,"[[3, 4], [197, 196]]",3,197,4,197,200,200,7,393,199,201,0.4975,0.42857142857142855,0.015,0.98,0.02,0.985,0.02898550724637681
0.99,400,"[[3, 4], [197, 196]]",3,197,4,197,200,200,7,393,199,201,0.4975,0.42857142857142855,0.015,0.98,0.02,0.985,0.02898550724637681
0.991,400,"[[3, 4], [197, 196]]",3,197,4,197,200,200,7,393,199,201,0.4975,0.42857142857142855,0.015,0.98,0.02,0.985,0.02898550724637681
0.992,400,"[[3, 4], [197, 196]]",3,197,4,197,200,200,7,393,199,201,0.4975,0.42857142857142855,0.015,0.98,0.02,0.985,0.02898550724637681
0.993,400,"[[3, 4], [197, 196]]",3,197,4,197,200,200,7,393,199,201,0.4975,0.42857142857142855,0.015,0.98,0.02,0.985,0.02898550724637681
0.994,400,"[[3, 4], [197, 196]]",3,197,4,197,200,200,7,393,199,201,0.4975,0.42857142857142855,0.015,0.98,0.02,0.985,0.02898550724637681
0.995,400,"[[3, 3], [197, 197]]",3,197,3,197,200,200,6,394,200,200,0.5,0.5,0.015,0.985,0.015,0.985,0.029126213592233007
0.996,400,"[[2, 2], [198, 198]]",2,198,2,198,200,200,4,396,200,200,0.5,0.5,0.01,0.99,0.01,0.99,0.0196078431372549
0.997,400,"[[2, 2], [198, 198]]",2,198,2,198,200,200,4,396,200,200,0.5,0.5,0.01,0.99,0.01,0.99,0.0196078431372549
0.998,400,"[[2, 1], [198, 199]]",2,198,1,198,200,200,3,397,201,199,0.5025,0.6666666666666666,0.01,0.995,0.005,0.99,0.019704433497536946
0.999,400,"[[0, 1], [200, 199]]",0,200,1,200,200,200,1,399,199,201,0.4975,0.0,0.0,0.995,0.005,1.0,
1.0,400,"[[0, 0], [200, 200]]",0,200,0,200,200,200,0,400,200,200,0.5,,0.0,1.0,0.0,1.0,
1.001,400,"[[0, 0], [200, 200]]",0,200,0,200,200,200,0,400,200,200,0.5,,0.0,1.0,0.0,1.0,
