Score Threshold,Measurements (M),Confusion Matrix (cm),True Pos.s (TP),True Neg.s (TN),False Pos.s (FP),*False Neg.s* (FN),Positives (P),Negatives (N),Meas.Pos.s (MP),Meas.Neg.s (MN),Correct Meas.s (CM),Incorrect Meas.s (IM),Accuracy (ACC),Precision (PPV),Recall/Sensitivity (TPR),Specificity/Selectivity (TNR),Fallout (FPR),Miss Rate (FNR),F1 Score (F1)
0.0,2910,"[[887, 2023], [0, 0]]",887,0,2023,0,887,2023,2910,0,887,2023,0.3048109965635739,0.3048109965635739,1.0,0.0,1.0,0.0,0.4672109560179089
0.001,2910,"[[884, 1939], [3, 84]]",884,3,1939,3,887,2023,2823,87,968,1942,0.3326460481099656,0.31314204746723345,0.9966178128523112,0.04152249134948097,0.9584775086505191,0.0033821871476888386,0.4765498652291106
0.002,2910,"[[883, 1922], [4, 101]]",883,4,1922,4,887,2023,2805,105,984,1926,0.33814432989690724,0.314795008912656,0.9954904171364148,0.04992585269401879,0.9500741473059812,0.004509582863585118,0.47833152762730236
0.003,2910,"[[883, 1905], [4, 118]]",883,4,1905,4,887,2023,2788,122,1001,1909,0.34398625429553265,0.3167144906743185,0.9954904171364148,0.0583292140385566,0.9416707859614434,0.004509582863585118,0.48054421768707484
0.004,2910,"[[882, 1893], [5, 130]]",882,5,1893,5,887,2023,2775,135,1012,1898,0.34776632302405497,0.3178378378378378,0.9943630214205186,0.06426099851705389,0.9357390014829461,0.005636978579481398,0.4817039868924085
0.005,2910,"[[881, 1886], [6, 137]]",881,6,1886,6,887,2023,2767,143,1018,1892,0.34982817869415805,0.3183953740513191,0.9932356257046223,0.06772120612951063,0.9322787938704894,0.006764374295377677,0.48221127531472363
0.006,2910,"[[881, 1879], [6, 144]]",881,6,1879,6,887,2023,2760,150,1025,1885,0.35223367697594504,0.31920289855072465,0.9932356257046223,0.07118141374196738,0.9288185862580326,0.006764374295377677,0.48313682478749664
0.007,2910,"[[881, 1876], [6, 147]]",881,6,1876,6,887,2023,2757,153,1028,1882,0.3532646048109966,0.31955023576351105,0.9932356257046223,0.0726643598615917,0.9273356401384083,0.006764374295377677,0.48353457738748623
0.008,2910,"[[881, 1872], [6, 151]]",881,6,1872,6,887,2023,2753,157,1032,1878,0.354639175257732,0.3200145296040683,0.9932356257046223,0.07464162135442412,0.9253583786455759,0.006764374295377677,0.48406593406593407
0.009,2910,"[[881, 1868], [6, 155]]",881,6,1868,6,887,2023,2749,161,1036,1874,0.35601374570446737,0.32048017460894873,0.9932356257046223,0.07661888284725656,0.9233811171527434,0.006764374295377677,0.48459845984598454
0.01,2910,"[[881, 1862], [6, 161]]",881,6,1862,6,887,2023,2743,167,1042,1868,0.35807560137457045,0.3211811884797667,0.9932356257046223,0.07958477508650519,0.9204152249134948,0.006764374295377677,0.48539944903581267
0.011,2910,"[[881, 1860], [6, 163]]",881,6,1860,6,887,2023,2741,169,1044,1866,0.35876288659793815,0.3214155417730755,0.9932356257046223,0.0805734058329214,0.9194265941670786,0.006764374295377677,0.4856670341786108
0.012,2910,"[[880, 1858], [7, 165]]",880,7,1858,7,887,2023,2738,172,1045,1865,0.359106529209622,0.32140248356464574,0.992108229988726,0.08156203657933762,0.9184379634206624,0.007891770011273957,0.4855172413793103
0.013,2910,"[[879, 1855], [8, 168]]",879,8,1855,8,887,2023,2734,176,1047,1863,0.3597938144329897,0.3215069495245062,0.9909808342728298,0.08304498269896193,0.916955017301038,0.009019165727170236,0.4855012427506214
0.014,2910,"[[879, 1852], [8, 171]]",879,8,1852,8,887,2023,2731,179,1050,1860,0.36082474226804123,0.3218601244965214,0.9909808342728298,0.08452792881858626,0.9154720711814137,0.009019165727170236,0.48590381426202317
0.015,2910,"[[879, 1849], [8, 174]]",879,8,1849,8,887,2023,2728,182,1053,1857,0.3618556701030928,0.3222140762463343,0.9909808342728298,0.08601087493821058,0.9139891250617894,0.009019165727170236,0.48630705394190876
0.016,2910,"[[879, 1846], [8, 177]]",879,8,1846,8,887,2023,2725,185,1056,1854,0.3628865979381443,0.32256880733944954,0.9909808342728298,0.0874938210578349,0.9125061789421651,0.009019165727170236,0.48671096345514947
0.017,2910,"[[879, 1843], [8, 180]]",879,8,1843,8,887,2023,2722,188,1059,1851,0.36391752577319586,0.32292432035268187,0.9909808342728298,0.08897676717745921,0.9110232328225408,0.009019165727170236,0.48711554447215305
0.018,2910,"[[879, 1840], [8, 183]]",879,8,1840,8,887,2023,2719,191,1062,1848,0.3649484536082474,0.32328061787421847,0.9909808342728298,0.09045971329708354,0.9095402867029164,0.009019165727170236,0.48752079866888515
0.019,2910,"[[879, 1836], [8, 187]]",879,8,1836,8,887,2023,2715,195,1066,1844,0.3663230240549828,0.3237569060773481,0.9909808342728298,0.09243697478991597,0.907563025210084,0.009019165727170236,0.4880621876735147
0.02,2910,"[[879, 1833], [8, 190]]",879,8,1833,8,887,2023,2712,198,1069,1841,0.3673539518900344,0.3241150442477876,0.9909808342728298,0.09391992090954028,0.9060800790904597,0.009019165727170236,0.4884690191719922
0.021,2910,"[[879, 1833], [8, 190]]",879,8,1833,8,887,2023,2712,198,1069,1841,0.3673539518900344,0.3241150442477876,0.9909808342728298,0.09391992090954028,0.9060800790904597,0.009019165727170236,0.4884690191719922
0.022,2910,"[[879, 1830], [8, 193]]",879,8,1830,8,887,2023,2709,201,1072,1838,0.36838487972508593,0.32447397563676633,0.9909808342728298,0.0954028670291646,0.9045971329708354,0.009019165727170236,0.4888765294771969
0.023,2910,"[[878, 1828], [9, 195]]",878,9,1828,9,887,2023,2706,204,1073,1837,0.3687285223367698,0.3244641537324464,0.9898534385569335,0.09639149777558081,0.9036085022244191,0.010146561443066516,0.4887280823824102
0.024,2910,"[[878, 1825], [9, 198]]",878,9,1825,9,887,2023,2703,207,1076,1834,0.3697594501718213,0.32482426933037367,0.9898534385569335,0.09787444389520514,0.9021255561047948,0.010146561443066516,0.48913649025069644
0.025,2910,"[[878, 1824], [9, 199]]",878,9,1824,9,887,2023,2702,208,1077,1833,0.37010309278350517,0.3249444855662472,0.9898534385569335,0.09836875926841325,0.9016312407315867,0.010146561443066516,0.48927277793257173
0.026,2910,"[[877, 1820], [10, 203]]",877,10,1820,10,887,2023,2697,213,1080,1830,0.3711340206185567,0.325176121616611,0.9887260428410372,0.10034602076124567,0.8996539792387543,0.011273957158962795,0.48939732142857145
0.027,2910,"[[877, 1816], [10, 207]]",877,10,1816,10,887,2023,2693,217,1084,1826,0.3725085910652921,0.32565911622725585,0.9887260428410372,0.10232328225407811,0.897676717745922,0.011273957158962795,0.48994413407821236
0.028,2910,"[[877, 1814], [10, 209]]",877,10,1814,10,887,2023,2691,219,1086,1824,0.3731958762886598,0.3259011519881085,0.9887260428410372,0.10331191300049432,0.8966880869995056,0.011273957158962795,0.4902179988820569
0.029,2910,"[[877, 1813], [10, 210]]",877,10,1813,10,887,2023,2690,220,1087,1823,0.37353951890034365,0.32602230483271377,0.9887260428410372,0.10380622837370242,0.8961937716262975,0.011273957158962795,0.49035504612804026
0.03,2910,"[[877, 1813], [10, 210]]",877,10,1813,10,887,2023,2690,220,1087,1823,0.37353951890034365,0.32602230483271377,0.9887260428410372,0.10380622837370242,0.8961937716262975,0.011273957158962795,0.49035504612804026
0.031,2910,"[[877, 1811], [10, 212]]",877,10,1811,10,887,2023,2688,222,1089,1821,0.37422680412371134,0.32626488095238093,0.9887260428410372,0.10479485912011864,0.8952051408798813,0.011273957158962795,0.4906293706293706
0.032,2910,"[[877, 1809], [10, 214]]",877,10,1809,10,887,2023,2686,224,1091,1819,0.37491408934707904,0.32650781831720027,0.9887260428410372,0.10578348986653485,0.8942165101334651,0.011273957158962795,0.49090400223901476
0.033,2910,"[[877, 1809], [10, 214]]",877,10,1809,10,887,2023,2686,224,1091,1819,0.37491408934707904,0.32650781831720027,0.9887260428410372,0.10578348986653485,0.8942165101334651,0.011273957158962795,0.49090400223901476
0.034,2910,"[[877, 1809], [10, 214]]",877,10,1809,10,887,2023,2686,224,1091,1819,0.37491408934707904,0.32650781831720027,0.9887260428410372,0.10578348986653485,0.8942165101334651,0.011273957158962795,0.49090400223901476
0.035,2910,"[[877, 1808], [10, 215]]",877,10,1808,10,887,2023,2685,225,1092,1818,0.3752577319587629,0.3266294227188082,0.9887260428410372,0.10627780523974295,0.893722194760257,0.011273957158962795,0.49104143337066064
0.036,2910,"[[877, 1805], [10, 218]]",877,10,1805,10,887,2023,2682,228,1095,1815,0.37628865979381443,0.3269947800149142,0.9887260428410372,0.10776075135936727,0.8922392486406328,0.011273957158962795,0.49145418884841685
0.037,2910,"[[877, 1804], [10, 219]]",877,10,1804,10,887,2023,2681,229,1096,1814,0.3766323024054983,0.32711674748228275,0.9887260428410372,0.10825506673257539,0.8917449332674247,0.011273957158962795,0.49159192825112114
0.038,2910,"[[877, 1802], [10, 221]]",877,10,1802,10,887,2023,2679,231,1098,1812,0.37731958762886597,0.3273609555804405,0.9887260428410372,0.1092436974789916,0.8907563025210085,0.011273957158962795,0.4918676388109927
0.039,2910,"[[877, 1801], [10, 222]]",877,10,1801,10,887,2023,2678,232,1099,1811,0.3776632302405498,0.32748319641523527,0.9887260428410372,0.10973801285219971,0.8902619871478002,0.011273957158962795,0.4920056100981768
0.04,2910,"[[877, 1796], [10, 227]]",877,10,1796,10,887,2023,2673,237,1104,1806,0.37938144329896906,0.328095772540217,0.9887260428410372,0.11220958971824024,0.8877904102817598,0.011273957158962795,0.49269662921348323
0.041,2910,"[[876, 1795], [11, 228]]",876,11,1795,11,887,2023,2671,239,1104,1806,0.37938144329896906,0.32796705353800076,0.9875986471251409,0.11270390509144834,0.8872960949085517,0.012401352874859075,0.4924114671163575
0.042,2910,"[[876, 1793], [11, 230]]",876,11,1793,11,887,2023,2669,241,1106,1804,0.38006872852233675,0.32821281378793554,0.9875986471251409,0.11369253583786455,0.8863074641621355,0.012401352874859075,0.49268841394825647
0.043,2910,"[[876, 1791], [11, 232]]",876,11,1791,11,887,2023,2667,243,1108,1802,0.38075601374570445,0.32845894263217096,0.9875986471251409,0.11468116658428078,0.8853188334157193,0.012401352874859075,0.4929656724817107
0.044,2910,"[[876, 1790], [11, 233]]",876,11,1790,11,887,2023,2666,244,1109,1801,0.3810996563573883,0.3285821455363841,0.9875986471251409,0.11517548195748888,0.8848245180425112,0.012401352874859075,0.4931044188010132
0.045,2910,"[[874, 1788], [13, 235]]",874,13,1788,13,887,2023,2662,248,1109,1801,0.3810996563573883,0.32832456799398946,0.9853438556933484,0.11616411270390509,0.8838358872960949,0.014656144306651634,0.49253310791772326
0.046,2910,"[[872, 1787], [15, 236]]",872,15,1787,15,887,2023,2659,251,1108,1802,0.38075601374570445,0.32794283565250093,0.9830890642615558,0.1166584280771132,0.8833415719228868,0.016910935738444193,0.49182177100958824
0.047,2910,"[[872, 1786], [15, 237]]",872,15,1786,15,887,2023,2658,252,1109,1801,0.3810996563573883,0.32806621519939805,0.9830890642615558,0.11715274345032131,0.8828472565496787,0.016910935738444193,0.49196050775740485
0.048,2910,"[[872, 1786], [15, 237]]",872,15,1786,15,887,2023,2658,252,1109,1801,0.3810996563573883,0.32806621519939805,0.9830890642615558,0.11715274345032131,0.8828472565496787,0.016910935738444193,0.49196050775740485
0.049,2910,"[[872, 1786], [15, 237]]",872,15,1786,15,887,2023,2658,252,1109,1801,0.3810996563573883,0.32806621519939805,0.9830890642615558,0.11715274345032131,0.8828472565496787,0.016910935738444193,0.49196050775740485
0.05,2910,"[[872, 1785], [15, 238]]",872,15,1785,15,887,2023,2657,253,1110,1800,0.38144329896907214,0.32818968761761386,0.9830890642615558,0.11764705882352941,0.8823529411764706,0.016910935738444193,0.492099322799097
0.051,2910,"[[872, 1785], [15, 238]]",872,15,1785,15,887,2023,2657,253,1110,1800,0.38144329896907214,0.32818968761761386,0.9830890642615558,0.11764705882352941,0.8823529411764706,0.016910935738444193,0.492099322799097
0.052,2910,"[[872, 1785], [15, 238]]",872,15,1785,15,887,2023,2657,253,1110,1800,0.38144329896907214,0.32818968761761386,0.9830890642615558,0.11764705882352941,0.8823529411764706,0.016910935738444193,0.492099322799097
0.053,2910,"[[872, 1783], [15, 240]]",872,15,1783,15,887,2023,2655,255,1112,1798,0.38213058419243984,0.32843691148775894,0.9830890642615558,0.11863568956994562,0.8813643104300544,0.016910935738444193,0.492377188029362
0.054,2910,"[[872, 1780], [15, 243]]",872,15,1780,15,887,2023,2652,258,1115,1795,0.38316151202749144,0.3288084464555053,0.9830890642615558,0.12011863568956994,0.8798813643104301,0.016910935738444193,0.4927945747386267
0.055,2910,"[[872, 1778], [15, 245]]",872,15,1778,15,887,2023,2650,260,1117,1793,0.38384879725085913,0.3290566037735849,0.9830890642615558,0.12110726643598616,0.8788927335640139,0.016910935738444193,0.4930732258976534
0.056,2910,"[[872, 1778], [15, 245]]",872,15,1778,15,887,2023,2650,260,1117,1793,0.38384879725085913,0.3290566037735849,0.9830890642615558,0.12110726643598616,0.8788927335640139,0.016910935738444193,0.4930732258976534
0.057,2910,"[[872, 1778], [15, 245]]",872,15,1778,15,887,2023,2650,260,1117,1793,0.38384879725085913,0.3290566037735849,0.9830890642615558,0.12110726643598616,0.8788927335640139,0.016910935738444193,0.4930732258976534
0.058,2910,"[[872, 1777], [15, 246]]",872,15,1777,15,887,2023,2649,261,1118,1792,0.384192439862543,0.32918082295205736,0.9830890642615558,0.12160158180919427,0.8783984181908058,0.016910935738444193,0.4932126696832579
0.059,2910,"[[872, 1775], [15, 248]]",872,15,1775,15,887,2023,2647,263,1120,1790,0.3848797250859107,0.32942954287873066,0.9830890642615558,0.12259021255561048,0.8774097874443895,0.016910935738444193,0.49349179400113186
0.06,2910,"[[872, 1775], [15, 248]]",872,15,1775,15,887,2023,2647,263,1120,1790,0.3848797250859107,0.32942954287873066,0.9830890642615558,0.12259021255561048,0.8774097874443895,0.016910935738444193,0.49349179400113186
0.061,2910,"[[872, 1775], [15, 248]]",872,15,1775,15,887,2023,2647,263,1120,1790,0.3848797250859107,0.32942954287873066,0.9830890642615558,0.12259021255561048,0.8774097874443895,0.016910935738444193,0.49349179400113186
0.062,2910,"[[872, 1773], [15, 250]]",872,15,1773,15,887,2023,2645,265,1122,1788,0.38556701030927837,0.32967863894139887,0.9830890642615558,0.12357884330202669,0.8764211566979733,0.016910935738444193,0.49377123442808607
0.063,2910,"[[872, 1772], [15, 251]]",872,15,1772,15,887,2023,2644,266,1123,1787,0.3859106529209622,0.329803328290469,0.9830890642615558,0.1240731586752348,0.8759268413247652,0.016910935738444193,0.49391107335032564
0.064,2910,"[[872, 1771], [15, 252]]",872,15,1771,15,887,2023,2643,267,1124,1786,0.38625429553264606,0.3299281119939463,0.9830890642615558,0.1245674740484429,0.8754325259515571,0.016910935738444193,0.4940509915014165
0.065,2910,"[[872, 1771], [15, 252]]",872,15,1771,15,887,2023,2643,267,1124,1786,0.38625429553264606,0.3299281119939463,0.9830890642615558,0.1245674740484429,0.8754325259515571,0.016910935738444193,0.4940509915014165
0.066,2910,"[[872, 1770], [15, 253]]",872,15,1770,15,887,2023,2642,268,1125,1785,0.3865979381443299,0.3300529901589705,0.9830890642615558,0.12506178942165103,0.874938210578349,0.016910935738444193,0.49419098894871066
0.067,2910,"[[872, 1768], [15, 255]]",872,15,1768,15,887,2023,2640,270,1127,1783,0.3872852233676976,0.3303030303030303,0.9830890642615558,0.12605042016806722,0.8739495798319328,0.016910935738444193,0.4944712220017011
0.068,2910,"[[872, 1766], [15, 257]]",872,15,1766,15,887,2023,2638,272,1129,1781,0.3879725085910653,0.3305534495830174,0.9830890642615558,0.12703905091448345,0.8729609490855166,0.016910935738444193,0.4947517730496453
0.069,2910,"[[872, 1766], [15, 257]]",872,15,1766,15,887,2023,2638,272,1129,1781,0.3879725085910653,0.3305534495830174,0.9830890642615558,0.12703905091448345,0.8729609490855166,0.016910935738444193,0.4947517730496453
0.07,2910,"[[872, 1766], [15, 257]]",872,15,1766,15,887,2023,2638,272,1129,1781,0.3879725085910653,0.3305534495830174,0.9830890642615558,0.12703905091448345,0.8729609490855166,0.016910935738444193,0.4947517730496453
0.071,2910,"[[871, 1766], [16, 257]]",871,16,1766,16,887,2023,2637,273,1128,1782,0.38762886597938145,0.3302995828593098,0.9819616685456595,0.12703905091448345,0.8729609490855166,0.018038331454340473,0.49432463110102154
0.072,2910,"[[871, 1765], [16, 258]]",871,16,1765,16,887,2023,2636,274,1129,1781,0.3879725085910653,0.3304248861911988,0.9819616685456595,0.12753336628769155,0.8724666337123085,0.018038331454340473,0.4944649446494465
0.073,2910,"[[871, 1765], [16, 258]]",871,16,1765,16,887,2023,2636,274,1129,1781,0.3879725085910653,0.3304248861911988,0.9819616685456595,0.12753336628769155,0.8724666337123085,0.018038331454340473,0.4944649446494465
0.074,2910,"[[871, 1765], [16, 258]]",871,16,1765,16,887,2023,2636,274,1129,1781,0.3879725085910653,0.3304248861911988,0.9819616685456595,0.12753336628769155,0.8724666337123085,0.018038331454340473,0.4944649446494465
0.075,2910,"[[871, 1765], [16, 258]]",871,16,1765,16,887,2023,2636,274,1129,1781,0.3879725085910653,0.3304248861911988,0.9819616685456595,0.12753336628769155,0.8724666337123085,0.018038331454340473,0.4944649446494465
0.076,2910,"[[871, 1763], [16, 260]]",871,16,1763,16,887,2023,2634,276,1131,1779,0.388659793814433,0.33067577828397876,0.9819616685456595,0.12852199703410777,0.8714780029658923,0.018038331454340473,0.49474581084919056
0.077,2910,"[[871, 1763], [16, 260]]",871,16,1763,16,887,2023,2634,276,1131,1779,0.388659793814433,0.33067577828397876,0.9819616685456595,0.12852199703410777,0.8714780029658923,0.018038331454340473,0.49474581084919056
0.078,2910,"[[871, 1763], [16, 260]]",871,16,1763,16,887,2023,2634,276,1131,1779,0.388659793814433,0.33067577828397876,0.9819616685456595,0.12852199703410777,0.8714780029658923,0.018038331454340473,0.49474581084919056
0.079,2910,"[[871, 1763], [16, 260]]",871,16,1763,16,887,2023,2634,276,1131,1779,0.388659793814433,0.33067577828397876,0.9819616685456595,0.12852199703410777,0.8714780029658923,0.018038331454340473,0.49474581084919056
0.08,2910,"[[871, 1763], [16, 260]]",871,16,1763,16,887,2023,2634,276,1131,1779,0.388659793814433,0.33067577828397876,0.9819616685456595,0.12852199703410777,0.8714780029658923,0.018038331454340473,0.49474581084919056
0.081,2910,"[[871, 1761], [16, 262]]",871,16,1761,16,887,2023,2632,278,1133,1777,0.3893470790378007,0.33092705167173253,0.9819616685456595,0.12951062778052397,0.870489372219476,0.018038331454340473,0.49502699630576874
0.082,2910,"[[871, 1760], [16, 263]]",871,16,1760,16,887,2023,2631,279,1134,1776,0.38969072164948454,0.33105283162295707,0.9819616685456595,0.1300049431537321,0.8699950568462679,0.018038331454340473,0.49516770892552586
0.083,2910,"[[871, 1760], [16, 263]]",871,16,1760,16,887,2023,2631,279,1134,1776,0.38969072164948454,0.33105283162295707,0.9819616685456595,0.1300049431537321,0.8699950568462679,0.018038331454340473,0.49516770892552586
0.084,2910,"[[871, 1760], [16, 263]]",871,16,1760,16,887,2023,2631,279,1134,1776,0.38969072164948454,0.33105283162295707,0.9819616685456595,0.1300049431537321,0.8699950568462679,0.018038331454340473,0.49516770892552586
0.085,2910,"[[871, 1758], [16, 265]]",871,16,1758,16,887,2023,2629,281,1136,1774,0.39037800687285223,0.33130467858501333,0.9819616685456595,0.1309935739001483,0.8690064260998517,0.018038331454340473,0.4954493742889648
0.086,2910,"[[871, 1758], [16, 265]]",871,16,1758,16,887,2023,2629,281,1136,1774,0.39037800687285223,0.33130467858501333,0.9819616685456595,0.1309935739001483,0.8690064260998517,0.018038331454340473,0.4954493742889648
0.087,2910,"[[871, 1757], [16, 266]]",871,16,1757,16,887,2023,2628,282,1137,1773,0.3907216494845361,0.3314307458143075,0.9819616685456595,0.1314878892733564,0.8685121107266436,0.018038331454340473,0.4955903271692746
0.088,2910,"[[871, 1754], [16, 269]]",871,16,1754,16,887,2023,2625,285,1140,1770,0.3917525773195876,0.33180952380952383,0.9819616685456595,0.1329708353929807,0.8670291646070193,0.018038331454340473,0.49601366742596814
0.089,2910,"[[871, 1752], [16, 271]]",871,16,1752,16,887,2023,2623,287,1142,1768,0.3924398625429553,0.33206252382767826,0.9819616685456595,0.13395946613939694,0.8660405338606031,0.018038331454340473,0.49629629629629624
0.09,2910,"[[870, 1752], [17, 271]]",870,17,1752,17,887,2023,2622,288,1141,1769,0.3920962199312715,0.3318077803203661,0.9808342728297632,0.13395946613939694,0.8660405338606031,0.019165727170236752,0.49586776859504134
0.091,2910,"[[870, 1750], [17, 273]]",870,17,1750,17,887,2023,2620,290,1143,1767,0.39278350515463917,0.3320610687022901,0.9808342728297632,0.13494809688581316,0.8650519031141869,0.019165727170236752,0.49615055603079555
0.092,2910,"[[870, 1750], [17, 273]]",870,17,1750,17,887,2023,2620,290,1143,1767,0.39278350515463917,0.3320610687022901,0.9808342728297632,0.13494809688581316,0.8650519031141869,0.019165727170236752,0.49615055603079555
0.093,2910,"[[870, 1750], [17, 273]]",870,17,1750,17,887,2023,2620,290,1143,1767,0.39278350515463917,0.3320610687022901,0.9808342728297632,0.13494809688581316,0.8650519031141869,0.019165727170236752,0.49615055603079555
0.094,2910,"[[870, 1750], [17, 273]]",870,17,1750,17,887,2023,2620,290,1143,1767,0.39278350515463917,0.3320610687022901,0.9808342728297632,0.13494809688581316,0.8650519031141869,0.019165727170236752,0.49615055603079555
0.095,2910,"[[870, 1749], [17, 274]]",870,17,1749,17,887,2023,2619,291,1144,1766,0.393127147766323,0.3321878579610538,0.9808342728297632,0.13544241225902126,0.8645575877409788,0.019165727170236752,0.4962920707358814
0.096,2910,"[[870, 1749], [17, 274]]",870,17,1749,17,887,2023,2619,291,1144,1766,0.393127147766323,0.3321878579610538,0.9808342728297632,0.13544241225902126,0.8645575877409788,0.019165727170236752,0.4962920707358814
0.097,2910,"[[869, 1747], [18, 276]]",869,18,1747,18,887,2023,2616,294,1145,1765,0.39347079037800686,0.33218654434250766,0.979706877113867,0.13643104300543746,0.8635689569945625,0.020293122886133032,0.4961461604339138
0.098,2910,"[[869, 1747], [18, 276]]",869,18,1747,18,887,2023,2616,294,1145,1765,0.39347079037800686,0.33218654434250766,0.979706877113867,0.13643104300543746,0.8635689569945625,0.020293122886133032,0.4961461604339138
0.099,2910,"[[869, 1745], [18, 278]]",869,18,1745,18,887,2023,2614,296,1147,1763,0.39415807560137456,0.3324407039020658,0.979706877113867,0.13741967375185368,0.8625803262481463,0.020293122886133032,0.49642959154527283
0.1,2910,"[[869, 1744], [18, 279]]",869,18,1744,18,887,2023,2613,297,1148,1762,0.3945017182130584,0.33256792958285497,0.979706877113867,0.13791398912506178,0.8620860108749382,0.020293122886133032,0.4965714285714286
0.101,2910,"[[869, 1744], [18, 279]]",869,18,1744,18,887,2023,2613,297,1148,1762,0.3945017182130584,0.33256792958285497,0.979706877113867,0.13791398912506178,0.8620860108749382,0.020293122886133032,0.4965714285714286
0.102,2910,"[[869, 1743], [18, 280]]",869,18,1743,18,887,2023,2612,298,1149,1761,0.39484536082474225,0.33269525267993877,0.979706877113867,0.1384083044982699,0.8615916955017301,0.020293122886133032,0.4967133466704773
0.103,2910,"[[869, 1741], [18, 282]]",869,18,1741,18,887,2023,2610,300,1151,1759,0.39553264604810995,0.33295019157088124,0.979706877113867,0.1393969352446861,0.8606030647553139,0.020293122886133032,0.4969974263654561
0.104,2910,"[[869, 1741], [18, 282]]",869,18,1741,18,887,2023,2610,300,1151,1759,0.39553264604810995,0.33295019157088124,0.979706877113867,0.1393969352446861,0.8606030647553139,0.020293122886133032,0.4969974263654561
0.105,2910,"[[869, 1741], [18, 282]]",869,18,1741,18,887,2023,2610,300,1151,1759,0.39553264604810995,0.33295019157088124,0.979706877113867,0.1393969352446861,0.8606030647553139,0.020293122886133032,0.4969974263654561
0.106,2910,"[[869, 1741], [18, 282]]",869,18,1741,18,887,2023,2610,300,1151,1759,0.39553264604810995,0.33295019157088124,0.979706877113867,0.1393969352446861,0.8606030647553139,0.020293122886133032,0.4969974263654561
0.107,2910,"[[869, 1739], [18, 284]]",869,18,1739,18,887,2023,2608,302,1153,1757,0.39621993127147764,0.33320552147239263,0.979706877113867,0.14038556599110233,0.8596144340088977,0.020293122886133032,0.4972818311874106
0.108,2910,"[[869, 1738], [18, 285]]",869,18,1738,18,887,2023,2607,303,1154,1756,0.3965635738831615,0.3333333333333333,0.979706877113867,0.14087988136431043,0.8591201186356896,0.020293122886133032,0.49742415569547793
0.109,2910,"[[869, 1737], [18, 286]]",869,18,1737,18,887,2023,2606,304,1155,1755,0.39690721649484534,0.33346124328472754,0.979706877113867,0.14137419673751853,0.8586258032624815,0.020293122886133032,0.49756656169481817
0.11,2910,"[[869, 1736], [18, 287]]",869,18,1736,18,887,2023,2605,305,1156,1754,0.3972508591065292,0.3335892514395393,0.979706877113867,0.14186851211072665,0.8581314878892734,0.020293122886133032,0.4977090492554409
0.111,2910,"[[869, 1734], [18, 289]]",869,18,1734,18,887,2023,2603,307,1158,1752,0.3979381443298969,0.33384556281213984,0.979706877113867,0.14285714285714285,0.8571428571428571,0.020293122886133032,0.49799426934097424
0.112,2910,"[[869, 1732], [18, 291]]",869,18,1732,18,887,2023,2601,309,1160,1750,0.39862542955326463,0.33410226835832374,0.979706877113867,0.14384577360355907,0.8561542263964409,0.020293122886133032,0.49827981651376146
0.113,2910,"[[869, 1732], [18, 291]]",869,18,1732,18,887,2023,2601,309,1160,1750,0.39862542955326463,0.33410226835832374,0.979706877113867,0.14384577360355907,0.8561542263964409,0.020293122886133032,0.49827981651376146
0.114,2910,"[[869, 1731], [18, 292]]",869,18,1731,18,887,2023,2600,310,1161,1749,0.3989690721649485,0.3342307692307692,0.979706877113867,0.14434008897676717,0.8556599110232328,0.020293122886133032,0.4984227129337539
0.115,2910,"[[869, 1730], [18, 293]]",869,18,1730,18,887,2023,2599,311,1162,1748,0.3993127147766323,0.33435936898807234,0.979706877113867,0.14483440434997527,0.8551655956500247,0.020293122886133032,0.4985656913367757
0.116,2910,"[[869, 1730], [18, 293]]",869,18,1730,18,887,2023,2599,311,1162,1748,0.3993127147766323,0.33435936898807234,0.979706877113867,0.14483440434997527,0.8551655956500247,0.020293122886133032,0.4985656913367757
0.117,2910,"[[869, 1730], [18, 293]]",869,18,1730,18,887,2023,2599,311,1162,1748,0.3993127147766323,0.33435936898807234,0.979706877113867,0.14483440434997527,0.8551655956500247,0.020293122886133032,0.4985656913367757
0.118,2910,"[[869, 1729], [18, 294]]",869,18,1729,18,887,2023,2598,312,1163,1747,0.3996563573883162,0.3344880677444188,0.979706877113867,0.1453287197231834,0.8546712802768166,0.020293122886133032,0.4987087517934003
0.119,2910,"[[869, 1729], [18, 294]]",869,18,1729,18,887,2023,2598,312,1163,1747,0.3996563573883162,0.3344880677444188,0.979706877113867,0.1453287197231834,0.8546712802768166,0.020293122886133032,0.4987087517934003
0.12,2910,"[[869, 1728], [18, 295]]",869,18,1728,18,887,2023,2597,313,1164,1746,0.4,0.3346168656141702,0.979706877113867,0.1458230350963915,0.8541769649036085,0.020293122886133032,0.49885189437428246
0.121,2910,"[[869, 1727], [18, 296]]",869,18,1727,18,887,2023,2596,314,1165,1745,0.40034364261168387,0.3347457627118644,0.979706877113867,0.1463173504695996,0.8536826495304004,0.020293122886133032,0.49899511915015793
0.122,2910,"[[869, 1727], [18, 296]]",869,18,1727,18,887,2023,2596,314,1165,1745,0.40034364261168387,0.3347457627118644,0.979706877113867,0.1463173504695996,0.8536826495304004,0.020293122886133032,0.49899511915015793
0.123,2910,"[[869, 1727], [18, 296]]",869,18,1727,18,887,2023,2596,314,1165,1745,0.40034364261168387,0.3347457627118644,0.979706877113867,0.1463173504695996,0.8536826495304004,0.020293122886133032,0.49899511915015793
0.124,2910,"[[869, 1727], [18, 296]]",869,18,1727,18,887,2023,2596,314,1165,1745,0.40034364261168387,0.3347457627118644,0.979706877113867,0.1463173504695996,0.8536826495304004,0.020293122886133032,0.49899511915015793
0.125,2910,"[[869, 1726], [18, 297]]",869,18,1726,18,887,2023,2595,315,1166,1744,0.4006872852233677,0.3348747591522158,0.979706877113867,0.14681166584280772,0.8531883341571923,0.020293122886133032,0.49913842619184384
0.126,2910,"[[869, 1726], [18, 297]]",869,18,1726,18,887,2023,2595,315,1166,1744,0.4006872852233677,0.3348747591522158,0.979706877113867,0.14681166584280772,0.8531883341571923,0.020293122886133032,0.49913842619184384
0.127,2910,"[[869, 1725], [18, 298]]",869,18,1725,18,887,2023,2594,316,1167,1743,0.40103092783505156,0.33500385505011565,0.979706877113867,0.14730598121601582,0.8526940187839842,0.020293122886133032,0.49928181557023843
0.128,2910,"[[869, 1725], [18, 298]]",869,18,1725,18,887,2023,2594,316,1167,1743,0.40103092783505156,0.33500385505011565,0.979706877113867,0.14730598121601582,0.8526940187839842,0.020293122886133032,0.49928181557023843
0.129,2910,"[[869, 1725], [18, 298]]",869,18,1725,18,887,2023,2594,316,1167,1743,0.40103092783505156,0.33500385505011565,0.979706877113867,0.14730598121601582,0.8526940187839842,0.020293122886133032,0.49928181557023843
0.13,2910,"[[869, 1724], [18, 299]]",869,18,1724,18,887,2023,2593,317,1168,1742,0.4013745704467354,0.33513305052063247,0.979706877113867,0.14780029658922392,0.8521997034107761,0.020293122886133032,0.49942528735632175
0.131,2910,"[[869, 1721], [18, 302]]",869,18,1721,18,887,2023,2590,320,1171,1739,0.40240549828178696,0.33552123552123553,0.979706877113867,0.14928324270884824,0.8507167572911517,0.020293122886133032,0.4998561978717286
0.132,2910,"[[869, 1720], [18, 303]]",869,18,1720,18,887,2023,2589,321,1172,1738,0.4027491408934708,0.33565083043646193,0.979706877113867,0.14977755808205634,0.8502224419179436,0.020293122886133032,0.5
0.133,2910,"[[869, 1720], [18, 303]]",869,18,1720,18,887,2023,2589,321,1172,1738,0.4027491408934708,0.33565083043646193,0.979706877113867,0.14977755808205634,0.8502224419179436,0.020293122886133032,0.5
0.134,2910,"[[869, 1719], [18, 304]]",869,18,1719,18,887,2023,2588,322,1173,1737,0.40309278350515465,0.3357805255023184,0.979706877113867,0.15027187345526447,0.8497281265447355,0.020293122886133032,0.5001438848920864
0.135,2910,"[[869, 1717], [18, 306]]",869,18,1717,18,887,2023,2586,324,1175,1735,0.40378006872852235,0.3360402165506574,0.979706877113867,0.15126050420168066,0.8487394957983193,0.020293122886133032,0.5004319032536712
0.136,2910,"[[869, 1717], [18, 306]]",869,18,1717,18,887,2023,2586,324,1175,1735,0.40378006872852235,0.3360402165506574,0.979706877113867,0.15126050420168066,0.8487394957983193,0.020293122886133032,0.5004319032536712
0.137,2910,"[[869, 1716], [18, 307]]",869,18,1716,18,887,2023,2585,325,1176,1734,0.4041237113402062,0.33617021276595743,0.979706877113867,0.1517548195748888,0.8482451804251112,0.020293122886133032,0.5005760368663594
0.138,2910,"[[869, 1716], [18, 307]]",869,18,1716,18,887,2023,2585,325,1176,1734,0.4041237113402062,0.33617021276595743,0.979706877113867,0.1517548195748888,0.8482451804251112,0.020293122886133032,0.5005760368663594
0.139,2910,"[[869, 1715], [18, 308]]",869,18,1715,18,887,2023,2584,326,1177,1733,0.40446735395189004,0.3363003095975232,0.979706877113867,0.1522491349480969,0.8477508650519031,0.020293122886133032,0.5007202535292422
0.14,2910,"[[869, 1715], [18, 308]]",869,18,1715,18,887,2023,2584,326,1177,1733,0.40446735395189004,0.3363003095975232,0.979706877113867,0.1522491349480969,0.8477508650519031,0.020293122886133032,0.5007202535292422
0.141,2910,"[[869, 1712], [18, 311]]",869,18,1712,18,887,2023,2581,329,1180,1730,0.4054982817869416,0.3366912049593181,0.979706877113867,0.1537320810677212,0.8462679189322788,0.020293122886133032,0.5011534025374855
0.142,2910,"[[869, 1710], [18, 313]]",869,18,1710,18,887,2023,2579,331,1182,1728,0.4061855670103093,0.33695230709577356,0.979706877113867,0.1547207118141374,0.8452792881858626,0.020293122886133032,0.5014425851125216
0.143,2910,"[[869, 1710], [18, 313]]",869,18,1710,18,887,2023,2579,331,1182,1728,0.4061855670103093,0.33695230709577356,0.979706877113867,0.1547207118141374,0.8452792881858626,0.020293122886133032,0.5014425851125216
0.144,2910,"[[869, 1709], [18, 314]]",869,18,1709,18,887,2023,2578,332,1183,1727,0.4065292096219931,0.3370830100853375,0.979706877113867,0.15521502718734553,0.8447849728126545,0.020293122886133032,0.5015873015873017
0.145,2910,"[[869, 1709], [18, 314]]",869,18,1709,18,887,2023,2578,332,1183,1727,0.4065292096219931,0.3370830100853375,0.979706877113867,0.15521502718734553,0.8447849728126545,0.020293122886133032,0.5015873015873017
0.146,2910,"[[869, 1709], [18, 314]]",869,18,1709,18,887,2023,2578,332,1183,1727,0.4065292096219931,0.3370830100853375,0.979706877113867,0.15521502718734553,0.8447849728126545,0.020293122886133032,0.5015873015873017
0.147,2910,"[[869, 1709], [18, 314]]",869,18,1709,18,887,2023,2578,332,1183,1727,0.4065292096219931,0.3370830100853375,0.979706877113867,0.15521502718734553,0.8447849728126545,0.020293122886133032,0.5015873015873017
0.148,2910,"[[869, 1708], [18, 315]]",869,18,1708,18,887,2023,2577,333,1184,1726,0.406872852233677,0.3372138145129996,0.979706877113867,0.15570934256055363,0.8442906574394463,0.020293122886133032,0.5017321016166282
0.149,2910,"[[869, 1708], [18, 315]]",869,18,1708,18,887,2023,2577,333,1184,1726,0.406872852233677,0.3372138145129996,0.979706877113867,0.15570934256055363,0.8442906574394463,0.020293122886133032,0.5017321016166282
0.15,2910,"[[869, 1708], [18, 315]]",869,18,1708,18,887,2023,2577,333,1184,1726,0.406872852233677,0.3372138145129996,0.979706877113867,0.15570934256055363,0.8442906574394463,0.020293122886133032,0.5017321016166282
0.151,2910,"[[869, 1708], [18, 315]]",869,18,1708,18,887,2023,2577,333,1184,1726,0.406872852233677,0.3372138145129996,0.979706877113867,0.15570934256055363,0.8442906574394463,0.020293122886133032,0.5017321016166282
0.152,2910,"[[869, 1708], [18, 315]]",869,18,1708,18,887,2023,2577,333,1184,1726,0.406872852233677,0.3372138145129996,0.979706877113867,0.15570934256055363,0.8442906574394463,0.020293122886133032,0.5017321016166282
0.153,2910,"[[869, 1708], [18, 315]]",869,18,1708,18,887,2023,2577,333,1184,1726,0.406872852233677,0.3372138145129996,0.979706877113867,0.15570934256055363,0.8442906574394463,0.020293122886133032,0.5017321016166282
0.154,2910,"[[869, 1707], [18, 316]]",869,18,1707,18,887,2023,2576,334,1185,1725,0.4072164948453608,0.3373447204968944,0.979706877113867,0.15620365793376173,0.8437963420662382,0.020293122886133032,0.5018769852728848
0.155,2910,"[[869, 1707], [18, 316]]",869,18,1707,18,887,2023,2576,334,1185,1725,0.4072164948453608,0.3373447204968944,0.979706877113867,0.15620365793376173,0.8437963420662382,0.020293122886133032,0.5018769852728848
0.156,2910,"[[869, 1707], [18, 316]]",869,18,1707,18,887,2023,2576,334,1185,1725,0.4072164948453608,0.3373447204968944,0.979706877113867,0.15620365793376173,0.8437963420662382,0.020293122886133032,0.5018769852728848
0.157,2910,"[[869, 1707], [18, 316]]",869,18,1707,18,887,2023,2576,334,1185,1725,0.4072164948453608,0.3373447204968944,0.979706877113867,0.15620365793376173,0.8437963420662382,0.020293122886133032,0.5018769852728848
0.158,2910,"[[869, 1707], [18, 316]]",869,18,1707,18,887,2023,2576,334,1185,1725,0.4072164948453608,0.3373447204968944,0.979706877113867,0.15620365793376173,0.8437963420662382,0.020293122886133032,0.5018769852728848
0.159,2910,"[[869, 1706], [18, 317]]",869,18,1706,18,887,2023,2575,335,1186,1724,0.40756013745704467,0.3374757281553398,0.979706877113867,0.15669797330696986,0.8433020266930301,0.020293122886133032,0.5020219526285383
0.16,2910,"[[869, 1705], [18, 318]]",869,18,1705,18,887,2023,2574,336,1187,1723,0.4079037800687285,0.33760683760683763,0.979706877113867,0.15719228868017796,0.842807711319822,0.020293122886133032,0.5021670037561399
0.161,2910,"[[869, 1705], [18, 318]]",869,18,1705,18,887,2023,2574,336,1187,1723,0.4079037800687285,0.33760683760683763,0.979706877113867,0.15719228868017796,0.842807711319822,0.020293122886133032,0.5021670037561399
0.162,2910,"[[869, 1705], [18, 318]]",869,18,1705,18,887,2023,2574,336,1187,1723,0.4079037800687285,0.33760683760683763,0.979706877113867,0.15719228868017796,0.842807711319822,0.020293122886133032,0.5021670037561399
0.163,2910,"[[869, 1704], [18, 319]]",869,18,1704,18,887,2023,2573,337,1188,1722,0.40824742268041236,0.33773804897007387,0.979706877113867,0.15768660405338605,0.8423133959466139,0.020293122886133032,0.5023121387283237
0.164,2910,"[[869, 1704], [18, 319]]",869,18,1704,18,887,2023,2573,337,1188,1722,0.40824742268041236,0.33773804897007387,0.979706877113867,0.15768660405338605,0.8423133959466139,0.020293122886133032,0.5023121387283237
0.165,2910,"[[869, 1702], [18, 321]]",869,18,1702,18,887,2023,2571,339,1190,1720,0.40893470790378006,0.338000777907429,0.979706877113867,0.15867523479980228,0.8413247652001977,0.020293122886133032,0.5026026604973974
0.166,2910,"[[869, 1702], [18, 321]]",869,18,1702,18,887,2023,2571,339,1190,1720,0.40893470790378006,0.338000777907429,0.979706877113867,0.15867523479980228,0.8413247652001977,0.020293122886133032,0.5026026604973974
0.167,2910,"[[868, 1701], [19, 322]]",868,19,1701,19,887,2023,2569,341,1190,1720,0.40893470790378006,0.33787465940054495,0.9785794813979707,0.15916955017301038,0.8408304498269896,0.02142051860202931,0.5023148148148148
0.168,2910,"[[868, 1700], [19, 323]]",868,19,1700,19,887,2023,2568,342,1191,1719,0.4092783505154639,0.338006230529595,0.9785794813979707,0.15966386554621848,0.8403361344537815,0.02142051860202931,0.5024602026049203
0.169,2910,"[[868, 1699], [19, 324]]",868,19,1699,19,887,2023,2567,343,1192,1718,0.40962199312714775,0.3381379041682898,0.9785794813979707,0.1601581809194266,0.8398418190805734,0.02142051860202931,0.5026056745801969
0.17,2910,"[[868, 1698], [19, 325]]",868,19,1698,19,887,2023,2566,344,1193,1717,0.4099656357388316,0.338269680436477,0.9785794813979707,0.1606524962926347,0.8393475037073653,0.02142051860202931,0.5027512308137851
0.171,2910,"[[868, 1698], [19, 325]]",868,19,1698,19,887,2023,2566,344,1193,1717,0.4099656357388316,0.338269680436477,0.9785794813979707,0.1606524962926347,0.8393475037073653,0.02142051860202931,0.5027512308137851
0.172,2910,"[[868, 1698], [19, 325]]",868,19,1698,19,887,2023,2566,344,1193,1717,0.4099656357388316,0.338269680436477,0.9785794813979707,0.1606524962926347,0.8393475037073653,0.02142051860202931,0.5027512308137851
0.173,2910,"[[868, 1698], [19, 325]]",868,19,1698,19,887,2023,2566,344,1193,1717,0.4099656357388316,0.338269680436477,0.9785794813979707,0.1606524962926347,0.8393475037073653,0.02142051860202931,0.5027512308137851
0.174,2910,"[[868, 1698], [19, 325]]",868,19,1698,19,887,2023,2566,344,1193,1717,0.4099656357388316,0.338269680436477,0.9785794813979707,0.1606524962926347,0.8393475037073653,0.02142051860202931,0.5027512308137851
0.175,2910,"[[868, 1697], [19, 326]]",868,19,1697,19,887,2023,2565,345,1194,1716,0.41030927835051545,0.33840155945419104,0.9785794813979707,0.1611468116658428,0.8388531883341572,0.02142051860202931,0.5028968713789108
0.176,2910,"[[868, 1695], [19, 328]]",868,19,1695,19,887,2023,2563,347,1196,1714,0.41099656357388314,0.33866562621927426,0.9785794813979707,0.16213544241225902,0.837864557587741,0.02142051860202931,0.5031884057971014
0.177,2910,"[[868, 1694], [19, 329]]",868,19,1694,19,887,2023,2562,348,1197,1713,0.411340206185567,0.33879781420765026,0.9785794813979707,0.16262975778546712,0.8373702422145328,0.02142051860202931,0.5033342997970427
0.178,2910,"[[868, 1693], [19, 330]]",868,19,1693,19,887,2023,2561,349,1198,1712,0.41168384879725084,0.33893010542756735,0.9785794813979707,0.16312407315867525,0.8368759268413247,0.02142051860202931,0.5034802784222738
0.179,2910,"[[868, 1693], [19, 330]]",868,19,1693,19,887,2023,2561,349,1198,1712,0.41168384879725084,0.33893010542756735,0.9785794813979707,0.16312407315867525,0.8368759268413247,0.02142051860202931,0.5034802784222738
0.18,2910,"[[868, 1693], [19, 330]]",868,19,1693,19,887,2023,2561,349,1198,1712,0.41168384879725084,0.33893010542756735,0.9785794813979707,0.16312407315867525,0.8368759268413247,0.02142051860202931,0.5034802784222738
0.181,2910,"[[868, 1693], [19, 330]]",868,19,1693,19,887,2023,2561,349,1198,1712,0.41168384879725084,0.33893010542756735,0.9785794813979707,0.16312407315867525,0.8368759268413247,0.02142051860202931,0.5034802784222738
0.182,2910,"[[868, 1692], [19, 331]]",868,19,1692,19,887,2023,2560,350,1199,1711,0.4120274914089347,0.3390625,0.9785794813979707,0.16361838853188335,0.8363816114681166,0.02142051860202931,0.5036263417464462
0.183,2910,"[[868, 1691], [19, 332]]",868,19,1691,19,887,2023,2559,351,1200,1710,0.41237113402061853,0.33919499804611175,0.9785794813979707,0.16411270390509144,0.8358872960949085,0.02142051860202931,0.5037724898432966
0.184,2910,"[[868, 1690], [19, 333]]",868,19,1690,19,887,2023,2558,352,1201,1709,0.4127147766323024,0.3393275996872557,0.9785794813979707,0.16460701927829954,0.8353929807217004,0.02142051860202931,0.5039187227866473
0.185,2910,"[[867, 1690], [20, 333]]",867,20,1690,20,887,2023,2557,353,1200,1710,0.41237113402061853,0.33906922174423154,0.9774520856820744,0.16460701927829954,0.8353929807217004,0.02254791431792559,0.5034843205574913
0.186,2910,"[[867, 1689], [20, 334]]",867,20,1689,20,887,2023,2556,354,1201,1709,0.4127147766323024,0.3392018779342723,0.9774520856820744,0.16510133465150767,0.8348986653484923,0.02254791431792559,0.5036305547487656
0.187,2910,"[[867, 1689], [20, 334]]",867,20,1689,20,887,2023,2556,354,1201,1709,0.4127147766323024,0.3392018779342723,0.9774520856820744,0.16510133465150767,0.8348986653484923,0.02254791431792559,0.5036305547487656
0.188,2910,"[[867, 1689], [20, 334]]",867,20,1689,20,887,2023,2556,354,1201,1709,0.4127147766323024,0.3392018779342723,0.9774520856820744,0.16510133465150767,0.8348986653484923,0.02254791431792559,0.5036305547487656
0.189,2910,"[[867, 1689], [20, 334]]",867,20,1689,20,887,2023,2556,354,1201,1709,0.4127147766323024,0.3392018779342723,0.9774520856820744,0.16510133465150767,0.8348986653484923,0.02254791431792559,0.5036305547487656
0.19,2910,"[[867, 1689], [20, 334]]",867,20,1689,20,887,2023,2556,354,1201,1709,0.4127147766323024,0.3392018779342723,0.9774520856820744,0.16510133465150767,0.8348986653484923,0.02254791431792559,0.5036305547487656
0.191,2910,"[[867, 1689], [20, 334]]",867,20,1689,20,887,2023,2556,354,1201,1709,0.4127147766323024,0.3392018779342723,0.9774520856820744,0.16510133465150767,0.8348986653484923,0.02254791431792559,0.5036305547487656
0.192,2910,"[[867, 1688], [20, 335]]",867,20,1688,20,887,2023,2555,355,1202,1708,0.41305841924398623,0.339334637964775,0.9774520856820744,0.16559565002471577,0.8344043499752842,0.02254791431792559,0.5037768739105173
0.193,2910,"[[867, 1688], [20, 335]]",867,20,1688,20,887,2023,2555,355,1202,1708,0.41305841924398623,0.339334637964775,0.9774520856820744,0.16559565002471577,0.8344043499752842,0.02254791431792559,0.5037768739105173
0.194,2910,"[[867, 1687], [20, 336]]",867,20,1687,20,887,2023,2554,356,1203,1707,0.4134020618556701,0.3394675019577134,0.9774520856820744,0.16608996539792387,0.8339100346020761,0.02254791431792559,0.5039232781168266
0.195,2910,"[[867, 1687], [20, 336]]",867,20,1687,20,887,2023,2554,356,1203,1707,0.4134020618556701,0.3394675019577134,0.9774520856820744,0.16608996539792387,0.8339100346020761,0.02254791431792559,0.5039232781168266
0.196,2910,"[[867, 1687], [20, 336]]",867,20,1687,20,887,2023,2554,356,1203,1707,0.4134020618556701,0.3394675019577134,0.9774520856820744,0.16608996539792387,0.8339100346020761,0.02254791431792559,0.5039232781168266
0.197,2910,"[[867, 1687], [20, 336]]",867,20,1687,20,887,2023,2554,356,1203,1707,0.4134020618556701,0.3394675019577134,0.9774520856820744,0.16608996539792387,0.8339100346020761,0.02254791431792559,0.5039232781168266
0.198,2910,"[[867, 1687], [20, 336]]",867,20,1687,20,887,2023,2554,356,1203,1707,0.4134020618556701,0.3394675019577134,0.9774520856820744,0.16608996539792387,0.8339100346020761,0.02254791431792559,0.5039232781168266
0.199,2910,"[[867, 1685], [20, 338]]",867,20,1685,20,887,2023,2552,358,1205,1705,0.41408934707903783,0.3397335423197492,0.9774520856820744,0.1670785961443401,0.8329214038556599,0.02254791431792559,0.504216341959872
0.2,2910,"[[867, 1683], [20, 340]]",867,20,1683,20,887,2023,2550,360,1207,1703,0.4147766323024055,0.34,0.9774520856820744,0.16806722689075632,0.8319327731092437,0.02254791431792559,0.5045097468722725
0.201,2910,"[[867, 1681], [20, 342]]",867,20,1681,20,887,2023,2548,362,1209,1701,0.4154639175257732,0.3402668759811617,0.9774520856820744,0.1690558576371725,0.8309441423628274,0.02254791431792559,0.5048034934497816
0.202,2910,"[[867, 1681], [20, 342]]",867,20,1681,20,887,2023,2548,362,1209,1701,0.4154639175257732,0.3402668759811617,0.9774520856820744,0.1690558576371725,0.8309441423628274,0.02254791431792559,0.5048034934497816
0.203,2910,"[[867, 1680], [20, 343]]",867,20,1680,20,887,2023,2547,363,1210,1700,0.41580756013745707,0.3404004711425206,0.9774520856820744,0.1695501730103806,0.8304498269896193,0.02254791431792559,0.5049504950495048
0.204,2910,"[[867, 1680], [20, 343]]",867,20,1680,20,887,2023,2547,363,1210,1700,0.41580756013745707,0.3404004711425206,0.9774520856820744,0.1695501730103806,0.8304498269896193,0.02254791431792559,0.5049504950495048
0.205,2910,"[[867, 1679], [20, 344]]",867,20,1679,20,887,2023,2546,364,1211,1699,0.4161512027491409,0.3405341712490181,0.9774520856820744,0.17004448838358874,0.8299555116164112,0.02254791431792559,0.5050975822895427
0.206,2910,"[[867, 1678], [20, 345]]",867,20,1678,20,887,2023,2545,365,1212,1698,0.41649484536082476,0.3406679764243615,0.9774520856820744,0.17053880375679684,0.8294611962432031,0.02254791431792559,0.5052447552447552
0.207,2910,"[[867, 1676], [20, 347]]",867,20,1676,20,887,2023,2543,367,1214,1696,0.41718213058419246,0.3409359024773889,0.9774520856820744,0.17152743450321306,0.8284725654967869,0.02254791431792559,0.5055393586005831
0.208,2910,"[[867, 1676], [20, 347]]",867,20,1676,20,887,2023,2543,367,1214,1696,0.41718213058419246,0.3409359024773889,0.9774520856820744,0.17152743450321306,0.8284725654967869,0.02254791431792559,0.5055393586005831
0.209,2910,"[[867, 1676], [20, 347]]",867,20,1676,20,887,2023,2543,367,1214,1696,0.41718213058419246,0.3409359024773889,0.9774520856820744,0.17152743450321306,0.8284725654967869,0.02254791431792559,0.5055393586005831
0.21,2910,"[[867, 1676], [20, 347]]",867,20,1676,20,887,2023,2543,367,1214,1696,0.41718213058419246,0.3409359024773889,0.9774520856820744,0.17152743450321306,0.8284725654967869,0.02254791431792559,0.5055393586005831
0.211,2910,"[[867, 1675], [20, 348]]",867,20,1675,20,887,2023,2542,368,1215,1695,0.4175257731958763,0.34107002360346184,0.9774520856820744,0.17202174987642116,0.8279782501235788,0.02254791431792559,0.505686789151356
0.212,2910,"[[867, 1674], [20, 349]]",867,20,1674,20,887,2023,2541,369,1216,1694,0.41786941580756015,0.3412042502951594,0.9774520856820744,0.17251606524962926,0.8274839347503707,0.02254791431792559,0.5058343057176196
0.213,2910,"[[867, 1672], [20, 351]]",867,20,1672,20,887,2023,2539,371,1218,1692,0.41855670103092785,0.34147302087436,0.9774520856820744,0.17350469599604548,0.8264953040039545,0.02254791431792559,0.5061295971978984
0.214,2910,"[[867, 1671], [20, 352]]",867,20,1671,20,887,2023,2538,372,1219,1691,0.4189003436426117,0.3416075650118203,0.9774520856820744,0.17399901136925358,0.8260009886307464,0.02254791431792559,0.5062773722627737
0.215,2910,"[[867, 1671], [20, 352]]",867,20,1671,20,887,2023,2538,372,1219,1691,0.4189003436426117,0.3416075650118203,0.9774520856820744,0.17399901136925358,0.8260009886307464,0.02254791431792559,0.5062773722627737
0.216,2910,"[[867, 1671], [20, 352]]",867,20,1671,20,887,2023,2538,372,1219,1691,0.4189003436426117,0.3416075650118203,0.9774520856820744,0.17399901136925358,0.8260009886307464,0.02254791431792559,0.5062773722627737
0.217,2910,"[[867, 1671], [20, 352]]",867,20,1671,20,887,2023,2538,372,1219,1691,0.4189003436426117,0.3416075650118203,0.9774520856820744,0.17399901136925358,0.8260009886307464,0.02254791431792559,0.5062773722627737
0.218,2910,"[[867, 1671], [20, 352]]",867,20,1671,20,887,2023,2538,372,1219,1691,0.4189003436426117,0.3416075650118203,0.9774520856820744,0.17399901136925358,0.8260009886307464,0.02254791431792559,0.5062773722627737
0.219,2910,"[[867, 1671], [20, 352]]",867,20,1671,20,887,2023,2538,372,1219,1691,0.4189003436426117,0.3416075650118203,0.9774520856820744,0.17399901136925358,0.8260009886307464,0.02254791431792559,0.5062773722627737
0.22,2910,"[[867, 1671], [20, 352]]",867,20,1671,20,887,2023,2538,372,1219,1691,0.4189003436426117,0.3416075650118203,0.9774520856820744,0.17399901136925358,0.8260009886307464,0.02254791431792559,0.5062773722627737
0.221,2910,"[[867, 1671], [20, 352]]",867,20,1671,20,887,2023,2538,372,1219,1691,0.4189003436426117,0.3416075650118203,0.9774520856820744,0.17399901136925358,0.8260009886307464,0.02254791431792559,0.5062773722627737
0.222,2910,"[[867, 1671], [20, 352]]",867,20,1671,20,887,2023,2538,372,1219,1691,0.4189003436426117,0.3416075650118203,0.9774520856820744,0.17399901136925358,0.8260009886307464,0.02254791431792559,0.5062773722627737
0.223,2910,"[[867, 1671], [20, 352]]",867,20,1671,20,887,2023,2538,372,1219,1691,0.4189003436426117,0.3416075650118203,0.9774520856820744,0.17399901136925358,0.8260009886307464,0.02254791431792559,0.5062773722627737
0.224,2910,"[[867, 1671], [20, 352]]",867,20,1671,20,887,2023,2538,372,1219,1691,0.4189003436426117,0.3416075650118203,0.9774520856820744,0.17399901136925358,0.8260009886307464,0.02254791431792559,0.5062773722627737
0.225,2910,"[[867, 1671], [20, 352]]",867,20,1671,20,887,2023,2538,372,1219,1691,0.4189003436426117,0.3416075650118203,0.9774520856820744,0.17399901136925358,0.8260009886307464,0.02254791431792559,0.5062773722627737
0.226,2910,"[[867, 1671], [20, 352]]",867,20,1671,20,887,2023,2538,372,1219,1691,0.4189003436426117,0.3416075650118203,0.9774520856820744,0.17399901136925358,0.8260009886307464,0.02254791431792559,0.5062773722627737
0.227,2910,"[[866, 1670], [21, 353]]",866,21,1670,21,887,2023,2536,374,1219,1691,0.4189003436426117,0.3414826498422713,0.9763246899661782,0.17449332674246168,0.8255066732575383,0.02367531003382187,0.5059888986269354
0.228,2910,"[[866, 1670], [21, 353]]",866,21,1670,21,887,2023,2536,374,1219,1691,0.4189003436426117,0.3414826498422713,0.9763246899661782,0.17449332674246168,0.8255066732575383,0.02367531003382187,0.5059888986269354
0.229,2910,"[[866, 1669], [21, 354]]",866,21,1669,21,887,2023,2535,375,1220,1690,0.41924398625429554,0.3416173570019724,0.9763246899661782,0.1749876421156698,0.8250123578843302,0.02367531003382187,0.5061367621274109
0.23,2910,"[[866, 1669], [21, 354]]",866,21,1669,21,887,2023,2535,375,1220,1690,0.41924398625429554,0.3416173570019724,0.9763246899661782,0.1749876421156698,0.8250123578843302,0.02367531003382187,0.5061367621274109
0.231,2910,"[[866, 1669], [21, 354]]",866,21,1669,21,887,2023,2535,375,1220,1690,0.41924398625429554,0.3416173570019724,0.9763246899661782,0.1749876421156698,0.8250123578843302,0.02367531003382187,0.5061367621274109
0.232,2910,"[[866, 1669], [21, 354]]",866,21,1669,21,887,2023,2535,375,1220,1690,0.41924398625429554,0.3416173570019724,0.9763246899661782,0.1749876421156698,0.8250123578843302,0.02367531003382187,0.5061367621274109
0.233,2910,"[[866, 1669], [21, 354]]",866,21,1669,21,887,2023,2535,375,1220,1690,0.41924398625429554,0.3416173570019724,0.9763246899661782,0.1749876421156698,0.8250123578843302,0.02367531003382187,0.5061367621274109
0.234,2910,"[[866, 1667], [21, 356]]",866,21,1667,21,887,2023,2533,377,1222,1688,0.41993127147766324,0.34188709040663245,0.9763246899661782,0.175976272862086,0.8240237271379139,0.02367531003382187,0.5064327485380117
0.235,2910,"[[866, 1667], [21, 356]]",866,21,1667,21,887,2023,2533,377,1222,1688,0.41993127147766324,0.34188709040663245,0.9763246899661782,0.175976272862086,0.8240237271379139,0.02367531003382187,0.5064327485380117
0.236,2910,"[[866, 1665], [21, 358]]",866,21,1665,21,887,2023,2531,379,1224,1686,0.42061855670103093,0.3421572500987752,0.9763246899661782,0.17696490360850223,0.8230350963914977,0.02367531003382187,0.5067290813341135
0.237,2910,"[[866, 1665], [21, 358]]",866,21,1665,21,887,2023,2531,379,1224,1686,0.42061855670103093,0.3421572500987752,0.9763246899661782,0.17696490360850223,0.8230350963914977,0.02367531003382187,0.5067290813341135
0.238,2910,"[[866, 1665], [21, 358]]",866,21,1665,21,887,2023,2531,379,1224,1686,0.42061855670103093,0.3421572500987752,0.9763246899661782,0.17696490360850223,0.8230350963914977,0.02367531003382187,0.5067290813341135
0.239,2910,"[[866, 1665], [21, 358]]",866,21,1665,21,887,2023,2531,379,1224,1686,0.42061855670103093,0.3421572500987752,0.9763246899661782,0.17696490360850223,0.8230350963914977,0.02367531003382187,0.5067290813341135
0.24,2910,"[[866, 1664], [21, 359]]",866,21,1664,21,887,2023,2530,380,1225,1685,0.4209621993127148,0.3422924901185771,0.9763246899661782,0.17745921898171033,0.8225407810182896,0.02367531003382187,0.5068773778167984
0.241,2910,"[[866, 1664], [21, 359]]",866,21,1664,21,887,2023,2530,380,1225,1685,0.4209621993127148,0.3422924901185771,0.9763246899661782,0.17745921898171033,0.8225407810182896,0.02367531003382187,0.5068773778167984
0.242,2910,"[[866, 1662], [21, 361]]",866,21,1662,21,887,2023,2528,382,1227,1683,0.4216494845360825,0.3425632911392405,0.9763246899661782,0.17844784972812655,0.8215521502718734,0.02367531003382187,0.5071742313323573
0.243,2910,"[[866, 1662], [21, 361]]",866,21,1662,21,887,2023,2528,382,1227,1683,0.4216494845360825,0.3425632911392405,0.9763246899661782,0.17844784972812655,0.8215521502718734,0.02367531003382187,0.5071742313323573
0.244,2910,"[[866, 1662], [21, 361]]",866,21,1662,21,887,2023,2528,382,1227,1683,0.4216494845360825,0.3425632911392405,0.9763246899661782,0.17844784972812655,0.8215521502718734,0.02367531003382187,0.5071742313323573
0.245,2910,"[[866, 1662], [21, 361]]",866,21,1662,21,887,2023,2528,382,1227,1683,0.4216494845360825,0.3425632911392405,0.9763246899661782,0.17844784972812655,0.8215521502718734,0.02367531003382187,0.5071742313323573
0.246,2910,"[[866, 1662], [21, 361]]",866,21,1662,21,887,2023,2528,382,1227,1683,0.4216494845360825,0.3425632911392405,0.9763246899661782,0.17844784972812655,0.8215521502718734,0.02367531003382187,0.5071742313323573
0.247,2910,"[[866, 1661], [21, 362]]",866,21,1661,21,887,2023,2527,383,1228,1682,0.4219931271477663,0.34269885239414327,0.9763246899661782,0.17894216510133465,0.8210578348986654,0.02367531003382187,0.5073227885178676
0.248,2910,"[[866, 1660], [21, 363]]",866,21,1660,21,887,2023,2526,384,1229,1681,0.42233676975945017,0.3428345209817894,0.9763246899661782,0.17943648047454275,0.8205635195254573,0.02367531003382187,0.5074714327571053
0.249,2910,"[[866, 1660], [21, 363]]",866,21,1660,21,887,2023,2526,384,1229,1681,0.42233676975945017,0.3428345209817894,0.9763246899661782,0.17943648047454275,0.8205635195254573,0.02367531003382187,0.5074714327571053
0.25,2910,"[[866, 1660], [21, 363]]",866,21,1660,21,887,2023,2526,384,1229,1681,0.42233676975945017,0.3428345209817894,0.9763246899661782,0.17943648047454275,0.8205635195254573,0.02367531003382187,0.5074714327571053
0.251,2910,"[[866, 1660], [21, 363]]",866,21,1660,21,887,2023,2526,384,1229,1681,0.42233676975945017,0.3428345209817894,0.9763246899661782,0.17943648047454275,0.8205635195254573,0.02367531003382187,0.5074714327571053
0.252,2910,"[[866, 1660], [21, 363]]",866,21,1660,21,887,2023,2526,384,1229,1681,0.42233676975945017,0.3428345209817894,0.9763246899661782,0.17943648047454275,0.8205635195254573,0.02367531003382187,0.5074714327571053
0.253,2910,"[[866, 1660], [21, 363]]",866,21,1660,21,887,2023,2526,384,1229,1681,0.42233676975945017,0.3428345209817894,0.9763246899661782,0.17943648047454275,0.8205635195254573,0.02367531003382187,0.5074714327571053
0.254,2910,"[[866, 1660], [21, 363]]",866,21,1660,21,887,2023,2526,384,1229,1681,0.42233676975945017,0.3428345209817894,0.9763246899661782,0.17943648047454275,0.8205635195254573,0.02367531003382187,0.5074714327571053
0.255,2910,"[[865, 1660], [22, 363]]",865,22,1660,22,887,2023,2525,385,1228,1682,0.4219931271477663,0.3425742574257426,0.9751972942502819,0.17943648047454275,0.8205635195254573,0.02480270574971815,0.5070339976553342
0.256,2910,"[[865, 1660], [22, 363]]",865,22,1660,22,887,2023,2525,385,1228,1682,0.4219931271477663,0.3425742574257426,0.9751972942502819,0.17943648047454275,0.8205635195254573,0.02480270574971815,0.5070339976553342
0.257,2910,"[[865, 1659], [22, 364]]",865,22,1659,22,887,2023,2524,386,1229,1681,0.42233676975945017,0.34270998415213944,0.9751972942502819,0.17993079584775087,0.8200692041522492,0.02480270574971815,0.5071826443858106
0.258,2910,"[[865, 1658], [22, 365]]",865,22,1658,22,887,2023,2523,387,1230,1680,0.422680412371134,0.3428458184700753,0.9751972942502819,0.18042511122095897,0.819574888779041,0.02480270574971815,0.5073313782991202
0.259,2910,"[[865, 1657], [22, 366]]",865,22,1657,22,887,2023,2522,388,1231,1679,0.42302405498281787,0.3429817605075337,0.9751972942502819,0.18091942659416707,0.819080573405833,0.02480270574971815,0.507480199471986
0.26,2910,"[[865, 1656], [22, 367]]",865,22,1656,22,887,2023,2521,389,1232,1678,0.4233676975945017,0.3431178103927013,0.9751972942502819,0.1814137419673752,0.8185862580326249,0.02480270574971815,0.5076291079812206
0.261,2910,"[[865, 1655], [22, 368]]",865,22,1655,22,887,2023,2520,390,1233,1677,0.42371134020618556,0.34325396825396826,0.9751972942502819,0.1819080573405833,0.8180919426594168,0.02480270574971815,0.5077781039037277
0.262,2910,"[[865, 1653], [22, 370]]",865,22,1653,22,887,2023,2518,392,1235,1675,0.42439862542955326,0.3435266084193805,0.9751972942502819,0.1828966880869995,0.8171033119130005,0.02480270574971815,0.5080763582966227
0.263,2910,"[[865, 1653], [22, 370]]",865,22,1653,22,887,2023,2518,392,1235,1675,0.42439862542955326,0.3435266084193805,0.9751972942502819,0.1828966880869995,0.8171033119130005,0.02480270574971815,0.5080763582966227
0.264,2910,"[[865, 1653], [22, 370]]",865,22,1653,22,887,2023,2518,392,1235,1675,0.42439862542955326,0.3435266084193805,0.9751972942502819,0.1828966880869995,0.8171033119130005,0.02480270574971815,0.5080763582966227
0.265,2910,"[[865, 1653], [22, 370]]",865,22,1653,22,887,2023,2518,392,1235,1675,0.42439862542955326,0.3435266084193805,0.9751972942502819,0.1828966880869995,0.8171033119130005,0.02480270574971815,0.5080763582966227
0.266,2910,"[[865, 1653], [22, 370]]",865,22,1653,22,887,2023,2518,392,1235,1675,0.42439862542955326,0.3435266084193805,0.9751972942502819,0.1828966880869995,0.8171033119130005,0.02480270574971815,0.5080763582966227
0.267,2910,"[[865, 1653], [22, 370]]",865,22,1653,22,887,2023,2518,392,1235,1675,0.42439862542955326,0.3435266084193805,0.9751972942502819,0.1828966880869995,0.8171033119130005,0.02480270574971815,0.5080763582966227
0.268,2910,"[[865, 1652], [22, 371]]",865,22,1652,22,887,2023,2517,393,1236,1674,0.4247422680412371,0.34366309098132697,0.9751972942502819,0.18339100346020762,0.8166089965397924,0.02480270574971815,0.5082256169212691
0.269,2910,"[[865, 1652], [22, 371]]",865,22,1652,22,887,2023,2517,393,1236,1674,0.4247422680412371,0.34366309098132697,0.9751972942502819,0.18339100346020762,0.8166089965397924,0.02480270574971815,0.5082256169212691
0.27,2910,"[[865, 1652], [22, 371]]",865,22,1652,22,887,2023,2517,393,1236,1674,0.4247422680412371,0.34366309098132697,0.9751972942502819,0.18339100346020762,0.8166089965397924,0.02480270574971815,0.5082256169212691
0.271,2910,"[[865, 1652], [22, 371]]",865,22,1652,22,887,2023,2517,393,1236,1674,0.4247422680412371,0.34366309098132697,0.9751972942502819,0.18339100346020762,0.8166089965397924,0.02480270574971815,0.5082256169212691
0.272,2910,"[[865, 1652], [22, 371]]",865,22,1652,22,887,2023,2517,393,1236,1674,0.4247422680412371,0.34366309098132697,0.9751972942502819,0.18339100346020762,0.8166089965397924,0.02480270574971815,0.5082256169212691
0.273,2910,"[[865, 1651], [22, 372]]",865,22,1651,22,887,2023,2516,394,1237,1673,0.42508591065292095,0.34379968203497613,0.9751972942502819,0.18388531883341572,0.8161146811665843,0.02480270574971815,0.5083749632677049
0.274,2910,"[[865, 1651], [22, 372]]",865,22,1651,22,887,2023,2516,394,1237,1673,0.42508591065292095,0.34379968203497613,0.9751972942502819,0.18388531883341572,0.8161146811665843,0.02480270574971815,0.5083749632677049
0.275,2910,"[[865, 1651], [22, 372]]",865,22,1651,22,887,2023,2516,394,1237,1673,0.42508591065292095,0.34379968203497613,0.9751972942502819,0.18388531883341572,0.8161146811665843,0.02480270574971815,0.5083749632677049
0.276,2910,"[[865, 1650], [22, 373]]",865,22,1650,22,887,2023,2515,395,1238,1672,0.4254295532646048,0.34393638170974156,0.9751972942502819,0.18437963420662382,0.8156203657933762,0.02480270574971815,0.5085243974132863
0.277,2910,"[[865, 1648], [22, 375]]",865,22,1648,22,887,2023,2513,397,1240,1670,0.4261168384879725,0.3442101074413052,0.9751972942502819,0.18536826495304004,0.81463173504696,0.02480270574971815,0.5088235294117648
0.278,2910,"[[865, 1648], [22, 375]]",865,22,1648,22,887,2023,2513,397,1240,1670,0.4261168384879725,0.3442101074413052,0.9751972942502819,0.18536826495304004,0.81463173504696,0.02480270574971815,0.5088235294117648
0.279,2910,"[[865, 1648], [22, 375]]",865,22,1648,22,887,2023,2513,397,1240,1670,0.4261168384879725,0.3442101074413052,0.9751972942502819,0.18536826495304004,0.81463173504696,0.02480270574971815,0.5088235294117648
0.28,2910,"[[865, 1648], [22, 375]]",865,22,1648,22,887,2023,2513,397,1240,1670,0.4261168384879725,0.3442101074413052,0.9751972942502819,0.18536826495304004,0.81463173504696,0.02480270574971815,0.5088235294117648
0.281,2910,"[[865, 1648], [22, 375]]",865,22,1648,22,887,2023,2513,397,1240,1670,0.4261168384879725,0.3442101074413052,0.9751972942502819,0.18536826495304004,0.81463173504696,0.02480270574971815,0.5088235294117648
0.282,2910,"[[865, 1648], [22, 375]]",865,22,1648,22,887,2023,2513,397,1240,1670,0.4261168384879725,0.3442101074413052,0.9751972942502819,0.18536826495304004,0.81463173504696,0.02480270574971815,0.5088235294117648
0.283,2910,"[[865, 1648], [22, 375]]",865,22,1648,22,887,2023,2513,397,1240,1670,0.4261168384879725,0.3442101074413052,0.9751972942502819,0.18536826495304004,0.81463173504696,0.02480270574971815,0.5088235294117648
0.284,2910,"[[865, 1648], [22, 375]]",865,22,1648,22,887,2023,2513,397,1240,1670,0.4261168384879725,0.3442101074413052,0.9751972942502819,0.18536826495304004,0.81463173504696,0.02480270574971815,0.5088235294117648
0.285,2910,"[[865, 1648], [22, 375]]",865,22,1648,22,887,2023,2513,397,1240,1670,0.4261168384879725,0.3442101074413052,0.9751972942502819,0.18536826495304004,0.81463173504696,0.02480270574971815,0.5088235294117648
0.286,2910,"[[863, 1648], [24, 375]]",863,24,1648,24,887,2023,2511,399,1238,1672,0.4254295532646048,0.3436877737953007,0.9729425028184893,0.18536826495304004,0.81463173504696,0.02705749718151071,0.5079458505002943
0.287,2910,"[[863, 1648], [24, 375]]",863,24,1648,24,887,2023,2511,399,1238,1672,0.4254295532646048,0.3436877737953007,0.9729425028184893,0.18536826495304004,0.81463173504696,0.02705749718151071,0.5079458505002943
0.288,2910,"[[863, 1648], [24, 375]]",863,24,1648,24,887,2023,2511,399,1238,1672,0.4254295532646048,0.3436877737953007,0.9729425028184893,0.18536826495304004,0.81463173504696,0.02705749718151071,0.5079458505002943
0.289,2910,"[[863, 1648], [24, 375]]",863,24,1648,24,887,2023,2511,399,1238,1672,0.4254295532646048,0.3436877737953007,0.9729425028184893,0.18536826495304004,0.81463173504696,0.02705749718151071,0.5079458505002943
0.29,2910,"[[863, 1646], [24, 377]]",863,24,1646,24,887,2023,2509,401,1240,1670,0.4261168384879725,0.34396173774412114,0.9729425028184893,0.18635689569945627,0.8136431043005438,0.02705749718151071,0.5082449941107186
0.291,2910,"[[863, 1646], [24, 377]]",863,24,1646,24,887,2023,2509,401,1240,1670,0.4261168384879725,0.34396173774412114,0.9729425028184893,0.18635689569945627,0.8136431043005438,0.02705749718151071,0.5082449941107186
0.292,2910,"[[863, 1644], [24, 379]]",863,24,1644,24,887,2023,2507,403,1242,1668,0.4268041237113402,0.3442361388113283,0.9729425028184893,0.18734552644587246,0.8126544735541276,0.02705749718151071,0.5085444902769594
0.293,2910,"[[863, 1644], [24, 379]]",863,24,1644,24,887,2023,2507,403,1242,1668,0.4268041237113402,0.3442361388113283,0.9729425028184893,0.18734552644587246,0.8126544735541276,0.02705749718151071,0.5085444902769594
0.294,2910,"[[863, 1643], [24, 380]]",863,24,1643,24,887,2023,2506,404,1243,1667,0.42714776632302404,0.3443735035913807,0.9729425028184893,0.18783984181908056,0.8121601581809195,0.02705749718151071,0.5086943707633362
0.295,2910,"[[863, 1643], [24, 380]]",863,24,1643,24,887,2023,2506,404,1243,1667,0.42714776632302404,0.3443735035913807,0.9729425028184893,0.18783984181908056,0.8121601581809195,0.02705749718151071,0.5086943707633362
0.296,2910,"[[863, 1643], [24, 380]]",863,24,1643,24,887,2023,2506,404,1243,1667,0.42714776632302404,0.3443735035913807,0.9729425028184893,0.18783984181908056,0.8121601581809195,0.02705749718151071,0.5086943707633362
0.297,2910,"[[863, 1643], [24, 380]]",863,24,1643,24,887,2023,2506,404,1243,1667,0.42714776632302404,0.3443735035913807,0.9729425028184893,0.18783984181908056,0.8121601581809195,0.02705749718151071,0.5086943707633362
0.298,2910,"[[863, 1643], [24, 380]]",863,24,1643,24,887,2023,2506,404,1243,1667,0.42714776632302404,0.3443735035913807,0.9729425028184893,0.18783984181908056,0.8121601581809195,0.02705749718151071,0.5086943707633362
0.299,2910,"[[863, 1643], [24, 380]]",863,24,1643,24,887,2023,2506,404,1243,1667,0.42714776632302404,0.3443735035913807,0.9729425028184893,0.18783984181908056,0.8121601581809195,0.02705749718151071,0.5086943707633362
0.3,2910,"[[863, 1642], [24, 381]]",863,24,1642,24,887,2023,2505,405,1244,1666,0.4274914089347079,0.3445109780439122,0.9729425028184893,0.1883341571922887,0.8116658428077114,0.02705749718151071,0.5088443396226415
0.301,2910,"[[863, 1642], [24, 381]]",863,24,1642,24,887,2023,2505,405,1244,1666,0.4274914089347079,0.3445109780439122,0.9729425028184893,0.1883341571922887,0.8116658428077114,0.02705749718151071,0.5088443396226415
0.302,2910,"[[863, 1642], [24, 381]]",863,24,1642,24,887,2023,2505,405,1244,1666,0.4274914089347079,0.3445109780439122,0.9729425028184893,0.1883341571922887,0.8116658428077114,0.02705749718151071,0.5088443396226415
0.303,2910,"[[863, 1642], [24, 381]]",863,24,1642,24,887,2023,2505,405,1244,1666,0.4274914089347079,0.3445109780439122,0.9729425028184893,0.1883341571922887,0.8116658428077114,0.02705749718151071,0.5088443396226415
0.304,2910,"[[863, 1642], [24, 381]]",863,24,1642,24,887,2023,2505,405,1244,1666,0.4274914089347079,0.3445109780439122,0.9729425028184893,0.1883341571922887,0.8116658428077114,0.02705749718151071,0.5088443396226415
0.305,2910,"[[863, 1639], [24, 384]]",863,24,1639,24,887,2023,2502,408,1247,1663,0.4285223367697594,0.34492406075139886,0.9729425028184893,0.189817103311913,0.810182896688087,0.02705749718151071,0.5092947772204189
0.306,2910,"[[863, 1639], [24, 384]]",863,24,1639,24,887,2023,2502,408,1247,1663,0.4285223367697594,0.34492406075139886,0.9729425028184893,0.189817103311913,0.810182896688087,0.02705749718151071,0.5092947772204189
0.307,2910,"[[863, 1639], [24, 384]]",863,24,1639,24,887,2023,2502,408,1247,1663,0.4285223367697594,0.34492406075139886,0.9729425028184893,0.189817103311913,0.810182896688087,0.02705749718151071,0.5092947772204189
0.308,2910,"[[863, 1639], [24, 384]]",863,24,1639,24,887,2023,2502,408,1247,1663,0.4285223367697594,0.34492406075139886,0.9729425028184893,0.189817103311913,0.810182896688087,0.02705749718151071,0.5092947772204189
0.309,2910,"[[863, 1638], [24, 385]]",863,24,1638,24,887,2023,2501,409,1248,1662,0.4288659793814433,0.34506197520991605,0.9729425028184893,0.1903114186851211,0.8096885813148789,0.02705749718151071,0.5094451003541913
0.31,2910,"[[863, 1638], [24, 385]]",863,24,1638,24,887,2023,2501,409,1248,1662,0.4288659793814433,0.34506197520991605,0.9729425028184893,0.1903114186851211,0.8096885813148789,0.02705749718151071,0.5094451003541913
0.311,2910,"[[863, 1637], [24, 386]]",863,24,1637,24,887,2023,2500,410,1249,1661,0.4292096219931271,0.3452,0.9729425028184893,0.1908057340583292,0.8091942659416708,0.02705749718151071,0.509595512252731
0.312,2910,"[[863, 1637], [24, 386]]",863,24,1637,24,887,2023,2500,410,1249,1661,0.4292096219931271,0.3452,0.9729425028184893,0.1908057340583292,0.8091942659416708,0.02705749718151071,0.509595512252731
0.313,2910,"[[863, 1637], [24, 386]]",863,24,1637,24,887,2023,2500,410,1249,1661,0.4292096219931271,0.3452,0.9729425028184893,0.1908057340583292,0.8091942659416708,0.02705749718151071,0.509595512252731
0.314,2910,"[[863, 1637], [24, 386]]",863,24,1637,24,887,2023,2500,410,1249,1661,0.4292096219931271,0.3452,0.9729425028184893,0.1908057340583292,0.8091942659416708,0.02705749718151071,0.509595512252731
0.315,2910,"[[863, 1637], [24, 386]]",863,24,1637,24,887,2023,2500,410,1249,1661,0.4292096219931271,0.3452,0.9729425028184893,0.1908057340583292,0.8091942659416708,0.02705749718151071,0.509595512252731
0.316,2910,"[[863, 1636], [24, 387]]",863,24,1636,24,887,2023,2499,411,1250,1660,0.42955326460481097,0.3453381352541016,0.9729425028184893,0.19130004943153733,0.8086999505684627,0.02705749718151071,0.509746012994684
0.317,2910,"[[862, 1635], [25, 388]]",862,25,1635,25,887,2023,2497,413,1250,1660,0.42955326460481097,0.3452142571085302,0.971815107102593,0.19179436480474543,0.8082056351952546,0.02818489289740699,0.5094562647754136
0.318,2910,"[[862, 1634], [25, 389]]",862,25,1634,25,887,2023,2496,414,1251,1659,0.4298969072164949,0.3453525641025641,0.971815107102593,0.19228868017795353,0.8077113198220465,0.02818489289740699,0.5096068578185042
0.319,2910,"[[861, 1633], [26, 390]]",861,26,1633,26,887,2023,2494,416,1251,1659,0.4298969072164949,0.34522854851643947,0.9706877113866967,0.19278299555116163,0.8072170044488384,0.029312288613303268,0.5093167701863354
0.32,2910,"[[861, 1633], [26, 390]]",861,26,1633,26,887,2023,2494,416,1251,1659,0.4298969072164949,0.34522854851643947,0.9706877113866967,0.19278299555116163,0.8072170044488384,0.029312288613303268,0.5093167701863354
0.321,2910,"[[861, 1632], [26, 391]]",861,26,1632,26,887,2023,2493,417,1252,1658,0.4302405498281787,0.345367027677497,0.9706877113866967,0.19327731092436976,0.8067226890756303,0.029312288613303268,0.5094674556213018
0.322,2910,"[[861, 1632], [26, 391]]",861,26,1632,26,887,2023,2493,417,1252,1658,0.4302405498281787,0.345367027677497,0.9706877113866967,0.19327731092436976,0.8067226890756303,0.029312288613303268,0.5094674556213018
0.323,2910,"[[861, 1632], [26, 391]]",861,26,1632,26,887,2023,2493,417,1252,1658,0.4302405498281787,0.345367027677497,0.9706877113866967,0.19327731092436976,0.8067226890756303,0.029312288613303268,0.5094674556213018
0.324,2910,"[[861, 1632], [26, 391]]",861,26,1632,26,887,2023,2493,417,1252,1658,0.4302405498281787,0.345367027677497,0.9706877113866967,0.19327731092436976,0.8067226890756303,0.029312288613303268,0.5094674556213018
0.325,2910,"[[861, 1632], [26, 391]]",861,26,1632,26,887,2023,2493,417,1252,1658,0.4302405498281787,0.345367027677497,0.9706877113866967,0.19327731092436976,0.8067226890756303,0.029312288613303268,0.5094674556213018
0.326,2910,"[[861, 1632], [26, 391]]",861,26,1632,26,887,2023,2493,417,1252,1658,0.4302405498281787,0.345367027677497,0.9706877113866967,0.19327731092436976,0.8067226890756303,0.029312288613303268,0.5094674556213018
0.327,2910,"[[861, 1632], [26, 391]]",861,26,1632,26,887,2023,2493,417,1252,1658,0.4302405498281787,0.345367027677497,0.9706877113866967,0.19327731092436976,0.8067226890756303,0.029312288613303268,0.5094674556213018
0.328,2910,"[[861, 1632], [26, 391]]",861,26,1632,26,887,2023,2493,417,1252,1658,0.4302405498281787,0.345367027677497,0.9706877113866967,0.19327731092436976,0.8067226890756303,0.029312288613303268,0.5094674556213018
0.329,2910,"[[861, 1632], [26, 391]]",861,26,1632,26,887,2023,2493,417,1252,1658,0.4302405498281787,0.345367027677497,0.9706877113866967,0.19327731092436976,0.8067226890756303,0.029312288613303268,0.5094674556213018
0.33,2910,"[[861, 1632], [26, 391]]",861,26,1632,26,887,2023,2493,417,1252,1658,0.4302405498281787,0.345367027677497,0.9706877113866967,0.19327731092436976,0.8067226890756303,0.029312288613303268,0.5094674556213018
0.331,2910,"[[860, 1632], [27, 391]]",860,27,1632,27,887,2023,2492,418,1251,1659,0.4298969072164949,0.3451043338683788,0.9695603156708005,0.19327731092436976,0.8067226890756303,0.030439684329199548,0.5090263391535956
0.332,2910,"[[860, 1632], [27, 391]]",860,27,1632,27,887,2023,2492,418,1251,1659,0.4298969072164949,0.3451043338683788,0.9695603156708005,0.19327731092436976,0.8067226890756303,0.030439684329199548,0.5090263391535956
0.333,2910,"[[860, 1632], [27, 391]]",860,27,1632,27,887,2023,2492,418,1251,1659,0.4298969072164949,0.3451043338683788,0.9695603156708005,0.19327731092436976,0.8067226890756303,0.030439684329199548,0.5090263391535956
0.334,2910,"[[860, 1632], [27, 391]]",860,27,1632,27,887,2023,2492,418,1251,1659,0.4298969072164949,0.3451043338683788,0.9695603156708005,0.19327731092436976,0.8067226890756303,0.030439684329199548,0.5090263391535956
0.335,2910,"[[860, 1632], [27, 391]]",860,27,1632,27,887,2023,2492,418,1251,1659,0.4298969072164949,0.3451043338683788,0.9695603156708005,0.19327731092436976,0.8067226890756303,0.030439684329199548,0.5090263391535956
0.336,2910,"[[860, 1631], [27, 392]]",860,27,1631,27,887,2023,2491,419,1252,1658,0.4302405498281787,0.34524287434765155,0.9695603156708005,0.19377162629757785,0.8062283737024222,0.030439684329199548,0.5091770278271167
0.337,2910,"[[860, 1629], [27, 394]]",860,27,1629,27,887,2023,2489,421,1254,1656,0.4309278350515464,0.3455202892728003,0.9695603156708005,0.19476025704399408,0.805239742956006,0.030439684329199548,0.509478672985782
0.338,2910,"[[860, 1628], [27, 395]]",860,27,1628,27,887,2023,2488,422,1255,1655,0.43127147766323026,0.34565916398713825,0.9695603156708005,0.19525457241720218,0.8047454275827979,0.030439684329199548,0.5096296296296297
0.339,2910,"[[860, 1628], [27, 395]]",860,27,1628,27,887,2023,2488,422,1255,1655,0.43127147766323026,0.34565916398713825,0.9695603156708005,0.19525457241720218,0.8047454275827979,0.030439684329199548,0.5096296296296297
0.34,2910,"[[860, 1627], [27, 396]]",860,27,1627,27,887,2023,2487,423,1256,1654,0.4316151202749141,0.3457981503819863,0.9695603156708005,0.19574888779041028,0.8042511122095897,0.030439684329199548,0.5097806757557795
0.341,2910,"[[860, 1627], [27, 396]]",860,27,1627,27,887,2023,2487,423,1256,1654,0.4316151202749141,0.3457981503819863,0.9695603156708005,0.19574888779041028,0.8042511122095897,0.030439684329199548,0.5097806757557795
0.342,2910,"[[860, 1627], [27, 396]]",860,27,1627,27,887,2023,2487,423,1256,1654,0.4316151202749141,0.3457981503819863,0.9695603156708005,0.19574888779041028,0.8042511122095897,0.030439684329199548,0.5097806757557795
0.343,2910,"[[860, 1627], [27, 396]]",860,27,1627,27,887,2023,2487,423,1256,1654,0.4316151202749141,0.3457981503819863,0.9695603156708005,0.19574888779041028,0.8042511122095897,0.030439684329199548,0.5097806757557795
0.344,2910,"[[860, 1627], [27, 396]]",860,27,1627,27,887,2023,2487,423,1256,1654,0.4316151202749141,0.3457981503819863,0.9695603156708005,0.19574888779041028,0.8042511122095897,0.030439684329199548,0.5097806757557795
0.345,2910,"[[860, 1627], [27, 396]]",860,27,1627,27,887,2023,2487,423,1256,1654,0.4316151202749141,0.3457981503819863,0.9695603156708005,0.19574888779041028,0.8042511122095897,0.030439684329199548,0.5097806757557795
0.346,2910,"[[860, 1627], [27, 396]]",860,27,1627,27,887,2023,2487,423,1256,1654,0.4316151202749141,0.3457981503819863,0.9695603156708005,0.19574888779041028,0.8042511122095897,0.030439684329199548,0.5097806757557795
0.347,2910,"[[860, 1627], [27, 396]]",860,27,1627,27,887,2023,2487,423,1256,1654,0.4316151202749141,0.3457981503819863,0.9695603156708005,0.19574888779041028,0.8042511122095897,0.030439684329199548,0.5097806757557795
0.348,2910,"[[860, 1627], [27, 396]]",860,27,1627,27,887,2023,2487,423,1256,1654,0.4316151202749141,0.3457981503819863,0.9695603156708005,0.19574888779041028,0.8042511122095897,0.030439684329199548,0.5097806757557795
0.349,2910,"[[860, 1627], [27, 396]]",860,27,1627,27,887,2023,2487,423,1256,1654,0.4316151202749141,0.3457981503819863,0.9695603156708005,0.19574888779041028,0.8042511122095897,0.030439684329199548,0.5097806757557795
0.35,2910,"[[860, 1627], [27, 396]]",860,27,1627,27,887,2023,2487,423,1256,1654,0.4316151202749141,0.3457981503819863,0.9695603156708005,0.19574888779041028,0.8042511122095897,0.030439684329199548,0.5097806757557795
0.351,2910,"[[860, 1627], [27, 396]]",860,27,1627,27,887,2023,2487,423,1256,1654,0.4316151202749141,0.3457981503819863,0.9695603156708005,0.19574888779041028,0.8042511122095897,0.030439684329199548,0.5097806757557795
0.352,2910,"[[860, 1627], [27, 396]]",860,27,1627,27,887,2023,2487,423,1256,1654,0.4316151202749141,0.3457981503819863,0.9695603156708005,0.19574888779041028,0.8042511122095897,0.030439684329199548,0.5097806757557795
0.353,2910,"[[860, 1627], [27, 396]]",860,27,1627,27,887,2023,2487,423,1256,1654,0.4316151202749141,0.3457981503819863,0.9695603156708005,0.19574888779041028,0.8042511122095897,0.030439684329199548,0.5097806757557795
0.354,2910,"[[860, 1626], [27, 397]]",860,27,1626,27,887,2023,2486,424,1257,1653,0.43195876288659796,0.34593724859211583,0.9695603156708005,0.1962432031636184,0.8037567968363816,0.030439684329199548,0.5099318114438186
0.355,2910,"[[860, 1625], [27, 398]]",860,27,1625,27,887,2023,2485,425,1258,1652,0.4323024054982818,0.3460764587525151,0.9695603156708005,0.1967375185368265,0.8032624814631735,0.030439684329199548,0.5100830367734283
0.356,2910,"[[860, 1624], [27, 399]]",860,27,1624,27,887,2023,2484,426,1259,1651,0.43264604810996565,0.3462157809983897,0.9695603156708005,0.1972318339100346,0.8027681660899654,0.030439684329199548,0.5102343518243845
0.357,2910,"[[860, 1624], [27, 399]]",860,27,1624,27,887,2023,2484,426,1259,1651,0.43264604810996565,0.3462157809983897,0.9695603156708005,0.1972318339100346,0.8027681660899654,0.030439684329199548,0.5102343518243845
0.358,2910,"[[860, 1623], [27, 400]]",860,27,1623,27,887,2023,2483,427,1260,1650,0.4329896907216495,0.3463552154651631,0.9695603156708005,0.1977261492832427,0.8022738507167573,0.030439684329199548,0.510385756676558
0.359,2910,"[[860, 1623], [27, 400]]",860,27,1623,27,887,2023,2483,427,1260,1650,0.4329896907216495,0.3463552154651631,0.9695603156708005,0.1977261492832427,0.8022738507167573,0.030439684329199548,0.510385756676558
0.36,2910,"[[860, 1623], [27, 400]]",860,27,1623,27,887,2023,2483,427,1260,1650,0.4329896907216495,0.3463552154651631,0.9695603156708005,0.1977261492832427,0.8022738507167573,0.030439684329199548,0.510385756676558
0.361,2910,"[[860, 1623], [27, 400]]",860,27,1623,27,887,2023,2483,427,1260,1650,0.4329896907216495,0.3463552154651631,0.9695603156708005,0.1977261492832427,0.8022738507167573,0.030439684329199548,0.510385756676558
0.362,2910,"[[860, 1623], [27, 400]]",860,27,1623,27,887,2023,2483,427,1260,1650,0.4329896907216495,0.3463552154651631,0.9695603156708005,0.1977261492832427,0.8022738507167573,0.030439684329199548,0.510385756676558
0.363,2910,"[[860, 1623], [27, 400]]",860,27,1623,27,887,2023,2483,427,1260,1650,0.4329896907216495,0.3463552154651631,0.9695603156708005,0.1977261492832427,0.8022738507167573,0.030439684329199548,0.510385756676558
0.364,2910,"[[860, 1623], [27, 400]]",860,27,1623,27,887,2023,2483,427,1260,1650,0.4329896907216495,0.3463552154651631,0.9695603156708005,0.1977261492832427,0.8022738507167573,0.030439684329199548,0.510385756676558
0.365,2910,"[[859, 1622], [28, 401]]",859,28,1622,28,887,2023,2481,429,1260,1650,0.4329896907216495,0.34623135832325674,0.9684329199549042,0.19822046465645082,0.8017795353435492,0.03156708004509583,0.5100950118764845
0.366,2910,"[[859, 1622], [28, 401]]",859,28,1622,28,887,2023,2481,429,1260,1650,0.4329896907216495,0.34623135832325674,0.9684329199549042,0.19822046465645082,0.8017795353435492,0.03156708004509583,0.5100950118764845
0.367,2910,"[[859, 1622], [28, 401]]",859,28,1622,28,887,2023,2481,429,1260,1650,0.4329896907216495,0.34623135832325674,0.9684329199549042,0.19822046465645082,0.8017795353435492,0.03156708004509583,0.5100950118764845
0.368,2910,"[[859, 1622], [28, 401]]",859,28,1622,28,887,2023,2481,429,1260,1650,0.4329896907216495,0.34623135832325674,0.9684329199549042,0.19822046465645082,0.8017795353435492,0.03156708004509583,0.5100950118764845
0.369,2910,"[[859, 1622], [28, 401]]",859,28,1622,28,887,2023,2481,429,1260,1650,0.4329896907216495,0.34623135832325674,0.9684329199549042,0.19822046465645082,0.8017795353435492,0.03156708004509583,0.5100950118764845
0.37,2910,"[[859, 1622], [28, 401]]",859,28,1622,28,887,2023,2481,429,1260,1650,0.4329896907216495,0.34623135832325674,0.9684329199549042,0.19822046465645082,0.8017795353435492,0.03156708004509583,0.5100950118764845
0.371,2910,"[[859, 1622], [28, 401]]",859,28,1622,28,887,2023,2481,429,1260,1650,0.4329896907216495,0.34623135832325674,0.9684329199549042,0.19822046465645082,0.8017795353435492,0.03156708004509583,0.5100950118764845
0.372,2910,"[[859, 1621], [28, 402]]",859,28,1621,28,887,2023,2480,430,1261,1649,0.43333333333333335,0.3463709677419355,0.9684329199549042,0.19871478002965892,0.8012852199703411,0.03156708004509583,0.5102465102465102
0.373,2910,"[[859, 1621], [28, 402]]",859,28,1621,28,887,2023,2480,430,1261,1649,0.43333333333333335,0.3463709677419355,0.9684329199549042,0.19871478002965892,0.8012852199703411,0.03156708004509583,0.5102465102465102
0.374,2910,"[[859, 1621], [28, 402]]",859,28,1621,28,887,2023,2480,430,1261,1649,0.43333333333333335,0.3463709677419355,0.9684329199549042,0.19871478002965892,0.8012852199703411,0.03156708004509583,0.5102465102465102
0.375,2910,"[[859, 1621], [28, 402]]",859,28,1621,28,887,2023,2480,430,1261,1649,0.43333333333333335,0.3463709677419355,0.9684329199549042,0.19871478002965892,0.8012852199703411,0.03156708004509583,0.5102465102465102
0.376,2910,"[[858, 1621], [29, 402]]",858,29,1621,29,887,2023,2479,431,1260,1650,0.4329896907216495,0.34610730133118195,0.9673055242390078,0.19871478002965892,0.8012852199703411,0.03269447576099211,0.5098039215686274
0.377,2910,"[[858, 1620], [29, 403]]",858,29,1620,29,887,2023,2478,432,1261,1649,0.43333333333333335,0.34624697336561744,0.9673055242390078,0.19920909540286702,0.800790904597133,0.03269447576099211,0.5099554234769688
0.378,2910,"[[858, 1620], [29, 403]]",858,29,1620,29,887,2023,2478,432,1261,1649,0.43333333333333335,0.34624697336561744,0.9673055242390078,0.19920909540286702,0.800790904597133,0.03269447576099211,0.5099554234769688
0.379,2910,"[[858, 1620], [29, 403]]",858,29,1620,29,887,2023,2478,432,1261,1649,0.43333333333333335,0.34624697336561744,0.9673055242390078,0.19920909540286702,0.800790904597133,0.03269447576099211,0.5099554234769688
0.38,2910,"[[858, 1620], [29, 403]]",858,29,1620,29,887,2023,2478,432,1261,1649,0.43333333333333335,0.34624697336561744,0.9673055242390078,0.19920909540286702,0.800790904597133,0.03269447576099211,0.5099554234769688
0.381,2910,"[[858, 1620], [29, 403]]",858,29,1620,29,887,2023,2478,432,1261,1649,0.43333333333333335,0.34624697336561744,0.9673055242390078,0.19920909540286702,0.800790904597133,0.03269447576099211,0.5099554234769688
0.382,2910,"[[858, 1620], [29, 403]]",858,29,1620,29,887,2023,2478,432,1261,1649,0.43333333333333335,0.34624697336561744,0.9673055242390078,0.19920909540286702,0.800790904597133,0.03269447576099211,0.5099554234769688
0.383,2910,"[[858, 1619], [29, 404]]",858,29,1619,29,887,2023,2477,433,1262,1648,0.4336769759450172,0.346386758175212,0.9673055242390078,0.19970341077607515,0.8002965892239249,0.03269447576099211,0.5101070154577884
0.384,2910,"[[858, 1617], [29, 406]]",858,29,1617,29,887,2023,2475,435,1264,1646,0.4343642611683849,0.3466666666666667,0.9673055242390078,0.20069204152249134,0.7993079584775087,0.03269447576099211,0.5104104699583581
0.385,2910,"[[857, 1616], [30, 407]]",857,30,1616,30,887,2023,2473,437,1264,1646,0.4343642611683849,0.34654266073594825,0.9661781285231116,0.20118635689569947,0.7988136431043006,0.033821871476888386,0.5101190476190476
0.386,2910,"[[857, 1614], [30, 409]]",857,30,1614,30,887,2023,2471,439,1266,1644,0.4350515463917526,0.3468231485228652,0.9661781285231116,0.20217498764211567,0.7978250123578843,0.033821871476888386,0.5104228707564026
0.387,2910,"[[856, 1614], [31, 409]]",856,31,1614,31,887,2023,2470,440,1265,1645,0.43470790378006874,0.3465587044534413,0.9650507328072153,0.20217498764211567,0.7978250123578843,0.03494926719278467,0.5099791480488531
0.388,2910,"[[856, 1614], [31, 409]]",856,31,1614,31,887,2023,2470,440,1265,1645,0.43470790378006874,0.3465587044534413,0.9650507328072153,0.20217498764211567,0.7978250123578843,0.03494926719278467,0.5099791480488531
0.389,2910,"[[856, 1614], [31, 409]]",856,31,1614,31,887,2023,2470,440,1265,1645,0.43470790378006874,0.3465587044534413,0.9650507328072153,0.20217498764211567,0.7978250123578843,0.03494926719278467,0.5099791480488531
0.39,2910,"[[856, 1613], [31, 410]]",856,31,1613,31,887,2023,2469,441,1266,1644,0.4350515463917526,0.3466990684487647,0.9650507328072153,0.20266930301532377,0.7973306969846762,0.03494926719278467,0.5101311084624554
0.391,2910,"[[856, 1611], [31, 412]]",856,31,1611,31,887,2023,2467,443,1268,1642,0.4357388316151203,0.3469801378192136,0.9650507328072153,0.20365793376174,0.79634206623826,0.03494926719278467,0.5104353011329755
0.392,2910,"[[856, 1611], [31, 412]]",856,31,1611,31,887,2023,2467,443,1268,1642,0.4357388316151203,0.3469801378192136,0.9650507328072153,0.20365793376174,0.79634206623826,0.03494926719278467,0.5104353011329755
0.393,2910,"[[856, 1611], [31, 412]]",856,31,1611,31,887,2023,2467,443,1268,1642,0.4357388316151203,0.3469801378192136,0.9650507328072153,0.20365793376174,0.79634206623826,0.03494926719278467,0.5104353011329755
0.394,2910,"[[856, 1611], [31, 412]]",856,31,1611,31,887,2023,2467,443,1268,1642,0.4357388316151203,0.3469801378192136,0.9650507328072153,0.20365793376174,0.79634206623826,0.03494926719278467,0.5104353011329755
0.395,2910,"[[856, 1611], [31, 412]]",856,31,1611,31,887,2023,2467,443,1268,1642,0.4357388316151203,0.3469801378192136,0.9650507328072153,0.20365793376174,0.79634206623826,0.03494926719278467,0.5104353011329755
0.396,2910,"[[856, 1609], [31, 414]]",856,31,1609,31,887,2023,2465,445,1270,1640,0.436426116838488,0.34726166328600405,0.9650507328072153,0.20464656450815621,0.7953534354918438,0.03494926719278467,0.5107398568019093
0.397,2910,"[[856, 1609], [31, 414]]",856,31,1609,31,887,2023,2465,445,1270,1640,0.436426116838488,0.34726166328600405,0.9650507328072153,0.20464656450815621,0.7953534354918438,0.03494926719278467,0.5107398568019093
0.398,2910,"[[856, 1609], [31, 414]]",856,31,1609,31,887,2023,2465,445,1270,1640,0.436426116838488,0.34726166328600405,0.9650507328072153,0.20464656450815621,0.7953534354918438,0.03494926719278467,0.5107398568019093
0.399,2910,"[[856, 1607], [31, 416]]",856,31,1607,31,887,2023,2463,447,1272,1638,0.43711340206185567,0.34754364596021114,0.9650507328072153,0.2056351952545724,0.7943648047454276,0.03494926719278467,0.5110447761194029
0.4,2910,"[[856, 1607], [31, 416]]",856,31,1607,31,887,2023,2463,447,1272,1638,0.43711340206185567,0.34754364596021114,0.9650507328072153,0.2056351952545724,0.7943648047454276,0.03494926719278467,0.5110447761194029
0.401,2910,"[[856, 1607], [31, 416]]",856,31,1607,31,887,2023,2463,447,1272,1638,0.43711340206185567,0.34754364596021114,0.9650507328072153,0.2056351952545724,0.7943648047454276,0.03494926719278467,0.5110447761194029
0.402,2910,"[[856, 1606], [31, 417]]",856,31,1606,31,887,2023,2462,448,1273,1637,0.4374570446735395,0.3476848090982941,0.9650507328072153,0.20612951062778054,0.7938704893722195,0.03494926719278467,0.5111973723499552
0.403,2910,"[[856, 1606], [31, 417]]",856,31,1606,31,887,2023,2462,448,1273,1637,0.4374570446735395,0.3476848090982941,0.9650507328072153,0.20612951062778054,0.7938704893722195,0.03494926719278467,0.5111973723499552
0.404,2910,"[[856, 1606], [31, 417]]",856,31,1606,31,887,2023,2462,448,1273,1637,0.4374570446735395,0.3476848090982941,0.9650507328072153,0.20612951062778054,0.7938704893722195,0.03494926719278467,0.5111973723499552
0.405,2910,"[[856, 1606], [31, 417]]",856,31,1606,31,887,2023,2462,448,1273,1637,0.4374570446735395,0.3476848090982941,0.9650507328072153,0.20612951062778054,0.7938704893722195,0.03494926719278467,0.5111973723499552
0.406,2910,"[[856, 1605], [31, 418]]",856,31,1605,31,887,2023,2461,449,1274,1636,0.43780068728522337,0.34782608695652173,0.9650507328072153,0.20662382600098864,0.7933761739990114,0.03494926719278467,0.5113500597371565
0.407,2910,"[[856, 1605], [31, 418]]",856,31,1605,31,887,2023,2461,449,1274,1636,0.43780068728522337,0.34782608695652173,0.9650507328072153,0.20662382600098864,0.7933761739990114,0.03494926719278467,0.5113500597371565
0.408,2910,"[[856, 1605], [31, 418]]",856,31,1605,31,887,2023,2461,449,1274,1636,0.43780068728522337,0.34782608695652173,0.9650507328072153,0.20662382600098864,0.7933761739990114,0.03494926719278467,0.5113500597371565
0.409,2910,"[[856, 1605], [31, 418]]",856,31,1605,31,887,2023,2461,449,1274,1636,0.43780068728522337,0.34782608695652173,0.9650507328072153,0.20662382600098864,0.7933761739990114,0.03494926719278467,0.5113500597371565
0.41,2910,"[[856, 1605], [31, 418]]",856,31,1605,31,887,2023,2461,449,1274,1636,0.43780068728522337,0.34782608695652173,0.9650507328072153,0.20662382600098864,0.7933761739990114,0.03494926719278467,0.5113500597371565
0.411,2910,"[[856, 1604], [31, 419]]",856,31,1604,31,887,2023,2460,450,1275,1635,0.4381443298969072,0.34796747967479674,0.9650507328072153,0.20711814137419673,0.7928818586258033,0.03494926719278467,0.5115028383627129
0.412,2910,"[[856, 1603], [31, 420]]",856,31,1603,31,887,2023,2459,451,1276,1634,0.43848797250859106,0.3481089873932493,0.9650507328072153,0.20761245674740483,0.7923875432525952,0.03494926719278467,0.511655708308428
0.413,2910,"[[855, 1602], [32, 421]]",855,32,1602,32,887,2023,2457,453,1276,1634,0.43848797250859106,0.34798534798534797,0.963923337091319,0.20810677212061296,0.7918932278793871,0.036076662908680945,0.5113636363636364
0.414,2910,"[[855, 1602], [32, 421]]",855,32,1602,32,887,2023,2457,453,1276,1634,0.43848797250859106,0.34798534798534797,0.963923337091319,0.20810677212061296,0.7918932278793871,0.036076662908680945,0.5113636363636364
0.415,2910,"[[855, 1602], [32, 421]]",855,32,1602,32,887,2023,2457,453,1276,1634,0.43848797250859106,0.34798534798534797,0.963923337091319,0.20810677212061296,0.7918932278793871,0.036076662908680945,0.5113636363636364
0.416,2910,"[[855, 1602], [32, 421]]",855,32,1602,32,887,2023,2457,453,1276,1634,0.43848797250859106,0.34798534798534797,0.963923337091319,0.20810677212061296,0.7918932278793871,0.036076662908680945,0.5113636363636364
0.417,2910,"[[855, 1602], [32, 421]]",855,32,1602,32,887,2023,2457,453,1276,1634,0.43848797250859106,0.34798534798534797,0.963923337091319,0.20810677212061296,0.7918932278793871,0.036076662908680945,0.5113636363636364
0.418,2910,"[[855, 1601], [32, 422]]",855,32,1601,32,887,2023,2456,454,1277,1633,0.4388316151202749,0.3481270358306189,0.963923337091319,0.20860108749382106,0.791398912506179,0.036076662908680945,0.5115166018546216
0.419,2910,"[[855, 1601], [32, 422]]",855,32,1601,32,887,2023,2456,454,1277,1633,0.4388316151202749,0.3481270358306189,0.963923337091319,0.20860108749382106,0.791398912506179,0.036076662908680945,0.5115166018546216
0.42,2910,"[[855, 1601], [32, 422]]",855,32,1601,32,887,2023,2456,454,1277,1633,0.4388316151202749,0.3481270358306189,0.963923337091319,0.20860108749382106,0.791398912506179,0.036076662908680945,0.5115166018546216
0.421,2910,"[[855, 1601], [32, 422]]",855,32,1601,32,887,2023,2456,454,1277,1633,0.4388316151202749,0.3481270358306189,0.963923337091319,0.20860108749382106,0.791398912506179,0.036076662908680945,0.5115166018546216
0.422,2910,"[[855, 1601], [32, 422]]",855,32,1601,32,887,2023,2456,454,1277,1633,0.4388316151202749,0.3481270358306189,0.963923337091319,0.20860108749382106,0.791398912506179,0.036076662908680945,0.5115166018546216
0.423,2910,"[[855, 1600], [32, 423]]",855,32,1600,32,887,2023,2455,455,1278,1632,0.43917525773195876,0.34826883910386963,0.963923337091319,0.20909540286702916,0.7909045971329708,0.036076662908680945,0.5116696588868941
0.424,2910,"[[855, 1600], [32, 423]]",855,32,1600,32,887,2023,2455,455,1278,1632,0.43917525773195876,0.34826883910386963,0.963923337091319,0.20909540286702916,0.7909045971329708,0.036076662908680945,0.5116696588868941
0.425,2910,"[[855, 1599], [32, 424]]",855,32,1599,32,887,2023,2454,456,1279,1631,0.4395189003436426,0.3484107579462103,0.963923337091319,0.20958971824023728,0.7904102817597627,0.036076662908680945,0.511822807542652
0.426,2910,"[[855, 1599], [32, 424]]",855,32,1599,32,887,2023,2454,456,1279,1631,0.4395189003436426,0.3484107579462103,0.963923337091319,0.20958971824023728,0.7904102817597627,0.036076662908680945,0.511822807542652
0.427,2910,"[[855, 1598], [32, 425]]",855,32,1598,32,887,2023,2453,457,1280,1630,0.43986254295532645,0.34855279249898086,0.963923337091319,0.21008403361344538,0.7899159663865546,0.036076662908680945,0.5119760479041916
0.428,2910,"[[855, 1598], [32, 425]]",855,32,1598,32,887,2023,2453,457,1280,1630,0.43986254295532645,0.34855279249898086,0.963923337091319,0.21008403361344538,0.7899159663865546,0.036076662908680945,0.5119760479041916
0.429,2910,"[[855, 1598], [32, 425]]",855,32,1598,32,887,2023,2453,457,1280,1630,0.43986254295532645,0.34855279249898086,0.963923337091319,0.21008403361344538,0.7899159663865546,0.036076662908680945,0.5119760479041916
0.43,2910,"[[855, 1598], [32, 425]]",855,32,1598,32,887,2023,2453,457,1280,1630,0.43986254295532645,0.34855279249898086,0.963923337091319,0.21008403361344538,0.7899159663865546,0.036076662908680945,0.5119760479041916
0.431,2910,"[[855, 1598], [32, 425]]",855,32,1598,32,887,2023,2453,457,1280,1630,0.43986254295532645,0.34855279249898086,0.963923337091319,0.21008403361344538,0.7899159663865546,0.036076662908680945,0.5119760479041916
0.432,2910,"[[855, 1598], [32, 425]]",855,32,1598,32,887,2023,2453,457,1280,1630,0.43986254295532645,0.34855279249898086,0.963923337091319,0.21008403361344538,0.7899159663865546,0.036076662908680945,0.5119760479041916
0.433,2910,"[[855, 1596], [32, 427]]",855,32,1596,32,887,2023,2451,459,1282,1628,0.44054982817869415,0.3488372093023256,0.963923337091319,0.21107266435986158,0.7889273356401384,0.036076662908680945,0.5122828040742959
0.434,2910,"[[855, 1596], [32, 427]]",855,32,1596,32,887,2023,2451,459,1282,1628,0.44054982817869415,0.3488372093023256,0.963923337091319,0.21107266435986158,0.7889273356401384,0.036076662908680945,0.5122828040742959
0.435,2910,"[[855, 1596], [32, 427]]",855,32,1596,32,887,2023,2451,459,1282,1628,0.44054982817869415,0.3488372093023256,0.963923337091319,0.21107266435986158,0.7889273356401384,0.036076662908680945,0.5122828040742959
0.436,2910,"[[855, 1595], [32, 428]]",855,32,1595,32,887,2023,2450,460,1283,1627,0.440893470790378,0.3489795918367347,0.963923337091319,0.2115669797330697,0.7884330202669303,0.036076662908680945,0.5124363200479473
0.437,2910,"[[855, 1594], [32, 429]]",855,32,1594,32,887,2023,2449,461,1284,1626,0.44123711340206184,0.3491220906492446,0.963923337091319,0.2120612951062778,0.7879387048937222,0.036076662908680945,0.5125899280575539
0.438,2910,"[[855, 1594], [32, 429]]",855,32,1594,32,887,2023,2449,461,1284,1626,0.44123711340206184,0.3491220906492446,0.963923337091319,0.2120612951062778,0.7879387048937222,0.036076662908680945,0.5125899280575539
0.439,2910,"[[855, 1594], [32, 429]]",855,32,1594,32,887,2023,2449,461,1284,1626,0.44123711340206184,0.3491220906492446,0.963923337091319,0.2120612951062778,0.7879387048937222,0.036076662908680945,0.5125899280575539
0.44,2910,"[[855, 1593], [32, 430]]",855,32,1593,32,887,2023,2448,462,1285,1625,0.4415807560137457,0.3492647058823529,0.963923337091319,0.2125556104794859,0.7874443895205141,0.036076662908680945,0.512743628185907
0.441,2910,"[[855, 1593], [32, 430]]",855,32,1593,32,887,2023,2448,462,1285,1625,0.4415807560137457,0.3492647058823529,0.963923337091319,0.2125556104794859,0.7874443895205141,0.036076662908680945,0.512743628185907
0.442,2910,"[[855, 1593], [32, 430]]",855,32,1593,32,887,2023,2448,462,1285,1625,0.4415807560137457,0.3492647058823529,0.963923337091319,0.2125556104794859,0.7874443895205141,0.036076662908680945,0.512743628185907
0.443,2910,"[[855, 1593], [32, 430]]",855,32,1593,32,887,2023,2448,462,1285,1625,0.4415807560137457,0.3492647058823529,0.963923337091319,0.2125556104794859,0.7874443895205141,0.036076662908680945,0.512743628185907
0.444,2910,"[[855, 1593], [32, 430]]",855,32,1593,32,887,2023,2448,462,1285,1625,0.4415807560137457,0.3492647058823529,0.963923337091319,0.2125556104794859,0.7874443895205141,0.036076662908680945,0.512743628185907
0.445,2910,"[[855, 1593], [32, 430]]",855,32,1593,32,887,2023,2448,462,1285,1625,0.4415807560137457,0.3492647058823529,0.963923337091319,0.2125556104794859,0.7874443895205141,0.036076662908680945,0.512743628185907
0.446,2910,"[[855, 1591], [32, 432]]",855,32,1591,32,887,2023,2446,464,1287,1623,0.4422680412371134,0.34955028618152084,0.963923337091319,0.21354424122590213,0.7864557587740979,0.036076662908680945,0.513051305130513
0.447,2910,"[[855, 1591], [32, 432]]",855,32,1591,32,887,2023,2446,464,1287,1623,0.4422680412371134,0.34955028618152084,0.963923337091319,0.21354424122590213,0.7864557587740979,0.036076662908680945,0.513051305130513
0.448,2910,"[[855, 1591], [32, 432]]",855,32,1591,32,887,2023,2446,464,1287,1623,0.4422680412371134,0.34955028618152084,0.963923337091319,0.21354424122590213,0.7864557587740979,0.036076662908680945,0.513051305130513
0.449,2910,"[[855, 1591], [32, 432]]",855,32,1591,32,887,2023,2446,464,1287,1623,0.4422680412371134,0.34955028618152084,0.963923337091319,0.21354424122590213,0.7864557587740979,0.036076662908680945,0.513051305130513
0.45,2910,"[[855, 1591], [32, 432]]",855,32,1591,32,887,2023,2446,464,1287,1623,0.4422680412371134,0.34955028618152084,0.963923337091319,0.21354424122590213,0.7864557587740979,0.036076662908680945,0.513051305130513
0.451,2910,"[[855, 1591], [32, 432]]",855,32,1591,32,887,2023,2446,464,1287,1623,0.4422680412371134,0.34955028618152084,0.963923337091319,0.21354424122590213,0.7864557587740979,0.036076662908680945,0.513051305130513
0.452,2910,"[[855, 1590], [32, 433]]",855,32,1590,32,887,2023,2445,465,1288,1622,0.44261168384879723,0.3496932515337423,0.963923337091319,0.21403855659911022,0.7859614434008898,0.036076662908680945,0.5132052821128452
0.453,2910,"[[855, 1590], [32, 433]]",855,32,1590,32,887,2023,2445,465,1288,1622,0.44261168384879723,0.3496932515337423,0.963923337091319,0.21403855659911022,0.7859614434008898,0.036076662908680945,0.5132052821128452
0.454,2910,"[[855, 1590], [32, 433]]",855,32,1590,32,887,2023,2445,465,1288,1622,0.44261168384879723,0.3496932515337423,0.963923337091319,0.21403855659911022,0.7859614434008898,0.036076662908680945,0.5132052821128452
0.455,2910,"[[855, 1590], [32, 433]]",855,32,1590,32,887,2023,2445,465,1288,1622,0.44261168384879723,0.3496932515337423,0.963923337091319,0.21403855659911022,0.7859614434008898,0.036076662908680945,0.5132052821128452
0.456,2910,"[[855, 1589], [32, 434]]",855,32,1589,32,887,2023,2444,466,1289,1621,0.4429553264604811,0.3498363338788871,0.963923337091319,0.21453287197231835,0.7854671280276817,0.036076662908680945,0.5133593515460823
0.457,2910,"[[855, 1589], [32, 434]]",855,32,1589,32,887,2023,2444,466,1289,1621,0.4429553264604811,0.3498363338788871,0.963923337091319,0.21453287197231835,0.7854671280276817,0.036076662908680945,0.5133593515460823
0.458,2910,"[[855, 1589], [32, 434]]",855,32,1589,32,887,2023,2444,466,1289,1621,0.4429553264604811,0.3498363338788871,0.963923337091319,0.21453287197231835,0.7854671280276817,0.036076662908680945,0.5133593515460823
0.459,2910,"[[855, 1589], [32, 434]]",855,32,1589,32,887,2023,2444,466,1289,1621,0.4429553264604811,0.3498363338788871,0.963923337091319,0.21453287197231835,0.7854671280276817,0.036076662908680945,0.5133593515460823
0.46,2910,"[[855, 1589], [32, 434]]",855,32,1589,32,887,2023,2444,466,1289,1621,0.4429553264604811,0.3498363338788871,0.963923337091319,0.21453287197231835,0.7854671280276817,0.036076662908680945,0.5133593515460823
0.461,2910,"[[855, 1588], [32, 435]]",855,32,1588,32,887,2023,2443,467,1290,1620,0.44329896907216493,0.3499795333606222,0.963923337091319,0.21502718734552645,0.7849728126544736,0.036076662908680945,0.5135135135135135
0.462,2910,"[[855, 1588], [32, 435]]",855,32,1588,32,887,2023,2443,467,1290,1620,0.44329896907216493,0.3499795333606222,0.963923337091319,0.21502718734552645,0.7849728126544736,0.036076662908680945,0.5135135135135135
0.463,2910,"[[855, 1587], [32, 436]]",855,32,1587,32,887,2023,2442,468,1291,1619,0.4436426116838488,0.3501228501228501,0.963923337091319,0.21552150271873455,0.7844784972812654,0.036076662908680945,0.5136677680985281
0.464,2910,"[[855, 1587], [32, 436]]",855,32,1587,32,887,2023,2442,468,1291,1619,0.4436426116838488,0.3501228501228501,0.963923337091319,0.21552150271873455,0.7844784972812654,0.036076662908680945,0.5136677680985281
0.465,2910,"[[855, 1587], [32, 436]]",855,32,1587,32,887,2023,2442,468,1291,1619,0.4436426116838488,0.3501228501228501,0.963923337091319,0.21552150271873455,0.7844784972812654,0.036076662908680945,0.5136677680985281
0.466,2910,"[[855, 1586], [32, 437]]",855,32,1586,32,887,2023,2441,469,1292,1618,0.4439862542955326,0.35026628430970913,0.963923337091319,0.21601581809194265,0.7839841819080573,0.036076662908680945,0.5138221153846154
0.467,2910,"[[855, 1586], [32, 437]]",855,32,1586,32,887,2023,2441,469,1292,1618,0.4439862542955326,0.35026628430970913,0.963923337091319,0.21601581809194265,0.7839841819080573,0.036076662908680945,0.5138221153846154
0.468,2910,"[[855, 1586], [32, 437]]",855,32,1586,32,887,2023,2441,469,1292,1618,0.4439862542955326,0.35026628430970913,0.963923337091319,0.21601581809194265,0.7839841819080573,0.036076662908680945,0.5138221153846154
0.469,2910,"[[855, 1586], [32, 437]]",855,32,1586,32,887,2023,2441,469,1292,1618,0.4439862542955326,0.35026628430970913,0.963923337091319,0.21601581809194265,0.7839841819080573,0.036076662908680945,0.5138221153846154
0.47,2910,"[[855, 1585], [32, 438]]",855,32,1585,32,887,2023,2440,470,1293,1617,0.44432989690721647,0.35040983606557374,0.963923337091319,0.21651013346515077,0.7834898665348492,0.036076662908680945,0.5139765554553651
0.471,2910,"[[855, 1584], [32, 439]]",855,32,1584,32,887,2023,2439,471,1294,1616,0.4446735395189003,0.3505535055350554,0.963923337091319,0.21700444883835887,0.7829955511616411,0.036076662908680945,0.5141310883944679
0.472,2910,"[[855, 1584], [32, 439]]",855,32,1584,32,887,2023,2439,471,1294,1616,0.4446735395189003,0.3505535055350554,0.963923337091319,0.21700444883835887,0.7829955511616411,0.036076662908680945,0.5141310883944679
0.473,2910,"[[855, 1584], [32, 439]]",855,32,1584,32,887,2023,2439,471,1294,1616,0.4446735395189003,0.3505535055350554,0.963923337091319,0.21700444883835887,0.7829955511616411,0.036076662908680945,0.5141310883944679
0.474,2910,"[[855, 1583], [32, 440]]",855,32,1583,32,887,2023,2438,472,1295,1615,0.44501718213058417,0.35069729286300244,0.963923337091319,0.21749876421156697,0.782501235788433,0.036076662908680945,0.5142857142857143
0.475,2910,"[[855, 1583], [32, 440]]",855,32,1583,32,887,2023,2438,472,1295,1615,0.44501718213058417,0.35069729286300244,0.963923337091319,0.21749876421156697,0.782501235788433,0.036076662908680945,0.5142857142857143
0.476,2910,"[[855, 1583], [32, 440]]",855,32,1583,32,887,2023,2438,472,1295,1615,0.44501718213058417,0.35069729286300244,0.963923337091319,0.21749876421156697,0.782501235788433,0.036076662908680945,0.5142857142857143
0.477,2910,"[[855, 1583], [32, 440]]",855,32,1583,32,887,2023,2438,472,1295,1615,0.44501718213058417,0.35069729286300244,0.963923337091319,0.21749876421156697,0.782501235788433,0.036076662908680945,0.5142857142857143
0.478,2910,"[[855, 1583], [32, 440]]",855,32,1583,32,887,2023,2438,472,1295,1615,0.44501718213058417,0.35069729286300244,0.963923337091319,0.21749876421156697,0.782501235788433,0.036076662908680945,0.5142857142857143
0.479,2910,"[[854, 1583], [33, 440]]",854,33,1583,33,887,2023,2437,473,1294,1616,0.4446735395189003,0.3504308576118178,0.9627959413754228,0.21749876421156697,0.782501235788433,0.03720405862457723,0.5138387484957883
0.48,2910,"[[854, 1583], [33, 440]]",854,33,1583,33,887,2023,2437,473,1294,1616,0.4446735395189003,0.3504308576118178,0.9627959413754228,0.21749876421156697,0.782501235788433,0.03720405862457723,0.5138387484957883
0.481,2910,"[[854, 1583], [33, 440]]",854,33,1583,33,887,2023,2437,473,1294,1616,0.4446735395189003,0.3504308576118178,0.9627959413754228,0.21749876421156697,0.782501235788433,0.03720405862457723,0.5138387484957883
0.482,2910,"[[854, 1583], [33, 440]]",854,33,1583,33,887,2023,2437,473,1294,1616,0.4446735395189003,0.3504308576118178,0.9627959413754228,0.21749876421156697,0.782501235788433,0.03720405862457723,0.5138387484957883
0.483,2910,"[[854, 1583], [33, 440]]",854,33,1583,33,887,2023,2437,473,1294,1616,0.4446735395189003,0.3504308576118178,0.9627959413754228,0.21749876421156697,0.782501235788433,0.03720405862457723,0.5138387484957883
0.484,2910,"[[854, 1582], [33, 441]]",854,33,1582,33,887,2023,2436,474,1295,1615,0.44501718213058417,0.3505747126436782,0.9627959413754228,0.2179930795847751,0.7820069204152249,0.03720405862457723,0.5139933794763767
0.485,2910,"[[854, 1582], [33, 441]]",854,33,1582,33,887,2023,2436,474,1295,1615,0.44501718213058417,0.3505747126436782,0.9627959413754228,0.2179930795847751,0.7820069204152249,0.03720405862457723,0.5139933794763767
0.486,2910,"[[854, 1582], [33, 441]]",854,33,1582,33,887,2023,2436,474,1295,1615,0.44501718213058417,0.3505747126436782,0.9627959413754228,0.2179930795847751,0.7820069204152249,0.03720405862457723,0.5139933794763767
0.487,2910,"[[854, 1582], [33, 441]]",854,33,1582,33,887,2023,2436,474,1295,1615,0.44501718213058417,0.3505747126436782,0.9627959413754228,0.2179930795847751,0.7820069204152249,0.03720405862457723,0.5139933794763767
0.488,2910,"[[854, 1582], [33, 441]]",854,33,1582,33,887,2023,2436,474,1295,1615,0.44501718213058417,0.3505747126436782,0.9627959413754228,0.2179930795847751,0.7820069204152249,0.03720405862457723,0.5139933794763767
0.489,2910,"[[854, 1581], [33, 442]]",854,33,1581,33,887,2023,2435,475,1296,1614,0.44536082474226807,0.3507186858316222,0.9627959413754228,0.2184873949579832,0.7815126050420168,0.03720405862457723,0.5141481035520771
0.49,2910,"[[854, 1581], [33, 442]]",854,33,1581,33,887,2023,2435,475,1296,1614,0.44536082474226807,0.3507186858316222,0.9627959413754228,0.2184873949579832,0.7815126050420168,0.03720405862457723,0.5141481035520771
0.491,2910,"[[854, 1581], [33, 442]]",854,33,1581,33,887,2023,2435,475,1296,1614,0.44536082474226807,0.3507186858316222,0.9627959413754228,0.2184873949579832,0.7815126050420168,0.03720405862457723,0.5141481035520771
0.492,2910,"[[854, 1581], [33, 442]]",854,33,1581,33,887,2023,2435,475,1296,1614,0.44536082474226807,0.3507186858316222,0.9627959413754228,0.2184873949579832,0.7815126050420168,0.03720405862457723,0.5141481035520771
0.493,2910,"[[854, 1581], [33, 442]]",854,33,1581,33,887,2023,2435,475,1296,1614,0.44536082474226807,0.3507186858316222,0.9627959413754228,0.2184873949579832,0.7815126050420168,0.03720405862457723,0.5141481035520771
0.494,2910,"[[854, 1581], [33, 442]]",854,33,1581,33,887,2023,2435,475,1296,1614,0.44536082474226807,0.3507186858316222,0.9627959413754228,0.2184873949579832,0.7815126050420168,0.03720405862457723,0.5141481035520771
0.495,2910,"[[854, 1581], [33, 442]]",854,33,1581,33,887,2023,2435,475,1296,1614,0.44536082474226807,0.3507186858316222,0.9627959413754228,0.2184873949579832,0.7815126050420168,0.03720405862457723,0.5141481035520771
0.496,2910,"[[854, 1581], [33, 442]]",854,33,1581,33,887,2023,2435,475,1296,1614,0.44536082474226807,0.3507186858316222,0.9627959413754228,0.2184873949579832,0.7815126050420168,0.03720405862457723,0.5141481035520771
0.497,2910,"[[854, 1581], [33, 442]]",854,33,1581,33,887,2023,2435,475,1296,1614,0.44536082474226807,0.3507186858316222,0.9627959413754228,0.2184873949579832,0.7815126050420168,0.03720405862457723,0.5141481035520771
0.498,2910,"[[854, 1580], [33, 443]]",854,33,1580,33,887,2023,2434,476,1297,1613,0.4457044673539519,0.35086277732128185,0.9627959413754228,0.2189817103311913,0.7810182896688087,0.03720405862457723,0.5143029208069859
0.499,2910,"[[853, 1580], [34, 443]]",853,34,1580,34,887,2023,2433,477,1296,1614,0.44536082474226807,0.3505959720509659,0.9616685456595265,0.2189817103311913,0.7810182896688087,0.038331454340473504,0.5138554216867469
0.5,2910,"[[853, 1579], [34, 444]]",853,34,1579,34,887,2023,2432,478,1297,1613,0.4457044673539519,0.35074013157894735,0.9616685456595265,0.21947602570439942,0.7805239742956006,0.038331454340473504,0.5140102440494125
0.501,2910,"[[853, 1579], [34, 444]]",853,34,1579,34,887,2023,2432,478,1297,1613,0.4457044673539519,0.35074013157894735,0.9616685456595265,0.21947602570439942,0.7805239742956006,0.038331454340473504,0.5140102440494125
0.502,2910,"[[853, 1578], [34, 445]]",853,34,1578,34,887,2023,2431,479,1298,1612,0.44604810996563576,0.3508844097079391,0.9616685456595265,0.21997034107760752,0.7800296589223925,0.038331454340473504,0.5141651597347799
0.503,2910,"[[853, 1577], [34, 446]]",853,34,1577,34,887,2023,2430,480,1299,1611,0.4463917525773196,0.35102880658436214,0.9616685456595265,0.22046465645081562,0.7795353435491844,0.038331454340473504,0.5143201688272535
0.504,2910,"[[852, 1577], [35, 446]]",852,35,1577,35,887,2023,2429,481,1298,1612,0.44604810996563576,0.3507616303005352,0.9605411499436303,0.22046465645081562,0.7795353435491844,0.03945885005636979,0.5138721351025332
0.505,2910,"[[852, 1577], [35, 446]]",852,35,1577,35,887,2023,2429,481,1298,1612,0.44604810996563576,0.3507616303005352,0.9605411499436303,0.22046465645081562,0.7795353435491844,0.03945885005636979,0.5138721351025332
0.506,2910,"[[852, 1577], [35, 446]]",852,35,1577,35,887,2023,2429,481,1298,1612,0.44604810996563576,0.3507616303005352,0.9605411499436303,0.22046465645081562,0.7795353435491844,0.03945885005636979,0.5138721351025332
0.507,2910,"[[852, 1577], [35, 446]]",852,35,1577,35,887,2023,2429,481,1298,1612,0.44604810996563576,0.3507616303005352,0.9605411499436303,0.22046465645081562,0.7795353435491844,0.03945885005636979,0.5138721351025332
0.508,2910,"[[852, 1577], [35, 446]]",852,35,1577,35,887,2023,2429,481,1298,1612,0.44604810996563576,0.3507616303005352,0.9605411499436303,0.22046465645081562,0.7795353435491844,0.03945885005636979,0.5138721351025332
0.509,2910,"[[852, 1577], [35, 446]]",852,35,1577,35,887,2023,2429,481,1298,1612,0.44604810996563576,0.3507616303005352,0.9605411499436303,0.22046465645081562,0.7795353435491844,0.03945885005636979,0.5138721351025332
0.51,2910,"[[852, 1577], [35, 446]]",852,35,1577,35,887,2023,2429,481,1298,1612,0.44604810996563576,0.3507616303005352,0.9605411499436303,0.22046465645081562,0.7795353435491844,0.03945885005636979,0.5138721351025332
0.511,2910,"[[852, 1576], [35, 447]]",852,35,1576,35,887,2023,2428,482,1299,1611,0.4463917525773196,0.35090609555189456,0.9605411499436303,0.22095897182402371,0.7790410281759763,0.03945885005636979,0.5140271493212669
0.512,2910,"[[852, 1576], [35, 447]]",852,35,1576,35,887,2023,2428,482,1299,1611,0.4463917525773196,0.35090609555189456,0.9605411499436303,0.22095897182402371,0.7790410281759763,0.03945885005636979,0.5140271493212669
0.513,2910,"[[852, 1576], [35, 447]]",852,35,1576,35,887,2023,2428,482,1299,1611,0.4463917525773196,0.35090609555189456,0.9605411499436303,0.22095897182402371,0.7790410281759763,0.03945885005636979,0.5140271493212669
0.514,2910,"[[852, 1576], [35, 447]]",852,35,1576,35,887,2023,2428,482,1299,1611,0.4463917525773196,0.35090609555189456,0.9605411499436303,0.22095897182402371,0.7790410281759763,0.03945885005636979,0.5140271493212669
0.515,2910,"[[852, 1576], [35, 447]]",852,35,1576,35,887,2023,2428,482,1299,1611,0.4463917525773196,0.35090609555189456,0.9605411499436303,0.22095897182402371,0.7790410281759763,0.03945885005636979,0.5140271493212669
0.516,2910,"[[852, 1576], [35, 447]]",852,35,1576,35,887,2023,2428,482,1299,1611,0.4463917525773196,0.35090609555189456,0.9605411499436303,0.22095897182402371,0.7790410281759763,0.03945885005636979,0.5140271493212669
0.517,2910,"[[851, 1575], [36, 448]]",851,36,1575,36,887,2023,2426,484,1299,1611,0.4463917525773196,0.35078318219291016,0.9594137542277339,0.22145328719723184,0.7785467128027682,0.040586245772266064,0.5137337760338062
0.518,2910,"[[851, 1574], [36, 449]]",851,36,1574,36,887,2023,2425,485,1300,1610,0.44673539518900346,0.3509278350515464,0.9594137542277339,0.22194760257043994,0.77805239742956,0.040586245772266064,0.513888888888889
0.519,2910,"[[851, 1574], [36, 449]]",851,36,1574,36,887,2023,2425,485,1300,1610,0.44673539518900346,0.3509278350515464,0.9594137542277339,0.22194760257043994,0.77805239742956,0.040586245772266064,0.513888888888889
0.52,2910,"[[851, 1572], [36, 451]]",851,36,1572,36,887,2023,2423,487,1302,1608,0.44742268041237115,0.3512174989682212,0.9594137542277339,0.22293623331685616,0.7770637666831438,0.040586245772266064,0.5141993957703926
0.521,2910,"[[851, 1572], [36, 451]]",851,36,1572,36,887,2023,2423,487,1302,1608,0.44742268041237115,0.3512174989682212,0.9594137542277339,0.22293623331685616,0.7770637666831438,0.040586245772266064,0.5141993957703926
0.522,2910,"[[851, 1572], [36, 451]]",851,36,1572,36,887,2023,2423,487,1302,1608,0.44742268041237115,0.3512174989682212,0.9594137542277339,0.22293623331685616,0.7770637666831438,0.040586245772266064,0.5141993957703926
0.523,2910,"[[851, 1572], [36, 451]]",851,36,1572,36,887,2023,2423,487,1302,1608,0.44742268041237115,0.3512174989682212,0.9594137542277339,0.22293623331685616,0.7770637666831438,0.040586245772266064,0.5141993957703926
0.524,2910,"[[851, 1572], [36, 451]]",851,36,1572,36,887,2023,2423,487,1302,1608,0.44742268041237115,0.3512174989682212,0.9594137542277339,0.22293623331685616,0.7770637666831438,0.040586245772266064,0.5141993957703926
0.525,2910,"[[851, 1572], [36, 451]]",851,36,1572,36,887,2023,2423,487,1302,1608,0.44742268041237115,0.3512174989682212,0.9594137542277339,0.22293623331685616,0.7770637666831438,0.040586245772266064,0.5141993957703926
0.526,2910,"[[851, 1572], [36, 451]]",851,36,1572,36,887,2023,2423,487,1302,1608,0.44742268041237115,0.3512174989682212,0.9594137542277339,0.22293623331685616,0.7770637666831438,0.040586245772266064,0.5141993957703926
0.527,2910,"[[851, 1572], [36, 451]]",851,36,1572,36,887,2023,2423,487,1302,1608,0.44742268041237115,0.3512174989682212,0.9594137542277339,0.22293623331685616,0.7770637666831438,0.040586245772266064,0.5141993957703926
0.528,2910,"[[851, 1572], [36, 451]]",851,36,1572,36,887,2023,2423,487,1302,1608,0.44742268041237115,0.3512174989682212,0.9594137542277339,0.22293623331685616,0.7770637666831438,0.040586245772266064,0.5141993957703926
0.529,2910,"[[851, 1572], [36, 451]]",851,36,1572,36,887,2023,2423,487,1302,1608,0.44742268041237115,0.3512174989682212,0.9594137542277339,0.22293623331685616,0.7770637666831438,0.040586245772266064,0.5141993957703926
0.53,2910,"[[851, 1572], [36, 451]]",851,36,1572,36,887,2023,2423,487,1302,1608,0.44742268041237115,0.3512174989682212,0.9594137542277339,0.22293623331685616,0.7770637666831438,0.040586245772266064,0.5141993957703926
0.531,2910,"[[851, 1572], [36, 451]]",851,36,1572,36,887,2023,2423,487,1302,1608,0.44742268041237115,0.3512174989682212,0.9594137542277339,0.22293623331685616,0.7770637666831438,0.040586245772266064,0.5141993957703926
0.532,2910,"[[851, 1572], [36, 451]]",851,36,1572,36,887,2023,2423,487,1302,1608,0.44742268041237115,0.3512174989682212,0.9594137542277339,0.22293623331685616,0.7770637666831438,0.040586245772266064,0.5141993957703926
0.533,2910,"[[851, 1572], [36, 451]]",851,36,1572,36,887,2023,2423,487,1302,1608,0.44742268041237115,0.3512174989682212,0.9594137542277339,0.22293623331685616,0.7770637666831438,0.040586245772266064,0.5141993957703926
0.534,2910,"[[851, 1572], [36, 451]]",851,36,1572,36,887,2023,2423,487,1302,1608,0.44742268041237115,0.3512174989682212,0.9594137542277339,0.22293623331685616,0.7770637666831438,0.040586245772266064,0.5141993957703926
0.535,2910,"[[851, 1572], [36, 451]]",851,36,1572,36,887,2023,2423,487,1302,1608,0.44742268041237115,0.3512174989682212,0.9594137542277339,0.22293623331685616,0.7770637666831438,0.040586245772266064,0.5141993957703926
0.536,2910,"[[851, 1572], [36, 451]]",851,36,1572,36,887,2023,2423,487,1302,1608,0.44742268041237115,0.3512174989682212,0.9594137542277339,0.22293623331685616,0.7770637666831438,0.040586245772266064,0.5141993957703926
0.537,2910,"[[851, 1571], [36, 452]]",851,36,1571,36,887,2023,2422,488,1303,1607,0.447766323024055,0.3513625103220479,0.9594137542277339,0.22343054869006426,0.7765694513099357,0.040586245772266064,0.5143547899667573
0.538,2910,"[[851, 1571], [36, 452]]",851,36,1571,36,887,2023,2422,488,1303,1607,0.447766323024055,0.3513625103220479,0.9594137542277339,0.22343054869006426,0.7765694513099357,0.040586245772266064,0.5143547899667573
0.539,2910,"[[851, 1571], [36, 452]]",851,36,1571,36,887,2023,2422,488,1303,1607,0.447766323024055,0.3513625103220479,0.9594137542277339,0.22343054869006426,0.7765694513099357,0.040586245772266064,0.5143547899667573
0.54,2910,"[[851, 1571], [36, 452]]",851,36,1571,36,887,2023,2422,488,1303,1607,0.447766323024055,0.3513625103220479,0.9594137542277339,0.22343054869006426,0.7765694513099357,0.040586245772266064,0.5143547899667573
0.541,2910,"[[850, 1571], [37, 452]]",850,37,1571,37,887,2023,2421,489,1302,1608,0.44742268041237115,0.3510945890128046,0.9582863585118376,0.22343054869006426,0.7765694513099357,0.04171364148816235,0.5139056831922612
0.542,2910,"[[850, 1571], [37, 452]]",850,37,1571,37,887,2023,2421,489,1302,1608,0.44742268041237115,0.3510945890128046,0.9582863585118376,0.22343054869006426,0.7765694513099357,0.04171364148816235,0.5139056831922612
0.543,2910,"[[850, 1570], [37, 453]]",850,37,1570,37,887,2023,2420,490,1303,1607,0.447766323024055,0.3512396694214876,0.9582863585118376,0.22392486406327236,0.7760751359367276,0.04171364148816235,0.5140610825521621
0.544,2910,"[[849, 1570], [38, 453]]",849,38,1570,38,887,2023,2419,491,1302,1608,0.44742268041237115,0.3509714758164531,0.9571589627959414,0.22392486406327236,0.7760751359367276,0.04284103720405862,0.5136116152450091
0.545,2910,"[[848, 1570], [39, 453]]",848,39,1570,39,887,2023,2418,492,1301,1609,0.4470790378006873,0.3507030603804797,0.9560315670800451,0.22392486406327236,0.7760751359367276,0.043968432919954906,0.5131618759455371
0.546,2910,"[[848, 1570], [39, 453]]",848,39,1570,39,887,2023,2418,492,1301,1609,0.4470790378006873,0.3507030603804797,0.9560315670800451,0.22392486406327236,0.7760751359367276,0.043968432919954906,0.5131618759455371
0.547,2910,"[[848, 1570], [39, 453]]",848,39,1570,39,887,2023,2418,492,1301,1609,0.4470790378006873,0.3507030603804797,0.9560315670800451,0.22392486406327236,0.7760751359367276,0.043968432919954906,0.5131618759455371
0.548,2910,"[[848, 1570], [39, 453]]",848,39,1570,39,887,2023,2418,492,1301,1609,0.4470790378006873,0.3507030603804797,0.9560315670800451,0.22392486406327236,0.7760751359367276,0.043968432919954906,0.5131618759455371
0.549,2910,"[[848, 1569], [39, 454]]",848,39,1569,39,887,2023,2417,493,1302,1608,0.44742268041237115,0.350848158874638,0.9560315670800451,0.2244191794364805,0.7755808205635195,0.043968432919954906,0.5133171912832929
0.55,2910,"[[848, 1569], [39, 454]]",848,39,1569,39,887,2023,2417,493,1302,1608,0.44742268041237115,0.350848158874638,0.9560315670800451,0.2244191794364805,0.7755808205635195,0.043968432919954906,0.5133171912832929
0.551,2910,"[[848, 1568], [39, 455]]",848,39,1568,39,887,2023,2416,494,1303,1607,0.447766323024055,0.3509933774834437,0.9560315670800451,0.22491349480968859,0.7750865051903114,0.043968432919954906,0.5134726006660612
0.552,2910,"[[848, 1566], [39, 457]]",848,39,1566,39,887,2023,2414,496,1305,1605,0.4484536082474227,0.3512841756420878,0.9560315670800451,0.22590212555610478,0.7740978744438952,0.043968432919954906,0.5137837019085125
0.553,2910,"[[848, 1566], [39, 457]]",848,39,1566,39,887,2023,2414,496,1305,1605,0.4484536082474227,0.3512841756420878,0.9560315670800451,0.22590212555610478,0.7740978744438952,0.043968432919954906,0.5137837019085125
0.554,2910,"[[848, 1566], [39, 457]]",848,39,1566,39,887,2023,2414,496,1305,1605,0.4484536082474227,0.3512841756420878,0.9560315670800451,0.22590212555610478,0.7740978744438952,0.043968432919954906,0.5137837019085125
0.555,2910,"[[848, 1566], [39, 457]]",848,39,1566,39,887,2023,2414,496,1305,1605,0.4484536082474227,0.3512841756420878,0.9560315670800451,0.22590212555610478,0.7740978744438952,0.043968432919954906,0.5137837019085125
0.556,2910,"[[848, 1566], [39, 457]]",848,39,1566,39,887,2023,2414,496,1305,1605,0.4484536082474227,0.3512841756420878,0.9560315670800451,0.22590212555610478,0.7740978744438952,0.043968432919954906,0.5137837019085125
0.557,2910,"[[848, 1565], [39, 458]]",848,39,1565,39,887,2023,2413,497,1306,1604,0.44879725085910654,0.35142975549108996,0.9560315670800451,0.2263964409293129,0.7736035590706871,0.043968432919954906,0.513939393939394
0.558,2910,"[[848, 1565], [39, 458]]",848,39,1565,39,887,2023,2413,497,1306,1604,0.44879725085910654,0.35142975549108996,0.9560315670800451,0.2263964409293129,0.7736035590706871,0.043968432919954906,0.513939393939394
0.559,2910,"[[848, 1565], [39, 458]]",848,39,1565,39,887,2023,2413,497,1306,1604,0.44879725085910654,0.35142975549108996,0.9560315670800451,0.2263964409293129,0.7736035590706871,0.043968432919954906,0.513939393939394
0.56,2910,"[[848, 1565], [39, 458]]",848,39,1565,39,887,2023,2413,497,1306,1604,0.44879725085910654,0.35142975549108996,0.9560315670800451,0.2263964409293129,0.7736035590706871,0.043968432919954906,0.513939393939394
0.561,2910,"[[848, 1564], [39, 459]]",848,39,1564,39,887,2023,2412,498,1307,1603,0.4491408934707904,0.351575456053068,0.9560315670800451,0.226890756302521,0.773109243697479,0.043968432919954906,0.5140951803576841
0.562,2910,"[[848, 1563], [39, 460]]",848,39,1563,39,887,2023,2411,499,1308,1602,0.44948453608247424,0.3517212774782248,0.9560315670800451,0.2273850716757291,0.7726149283242709,0.043968432919954906,0.514251061249242
0.563,2910,"[[848, 1563], [39, 460]]",848,39,1563,39,887,2023,2411,499,1308,1602,0.44948453608247424,0.3517212774782248,0.9560315670800451,0.2273850716757291,0.7726149283242709,0.043968432919954906,0.514251061249242
0.564,2910,"[[848, 1562], [39, 461]]",848,39,1562,39,887,2023,2410,500,1309,1601,0.4498281786941581,0.3518672199170125,0.9560315670800451,0.22787938704893723,0.7721206129510628,0.043968432919954906,0.5144070367000304
0.565,2910,"[[848, 1561], [39, 462]]",848,39,1561,39,887,2023,2409,501,1310,1600,0.45017182130584193,0.35201328352013284,0.9560315670800451,0.22837370242214533,0.7716262975778547,0.043968432919954906,0.5145631067961164
0.566,2910,"[[848, 1561], [39, 462]]",848,39,1561,39,887,2023,2409,501,1310,1600,0.45017182130584193,0.35201328352013284,0.9560315670800451,0.22837370242214533,0.7716262975778547,0.043968432919954906,0.5145631067961164
0.567,2910,"[[848, 1560], [39, 463]]",848,39,1560,39,887,2023,2408,502,1311,1599,0.4505154639175258,0.3521594684385382,0.9560315670800451,0.22886801779535343,0.7711319822046465,0.043968432919954906,0.5147192716236721
0.568,2910,"[[847, 1560], [40, 463]]",847,40,1560,40,887,2023,2407,503,1310,1600,0.45017182130584193,0.3518903199002908,0.9549041713641488,0.22886801779535343,0.7711319822046465,0.04509582863585118,0.5142683667273832
0.569,2910,"[[847, 1560], [40, 463]]",847,40,1560,40,887,2023,2407,503,1310,1600,0.45017182130584193,0.3518903199002908,0.9549041713641488,0.22886801779535343,0.7711319822046465,0.04509582863585118,0.5142683667273832
0.57,2910,"[[847, 1560], [40, 463]]",847,40,1560,40,887,2023,2407,503,1310,1600,0.45017182130584193,0.3518903199002908,0.9549041713641488,0.22886801779535343,0.7711319822046465,0.04509582863585118,0.5142683667273832
0.571,2910,"[[847, 1560], [40, 463]]",847,40,1560,40,887,2023,2407,503,1310,1600,0.45017182130584193,0.3518903199002908,0.9549041713641488,0.22886801779535343,0.7711319822046465,0.04509582863585118,0.5142683667273832
0.572,2910,"[[847, 1560], [40, 463]]",847,40,1560,40,887,2023,2407,503,1310,1600,0.45017182130584193,0.3518903199002908,0.9549041713641488,0.22886801779535343,0.7711319822046465,0.04509582863585118,0.5142683667273832
0.573,2910,"[[847, 1560], [40, 463]]",847,40,1560,40,887,2023,2407,503,1310,1600,0.45017182130584193,0.3518903199002908,0.9549041713641488,0.22886801779535343,0.7711319822046465,0.04509582863585118,0.5142683667273832
0.574,2910,"[[847, 1560], [40, 463]]",847,40,1560,40,887,2023,2407,503,1310,1600,0.45017182130584193,0.3518903199002908,0.9549041713641488,0.22886801779535343,0.7711319822046465,0.04509582863585118,0.5142683667273832
0.575,2910,"[[847, 1560], [40, 463]]",847,40,1560,40,887,2023,2407,503,1310,1600,0.45017182130584193,0.3518903199002908,0.9549041713641488,0.22886801779535343,0.7711319822046465,0.04509582863585118,0.5142683667273832
0.576,2910,"[[847, 1560], [40, 463]]",847,40,1560,40,887,2023,2407,503,1310,1600,0.45017182130584193,0.3518903199002908,0.9549041713641488,0.22886801779535343,0.7711319822046465,0.04509582863585118,0.5142683667273832
0.577,2910,"[[847, 1560], [40, 463]]",847,40,1560,40,887,2023,2407,503,1310,1600,0.45017182130584193,0.3518903199002908,0.9549041713641488,0.22886801779535343,0.7711319822046465,0.04509582863585118,0.5142683667273832
0.578,2910,"[[847, 1560], [40, 463]]",847,40,1560,40,887,2023,2407,503,1310,1600,0.45017182130584193,0.3518903199002908,0.9549041713641488,0.22886801779535343,0.7711319822046465,0.04509582863585118,0.5142683667273832
0.579,2910,"[[847, 1560], [40, 463]]",847,40,1560,40,887,2023,2407,503,1310,1600,0.45017182130584193,0.3518903199002908,0.9549041713641488,0.22886801779535343,0.7711319822046465,0.04509582863585118,0.5142683667273832
0.58,2910,"[[847, 1560], [40, 463]]",847,40,1560,40,887,2023,2407,503,1310,1600,0.45017182130584193,0.3518903199002908,0.9549041713641488,0.22886801779535343,0.7711319822046465,0.04509582863585118,0.5142683667273832
0.581,2910,"[[847, 1560], [40, 463]]",847,40,1560,40,887,2023,2407,503,1310,1600,0.45017182130584193,0.3518903199002908,0.9549041713641488,0.22886801779535343,0.7711319822046465,0.04509582863585118,0.5142683667273832
0.582,2910,"[[847, 1560], [40, 463]]",847,40,1560,40,887,2023,2407,503,1310,1600,0.45017182130584193,0.3518903199002908,0.9549041713641488,0.22886801779535343,0.7711319822046465,0.04509582863585118,0.5142683667273832
0.583,2910,"[[847, 1560], [40, 463]]",847,40,1560,40,887,2023,2407,503,1310,1600,0.45017182130584193,0.3518903199002908,0.9549041713641488,0.22886801779535343,0.7711319822046465,0.04509582863585118,0.5142683667273832
0.584,2910,"[[847, 1559], [40, 464]]",847,40,1559,40,887,2023,2406,504,1311,1599,0.4505154639175258,0.35203657522859516,0.9549041713641488,0.22936233316856156,0.7706376668314384,0.04509582863585118,0.514424536896447
0.585,2910,"[[847, 1558], [40, 465]]",847,40,1558,40,887,2023,2405,505,1312,1598,0.45085910652920963,0.3521829521829522,0.9549041713641488,0.22985664854176965,0.7701433514582303,0.04509582863585118,0.5145808019441069
0.586,2910,"[[847, 1558], [40, 465]]",847,40,1558,40,887,2023,2405,505,1312,1598,0.45085910652920963,0.3521829521829522,0.9549041713641488,0.22985664854176965,0.7701433514582303,0.04509582863585118,0.5145808019441069
0.587,2910,"[[847, 1558], [40, 465]]",847,40,1558,40,887,2023,2405,505,1312,1598,0.45085910652920963,0.3521829521829522,0.9549041713641488,0.22985664854176965,0.7701433514582303,0.04509582863585118,0.5145808019441069
0.588,2910,"[[847, 1558], [40, 465]]",847,40,1558,40,887,2023,2405,505,1312,1598,0.45085910652920963,0.3521829521829522,0.9549041713641488,0.22985664854176965,0.7701433514582303,0.04509582863585118,0.5145808019441069
0.589,2910,"[[847, 1558], [40, 465]]",847,40,1558,40,887,2023,2405,505,1312,1598,0.45085910652920963,0.3521829521829522,0.9549041713641488,0.22985664854176965,0.7701433514582303,0.04509582863585118,0.5145808019441069
0.59,2910,"[[847, 1558], [40, 465]]",847,40,1558,40,887,2023,2405,505,1312,1598,0.45085910652920963,0.3521829521829522,0.9549041713641488,0.22985664854176965,0.7701433514582303,0.04509582863585118,0.5145808019441069
0.591,2910,"[[846, 1558], [41, 465]]",846,41,1558,41,887,2023,2404,506,1311,1599,0.4505154639175258,0.3519134775374376,0.9537767756482526,0.22985664854176965,0.7701433514582303,0.046223224351747465,0.5141294439380129
0.592,2910,"[[846, 1558], [41, 465]]",846,41,1558,41,887,2023,2404,506,1311,1599,0.4505154639175258,0.3519134775374376,0.9537767756482526,0.22985664854176965,0.7701433514582303,0.046223224351747465,0.5141294439380129
0.593,2910,"[[846, 1558], [41, 465]]",846,41,1558,41,887,2023,2404,506,1311,1599,0.4505154639175258,0.3519134775374376,0.9537767756482526,0.22985664854176965,0.7701433514582303,0.046223224351747465,0.5141294439380129
0.594,2910,"[[846, 1558], [41, 465]]",846,41,1558,41,887,2023,2404,506,1311,1599,0.4505154639175258,0.3519134775374376,0.9537767756482526,0.22985664854176965,0.7701433514582303,0.046223224351747465,0.5141294439380129
0.595,2910,"[[846, 1556], [41, 467]]",846,41,1556,41,887,2023,2402,508,1313,1597,0.4512027491408935,0.3522064945878435,0.9537767756482526,0.23084527928818585,0.7691547207118141,0.046223224351747465,0.514442079659471
0.596,2910,"[[846, 1556], [41, 467]]",846,41,1556,41,887,2023,2402,508,1313,1597,0.4512027491408935,0.3522064945878435,0.9537767756482526,0.23084527928818585,0.7691547207118141,0.046223224351747465,0.514442079659471
0.597,2910,"[[846, 1556], [41, 467]]",846,41,1556,41,887,2023,2402,508,1313,1597,0.4512027491408935,0.3522064945878435,0.9537767756482526,0.23084527928818585,0.7691547207118141,0.046223224351747465,0.514442079659471
0.598,2910,"[[846, 1556], [41, 467]]",846,41,1556,41,887,2023,2402,508,1313,1597,0.4512027491408935,0.3522064945878435,0.9537767756482526,0.23084527928818585,0.7691547207118141,0.046223224351747465,0.514442079659471
0.599,2910,"[[846, 1556], [41, 467]]",846,41,1556,41,887,2023,2402,508,1313,1597,0.4512027491408935,0.3522064945878435,0.9537767756482526,0.23084527928818585,0.7691547207118141,0.046223224351747465,0.514442079659471
0.6,2910,"[[846, 1556], [41, 467]]",846,41,1556,41,887,2023,2402,508,1313,1597,0.4512027491408935,0.3522064945878435,0.9537767756482526,0.23084527928818585,0.7691547207118141,0.046223224351747465,0.514442079659471
0.601,2910,"[[845, 1556], [42, 467]]",845,42,1556,42,887,2023,2401,509,1312,1598,0.45085910652920963,0.35193669304456476,0.9526493799323562,0.23084527928818585,0.7691547207118141,0.04735062006764374,0.5139902676399026
0.602,2910,"[[845, 1555], [42, 468]]",845,42,1555,42,887,2023,2400,510,1313,1597,0.4512027491408935,0.35208333333333336,0.9526493799323562,0.23133959466139398,0.768660405338606,0.04735062006764374,0.5141466382719805
0.603,2910,"[[845, 1554], [42, 469]]",845,42,1554,42,887,2023,2399,511,1314,1596,0.4515463917525773,0.3522300958732805,0.9526493799323562,0.23183391003460208,0.7681660899653979,0.04735062006764374,0.5143031040779062
0.604,2910,"[[845, 1554], [42, 469]]",845,42,1554,42,887,2023,2399,511,1314,1596,0.4515463917525773,0.3522300958732805,0.9526493799323562,0.23183391003460208,0.7681660899653979,0.04735062006764374,0.5143031040779062
0.605,2910,"[[845, 1554], [42, 469]]",845,42,1554,42,887,2023,2399,511,1314,1596,0.4515463917525773,0.3522300958732805,0.9526493799323562,0.23183391003460208,0.7681660899653979,0.04735062006764374,0.5143031040779062
0.606,2910,"[[845, 1554], [42, 469]]",845,42,1554,42,887,2023,2399,511,1314,1596,0.4515463917525773,0.3522300958732805,0.9526493799323562,0.23183391003460208,0.7681660899653979,0.04735062006764374,0.5143031040779062
0.607,2910,"[[845, 1554], [42, 469]]",845,42,1554,42,887,2023,2399,511,1314,1596,0.4515463917525773,0.3522300958732805,0.9526493799323562,0.23183391003460208,0.7681660899653979,0.04735062006764374,0.5143031040779062
0.608,2910,"[[845, 1554], [42, 469]]",845,42,1554,42,887,2023,2399,511,1314,1596,0.4515463917525773,0.3522300958732805,0.9526493799323562,0.23183391003460208,0.7681660899653979,0.04735062006764374,0.5143031040779062
0.609,2910,"[[845, 1554], [42, 469]]",845,42,1554,42,887,2023,2399,511,1314,1596,0.4515463917525773,0.3522300958732805,0.9526493799323562,0.23183391003460208,0.7681660899653979,0.04735062006764374,0.5143031040779062
0.61,2910,"[[845, 1554], [42, 469]]",845,42,1554,42,887,2023,2399,511,1314,1596,0.4515463917525773,0.3522300958732805,0.9526493799323562,0.23183391003460208,0.7681660899653979,0.04735062006764374,0.5143031040779062
0.611,2910,"[[845, 1554], [42, 469]]",845,42,1554,42,887,2023,2399,511,1314,1596,0.4515463917525773,0.3522300958732805,0.9526493799323562,0.23183391003460208,0.7681660899653979,0.04735062006764374,0.5143031040779062
0.612,2910,"[[845, 1554], [42, 469]]",845,42,1554,42,887,2023,2399,511,1314,1596,0.4515463917525773,0.3522300958732805,0.9526493799323562,0.23183391003460208,0.7681660899653979,0.04735062006764374,0.5143031040779062
0.613,2910,"[[845, 1554], [42, 469]]",845,42,1554,42,887,2023,2399,511,1314,1596,0.4515463917525773,0.3522300958732805,0.9526493799323562,0.23183391003460208,0.7681660899653979,0.04735062006764374,0.5143031040779062
0.614,2910,"[[845, 1554], [42, 469]]",845,42,1554,42,887,2023,2399,511,1314,1596,0.4515463917525773,0.3522300958732805,0.9526493799323562,0.23183391003460208,0.7681660899653979,0.04735062006764374,0.5143031040779062
0.615,2910,"[[845, 1554], [42, 469]]",845,42,1554,42,887,2023,2399,511,1314,1596,0.4515463917525773,0.3522300958732805,0.9526493799323562,0.23183391003460208,0.7681660899653979,0.04735062006764374,0.5143031040779062
0.616,2910,"[[845, 1553], [42, 470]]",845,42,1553,42,887,2023,2398,512,1315,1595,0.4518900343642612,0.3523769808173478,0.9526493799323562,0.23232822540781017,0.7676717745921898,0.04735062006764374,0.5144596651445966
0.617,2910,"[[845, 1553], [42, 470]]",845,42,1553,42,887,2023,2398,512,1315,1595,0.4518900343642612,0.3523769808173478,0.9526493799323562,0.23232822540781017,0.7676717745921898,0.04735062006764374,0.5144596651445966
0.618,2910,"[[845, 1552], [42, 471]]",845,42,1552,42,887,2023,2397,513,1316,1594,0.452233676975945,0.3525239883187318,0.9526493799323562,0.2328225407810183,0.7671774592189817,0.04735062006764374,0.5146163215590743
0.619,2910,"[[845, 1552], [42, 471]]",845,42,1552,42,887,2023,2397,513,1316,1594,0.452233676975945,0.3525239883187318,0.9526493799323562,0.2328225407810183,0.7671774592189817,0.04735062006764374,0.5146163215590743
0.62,2910,"[[845, 1552], [42, 471]]",845,42,1552,42,887,2023,2397,513,1316,1594,0.452233676975945,0.3525239883187318,0.9526493799323562,0.2328225407810183,0.7671774592189817,0.04735062006764374,0.5146163215590743
0.621,2910,"[[845, 1551], [42, 472]]",845,42,1551,42,887,2023,2396,514,1317,1593,0.45257731958762887,0.3526711185308848,0.9526493799323562,0.2333168561542264,0.7666831438457736,0.04735062006764374,0.5147730734084678
0.622,2910,"[[845, 1551], [42, 472]]",845,42,1551,42,887,2023,2396,514,1317,1593,0.45257731958762887,0.3526711185308848,0.9526493799323562,0.2333168561542264,0.7666831438457736,0.04735062006764374,0.5147730734084678
0.623,2910,"[[845, 1550], [42, 473]]",845,42,1550,42,887,2023,2395,515,1318,1592,0.4529209621993127,0.35281837160751567,0.9526493799323562,0.2338111715274345,0.7661888284725655,0.04735062006764374,0.5149299207800122
0.624,2910,"[[845, 1550], [42, 473]]",845,42,1550,42,887,2023,2395,515,1318,1592,0.4529209621993127,0.35281837160751567,0.9526493799323562,0.2338111715274345,0.7661888284725655,0.04735062006764374,0.5149299207800122
0.625,2910,"[[845, 1549], [42, 474]]",845,42,1549,42,887,2023,2394,516,1319,1591,0.45326460481099656,0.3529657477025898,0.9526493799323562,0.23430548690064262,0.7656945130993574,0.04735062006764374,0.5150868637610485
0.626,2910,"[[845, 1548], [42, 475]]",845,42,1548,42,887,2023,2393,517,1320,1590,0.4536082474226804,0.35311324697033014,0.9526493799323562,0.23479980227385072,0.7652001977261493,0.04735062006764374,0.5152439024390244
0.627,2910,"[[845, 1548], [42, 475]]",845,42,1548,42,887,2023,2393,517,1320,1590,0.4536082474226804,0.35311324697033014,0.9526493799323562,0.23479980227385072,0.7652001977261493,0.04735062006764374,0.5152439024390244
0.628,2910,"[[845, 1548], [42, 475]]",845,42,1548,42,887,2023,2393,517,1320,1590,0.4536082474226804,0.35311324697033014,0.9526493799323562,0.23479980227385072,0.7652001977261493,0.04735062006764374,0.5152439024390244
0.629,2910,"[[845, 1548], [42, 475]]",845,42,1548,42,887,2023,2393,517,1320,1590,0.4536082474226804,0.35311324697033014,0.9526493799323562,0.23479980227385072,0.7652001977261493,0.04735062006764374,0.5152439024390244
0.63,2910,"[[845, 1548], [42, 475]]",845,42,1548,42,887,2023,2393,517,1320,1590,0.4536082474226804,0.35311324697033014,0.9526493799323562,0.23479980227385072,0.7652001977261493,0.04735062006764374,0.5152439024390244
0.631,2910,"[[845, 1547], [42, 476]]",845,42,1547,42,887,2023,2392,518,1321,1589,0.45395189003436426,0.3532608695652174,0.9526493799323562,0.23529411764705882,0.7647058823529411,0.04735062006764374,0.5154010369014944
0.632,2910,"[[845, 1547], [42, 476]]",845,42,1547,42,887,2023,2392,518,1321,1589,0.45395189003436426,0.3532608695652174,0.9526493799323562,0.23529411764705882,0.7647058823529411,0.04735062006764374,0.5154010369014944
0.633,2910,"[[845, 1547], [42, 476]]",845,42,1547,42,887,2023,2392,518,1321,1589,0.45395189003436426,0.3532608695652174,0.9526493799323562,0.23529411764705882,0.7647058823529411,0.04735062006764374,0.5154010369014944
0.634,2910,"[[845, 1546], [42, 477]]",845,42,1546,42,887,2023,2391,519,1322,1588,0.4542955326460481,0.3534086156419908,0.9526493799323562,0.23578843302026692,0.764211566979733,0.04735062006764374,0.5155582672361195
0.635,2910,"[[845, 1546], [42, 477]]",845,42,1546,42,887,2023,2391,519,1322,1588,0.4542955326460481,0.3534086156419908,0.9526493799323562,0.23578843302026692,0.764211566979733,0.04735062006764374,0.5155582672361195
0.636,2910,"[[845, 1545], [42, 478]]",845,42,1545,42,887,2023,2390,520,1323,1587,0.45463917525773195,0.35355648535564854,0.9526493799323562,0.23628274839347504,0.7637172516065249,0.04735062006764374,0.5157155935306684
0.637,2910,"[[845, 1543], [42, 480]]",845,42,1543,42,887,2023,2388,522,1325,1585,0.45532646048109965,0.3538525963149079,0.9526493799323562,0.23727137913989124,0.7627286208601087,0.04735062006764374,0.5160305343511451
0.638,2910,"[[845, 1543], [42, 480]]",845,42,1543,42,887,2023,2388,522,1325,1585,0.45532646048109965,0.3538525963149079,0.9526493799323562,0.23727137913989124,0.7627286208601087,0.04735062006764374,0.5160305343511451
0.639,2910,"[[845, 1542], [42, 481]]",845,42,1542,42,887,2023,2387,523,1326,1584,0.4556701030927835,0.35400083787180564,0.9526493799323562,0.23776569451309937,0.7622343054869006,0.04735062006764374,0.516188149053146
0.64,2910,"[[845, 1541], [42, 482]]",845,42,1541,42,887,2023,2386,524,1327,1583,0.45601374570446734,0.35414920368818104,0.9526493799323562,0.23826000988630747,0.7617399901136925,0.04735062006764374,0.5163458600672166
0.641,2910,"[[845, 1541], [42, 482]]",845,42,1541,42,887,2023,2386,524,1327,1583,0.45601374570446734,0.35414920368818104,0.9526493799323562,0.23826000988630747,0.7617399901136925,0.04735062006764374,0.5163458600672166
0.642,2910,"[[845, 1541], [42, 482]]",845,42,1541,42,887,2023,2386,524,1327,1583,0.45601374570446734,0.35414920368818104,0.9526493799323562,0.23826000988630747,0.7617399901136925,0.04735062006764374,0.5163458600672166
0.643,2910,"[[844, 1541], [43, 482]]",844,43,1541,43,887,2023,2385,525,1326,1584,0.4556701030927835,0.3538784067085954,0.95152198421646,0.23826000988630747,0.7617399901136925,0.048478015783540024,0.5158924205378973
0.644,2910,"[[844, 1541], [43, 482]]",844,43,1541,43,887,2023,2385,525,1326,1584,0.4556701030927835,0.3538784067085954,0.95152198421646,0.23826000988630747,0.7617399901136925,0.048478015783540024,0.5158924205378973
0.645,2910,"[[844, 1541], [43, 482]]",844,43,1541,43,887,2023,2385,525,1326,1584,0.4556701030927835,0.3538784067085954,0.95152198421646,0.23826000988630747,0.7617399901136925,0.048478015783540024,0.5158924205378973
0.646,2910,"[[844, 1540], [43, 483]]",844,43,1540,43,887,2023,2384,526,1327,1583,0.45601374570446734,0.3540268456375839,0.95152198421646,0.23875432525951557,0.7612456747404844,0.048478015783540024,0.5160501375726078
0.647,2910,"[[844, 1540], [43, 483]]",844,43,1540,43,887,2023,2384,526,1327,1583,0.45601374570446734,0.3540268456375839,0.95152198421646,0.23875432525951557,0.7612456747404844,0.048478015783540024,0.5160501375726078
0.648,2910,"[[844, 1539], [43, 484]]",844,43,1539,43,887,2023,2383,527,1328,1582,0.4563573883161512,0.3541754091481326,0.95152198421646,0.2392486406327237,0.7607513593672763,0.048478015783540024,0.5162079510703363
0.649,2910,"[[844, 1538], [43, 485]]",844,43,1538,43,887,2023,2382,528,1329,1581,0.45670103092783504,0.35432409739714527,0.95152198421646,0.2397429560059318,0.7602570439940682,0.048478015783540024,0.5163658611196084
0.65,2910,"[[844, 1537], [43, 486]]",844,43,1537,43,887,2023,2381,529,1330,1580,0.4570446735395189,0.35447291054178914,0.95152198421646,0.2402372713791399,0.7597627286208601,0.048478015783540024,0.5165238678090575
0.651,2910,"[[844, 1537], [43, 486]]",844,43,1537,43,887,2023,2381,529,1330,1580,0.4570446735395189,0.35447291054178914,0.95152198421646,0.2402372713791399,0.7597627286208601,0.048478015783540024,0.5165238678090575
0.652,2910,"[[844, 1537], [43, 486]]",844,43,1537,43,887,2023,2381,529,1330,1580,0.4570446735395189,0.35447291054178914,0.95152198421646,0.2402372713791399,0.7597627286208601,0.048478015783540024,0.5165238678090575
0.653,2910,"[[844, 1537], [43, 486]]",844,43,1537,43,887,2023,2381,529,1330,1580,0.4570446735395189,0.35447291054178914,0.95152198421646,0.2402372713791399,0.7597627286208601,0.048478015783540024,0.5165238678090575
0.654,2910,"[[844, 1537], [43, 486]]",844,43,1537,43,887,2023,2381,529,1330,1580,0.4570446735395189,0.35447291054178914,0.95152198421646,0.2402372713791399,0.7597627286208601,0.048478015783540024,0.5165238678090575
0.655,2910,"[[844, 1537], [43, 486]]",844,43,1537,43,887,2023,2381,529,1330,1580,0.4570446735395189,0.35447291054178914,0.95152198421646,0.2402372713791399,0.7597627286208601,0.048478015783540024,0.5165238678090575
0.656,2910,"[[844, 1536], [43, 487]]",844,43,1536,43,887,2023,2380,530,1331,1579,0.45738831615120273,0.3546218487394958,0.95152198421646,0.240731586752348,0.759268413247652,0.048478015783540024,0.5166819712274258
0.657,2910,"[[844, 1536], [43, 487]]",844,43,1536,43,887,2023,2380,530,1331,1579,0.45738831615120273,0.3546218487394958,0.95152198421646,0.240731586752348,0.759268413247652,0.048478015783540024,0.5166819712274258
0.658,2910,"[[844, 1536], [43, 487]]",844,43,1536,43,887,2023,2380,530,1331,1579,0.45738831615120273,0.3546218487394958,0.95152198421646,0.240731586752348,0.759268413247652,0.048478015783540024,0.5166819712274258
0.659,2910,"[[844, 1536], [43, 487]]",844,43,1536,43,887,2023,2380,530,1331,1579,0.45738831615120273,0.3546218487394958,0.95152198421646,0.240731586752348,0.759268413247652,0.048478015783540024,0.5166819712274258
0.66,2910,"[[844, 1536], [43, 487]]",844,43,1536,43,887,2023,2380,530,1331,1579,0.45738831615120273,0.3546218487394958,0.95152198421646,0.240731586752348,0.759268413247652,0.048478015783540024,0.5166819712274258
0.661,2910,"[[844, 1536], [43, 487]]",844,43,1536,43,887,2023,2380,530,1331,1579,0.45738831615120273,0.3546218487394958,0.95152198421646,0.240731586752348,0.759268413247652,0.048478015783540024,0.5166819712274258
0.662,2910,"[[844, 1535], [43, 488]]",844,43,1535,43,887,2023,2379,531,1332,1578,0.4577319587628866,0.3547709121479613,0.95152198421646,0.2412259021255561,0.7587740978744439,0.048478015783540024,0.516840171463564
0.663,2910,"[[844, 1535], [43, 488]]",844,43,1535,43,887,2023,2379,531,1332,1578,0.4577319587628866,0.3547709121479613,0.95152198421646,0.2412259021255561,0.7587740978744439,0.048478015783540024,0.516840171463564
0.664,2910,"[[843, 1535], [44, 488]]",843,44,1535,44,887,2023,2378,532,1331,1579,0.45738831615120273,0.35449957947855343,0.9503945885005637,0.2412259021255561,0.7587740978744439,0.0496054114994363,0.5163859111791731
0.665,2910,"[[843, 1535], [44, 488]]",843,44,1535,44,887,2023,2378,532,1331,1579,0.45738831615120273,0.35449957947855343,0.9503945885005637,0.2412259021255561,0.7587740978744439,0.0496054114994363,0.5163859111791731
0.666,2910,"[[843, 1535], [44, 488]]",843,44,1535,44,887,2023,2378,532,1331,1579,0.45738831615120273,0.35449957947855343,0.9503945885005637,0.2412259021255561,0.7587740978744439,0.0496054114994363,0.5163859111791731
0.667,2910,"[[843, 1535], [44, 488]]",843,44,1535,44,887,2023,2378,532,1331,1579,0.45738831615120273,0.35449957947855343,0.9503945885005637,0.2412259021255561,0.7587740978744439,0.0496054114994363,0.5163859111791731
0.668,2910,"[[843, 1534], [44, 489]]",843,44,1534,44,887,2023,2377,533,1332,1578,0.4577319587628866,0.3546487168700042,0.9503945885005637,0.2417202174987642,0.7582797825012358,0.0496054114994363,0.5165441176470589
0.669,2910,"[[843, 1532], [44, 491]]",843,44,1532,44,887,2023,2375,535,1334,1576,0.4584192439862543,0.3549473684210526,0.9503945885005637,0.24270884824518044,0.7572911517548195,0.0496054114994363,0.5168608215818516
0.67,2910,"[[843, 1531], [44, 492]]",843,44,1531,44,887,2023,2374,536,1335,1575,0.4587628865979381,0.35509688289806235,0.9503945885005637,0.24320316361838853,0.7567968363816114,0.0496054114994363,0.5170193192272309
0.671,2910,"[[843, 1531], [44, 492]]",843,44,1531,44,887,2023,2374,536,1335,1575,0.4587628865979381,0.35509688289806235,0.9503945885005637,0.24320316361838853,0.7567968363816114,0.0496054114994363,0.5170193192272309
0.672,2910,"[[843, 1531], [44, 492]]",843,44,1531,44,887,2023,2374,536,1335,1575,0.4587628865979381,0.35509688289806235,0.9503945885005637,0.24320316361838853,0.7567968363816114,0.0496054114994363,0.5170193192272309
0.673,2910,"[[843, 1530], [44, 493]]",843,44,1530,44,887,2023,2373,537,1336,1574,0.45910652920962197,0.3552465233881163,0.9503945885005637,0.24369747899159663,0.7563025210084033,0.0496054114994363,0.5171779141104295
0.674,2910,"[[843, 1530], [44, 493]]",843,44,1530,44,887,2023,2373,537,1336,1574,0.45910652920962197,0.3552465233881163,0.9503945885005637,0.24369747899159663,0.7563025210084033,0.0496054114994363,0.5171779141104295
0.675,2910,"[[843, 1529], [44, 494]]",843,44,1529,44,887,2023,2372,538,1337,1573,0.4594501718213058,0.3553962900505902,0.9503945885005637,0.24419179436480473,0.7558082056351952,0.0496054114994363,0.5173366063209573
0.676,2910,"[[843, 1529], [44, 494]]",843,44,1529,44,887,2023,2372,538,1337,1573,0.4594501718213058,0.3553962900505902,0.9503945885005637,0.24419179436480473,0.7558082056351952,0.0496054114994363,0.5173366063209573
0.677,2910,"[[843, 1529], [44, 494]]",843,44,1529,44,887,2023,2372,538,1337,1573,0.4594501718213058,0.3553962900505902,0.9503945885005637,0.24419179436480473,0.7558082056351952,0.0496054114994363,0.5173366063209573
0.678,2910,"[[843, 1529], [44, 494]]",843,44,1529,44,887,2023,2372,538,1337,1573,0.4594501718213058,0.3553962900505902,0.9503945885005637,0.24419179436480473,0.7558082056351952,0.0496054114994363,0.5173366063209573
0.679,2910,"[[843, 1529], [44, 494]]",843,44,1529,44,887,2023,2372,538,1337,1573,0.4594501718213058,0.3553962900505902,0.9503945885005637,0.24419179436480473,0.7558082056351952,0.0496054114994363,0.5173366063209573
0.68,2910,"[[843, 1529], [44, 494]]",843,44,1529,44,887,2023,2372,538,1337,1573,0.4594501718213058,0.3553962900505902,0.9503945885005637,0.24419179436480473,0.7558082056351952,0.0496054114994363,0.5173366063209573
0.681,2910,"[[843, 1529], [44, 494]]",843,44,1529,44,887,2023,2372,538,1337,1573,0.4594501718213058,0.3553962900505902,0.9503945885005637,0.24419179436480473,0.7558082056351952,0.0496054114994363,0.5173366063209573
0.682,2910,"[[843, 1528], [44, 495]]",843,44,1528,44,887,2023,2371,539,1338,1572,0.45979381443298967,0.35554618304512864,0.9503945885005637,0.24468610973801286,0.7553138902619871,0.0496054114994363,0.5174953959484346
0.683,2910,"[[843, 1528], [44, 495]]",843,44,1528,44,887,2023,2371,539,1338,1572,0.45979381443298967,0.35554618304512864,0.9503945885005637,0.24468610973801286,0.7553138902619871,0.0496054114994363,0.5174953959484346
0.684,2910,"[[843, 1527], [44, 496]]",843,44,1527,44,887,2023,2370,540,1339,1571,0.4601374570446735,0.3556962025316456,0.9503945885005637,0.24518042511122096,0.754819574888779,0.0496054114994363,0.5176542830825913
0.685,2910,"[[843, 1527], [44, 496]]",843,44,1527,44,887,2023,2370,540,1339,1571,0.4601374570446735,0.3556962025316456,0.9503945885005637,0.24518042511122096,0.754819574888779,0.0496054114994363,0.5176542830825913
0.686,2910,"[[842, 1527], [45, 496]]",842,45,1527,45,887,2023,2369,541,1338,1572,0.45979381443298967,0.35542422963275644,0.9492671927846674,0.24518042511122096,0.754819574888779,0.05073280721533258,0.5171990171990173
0.687,2910,"[[842, 1527], [45, 496]]",842,45,1527,45,887,2023,2369,541,1338,1572,0.45979381443298967,0.35542422963275644,0.9492671927846674,0.24518042511122096,0.754819574888779,0.05073280721533258,0.5171990171990173
0.688,2910,"[[842, 1527], [45, 496]]",842,45,1527,45,887,2023,2369,541,1338,1572,0.45979381443298967,0.35542422963275644,0.9492671927846674,0.24518042511122096,0.754819574888779,0.05073280721533258,0.5171990171990173
0.689,2910,"[[842, 1527], [45, 496]]",842,45,1527,45,887,2023,2369,541,1338,1572,0.45979381443298967,0.35542422963275644,0.9492671927846674,0.24518042511122096,0.754819574888779,0.05073280721533258,0.5171990171990173
0.69,2910,"[[842, 1526], [45, 497]]",842,45,1526,45,887,2023,2368,542,1339,1571,0.4601374570446735,0.35557432432432434,0.9492671927846674,0.24567474048442905,0.754325259515571,0.05073280721533258,0.517357910906298
0.691,2910,"[[842, 1526], [45, 497]]",842,45,1526,45,887,2023,2368,542,1339,1571,0.4601374570446735,0.35557432432432434,0.9492671927846674,0.24567474048442905,0.754325259515571,0.05073280721533258,0.517357910906298
0.692,2910,"[[842, 1526], [45, 497]]",842,45,1526,45,887,2023,2368,542,1339,1571,0.4601374570446735,0.35557432432432434,0.9492671927846674,0.24567474048442905,0.754325259515571,0.05073280721533258,0.517357910906298
0.693,2910,"[[842, 1525], [45, 498]]",842,45,1525,45,887,2023,2367,543,1340,1570,0.46048109965635736,0.3557245458386143,0.9492671927846674,0.24616905585763718,0.7538309441423628,0.05073280721533258,0.5175169022741243
0.694,2910,"[[842, 1525], [45, 498]]",842,45,1525,45,887,2023,2367,543,1340,1570,0.46048109965635736,0.3557245458386143,0.9492671927846674,0.24616905585763718,0.7538309441423628,0.05073280721533258,0.5175169022741243
0.695,2910,"[[842, 1523], [45, 500]]",842,45,1523,45,887,2023,2365,545,1342,1568,0.4611683848797251,0.35602536997885836,0.9492671927846674,0.24715768660405338,0.7528423133959466,0.05073280721533258,0.5178351783517836
0.696,2910,"[[842, 1522], [45, 501]]",842,45,1522,45,887,2023,2364,546,1343,1567,0.46151202749140896,0.35617597292724196,0.9492671927846674,0.2476520019772615,0.7523479980227386,0.05073280721533258,0.5179944632420793
0.697,2910,"[[842, 1522], [45, 501]]",842,45,1522,45,887,2023,2364,546,1343,1567,0.46151202749140896,0.35617597292724196,0.9492671927846674,0.2476520019772615,0.7523479980227386,0.05073280721533258,0.5179944632420793
0.698,2910,"[[842, 1522], [45, 501]]",842,45,1522,45,887,2023,2364,546,1343,1567,0.46151202749140896,0.35617597292724196,0.9492671927846674,0.2476520019772615,0.7523479980227386,0.05073280721533258,0.5179944632420793
0.699,2910,"[[842, 1520], [45, 503]]",842,45,1520,45,887,2023,2362,548,1345,1565,0.46219931271477666,0.35647756138865366,0.9492671927846674,0.2486406327236777,0.7513593672763222,0.05073280721533258,0.5183133271775932
0.7,2910,"[[842, 1519], [45, 504]]",842,45,1519,45,887,2023,2361,549,1346,1564,0.4625429553264605,0.3566285472257518,0.9492671927846674,0.2491349480968858,0.7508650519031141,0.05073280721533258,0.518472906403941
0.701,2910,"[[842, 1519], [45, 504]]",842,45,1519,45,887,2023,2361,549,1346,1564,0.4625429553264605,0.3566285472257518,0.9492671927846674,0.2491349480968858,0.7508650519031141,0.05073280721533258,0.518472906403941
0.702,2910,"[[842, 1518], [45, 505]]",842,45,1518,45,887,2023,2360,550,1347,1563,0.46288659793814435,0.35677966101694913,0.9492671927846674,0.24962926347009393,0.750370736529906,0.05073280721533258,0.5186325839236218
0.703,2910,"[[842, 1518], [45, 505]]",842,45,1518,45,887,2023,2360,550,1347,1563,0.46288659793814435,0.35677966101694913,0.9492671927846674,0.24962926347009393,0.750370736529906,0.05073280721533258,0.5186325839236218
0.704,2910,"[[842, 1517], [45, 506]]",842,45,1517,45,887,2023,2359,551,1348,1562,0.4632302405498282,0.3569309029249682,0.9492671927846674,0.25012357884330205,0.749876421156698,0.05073280721533258,0.51879235982748
0.705,2910,"[[842, 1517], [45, 506]]",842,45,1517,45,887,2023,2359,551,1348,1562,0.4632302405498282,0.3569309029249682,0.9492671927846674,0.25012357884330205,0.749876421156698,0.05073280721533258,0.51879235982748
0.706,2910,"[[842, 1516], [45, 507]]",842,45,1516,45,887,2023,2358,552,1349,1561,0.46357388316151205,0.3570822731128075,0.9492671927846674,0.25061789421651015,0.7493821057834898,0.05073280721533258,0.5189522342064716
0.707,2910,"[[842, 1515], [45, 508]]",842,45,1515,45,887,2023,2357,553,1350,1560,0.4639175257731959,0.35723377174374205,0.9492671927846674,0.25111220958971825,0.7488877904102818,0.05073280721533258,0.5191122071516646
0.708,2910,"[[842, 1515], [45, 508]]",842,45,1515,45,887,2023,2357,553,1350,1560,0.4639175257731959,0.35723377174374205,0.9492671927846674,0.25111220958971825,0.7488877904102818,0.05073280721533258,0.5191122071516646
0.709,2910,"[[842, 1513], [45, 510]]",842,45,1513,45,887,2023,2355,555,1352,1558,0.4646048109965636,0.35753715498938426,0.9492671927846674,0.25210084033613445,0.7478991596638656,0.05073280721533258,0.5194324491054904
0.71,2910,"[[842, 1513], [45, 510]]",842,45,1513,45,887,2023,2355,555,1352,1558,0.4646048109965636,0.35753715498938426,0.9492671927846674,0.25210084033613445,0.7478991596638656,0.05073280721533258,0.5194324491054904
0.711,2910,"[[842, 1511], [45, 512]]",842,45,1511,45,887,2023,2353,557,1354,1556,0.4652920962199313,0.3578410539736507,0.9492671927846674,0.25308947108255064,0.7469105289174494,0.05073280721533258,0.519753086419753
0.712,2910,"[[842, 1511], [45, 512]]",842,45,1511,45,887,2023,2353,557,1354,1556,0.4652920962199313,0.3578410539736507,0.9492671927846674,0.25308947108255064,0.7469105289174494,0.05073280721533258,0.519753086419753
0.713,2910,"[[842, 1511], [45, 512]]",842,45,1511,45,887,2023,2353,557,1354,1556,0.4652920962199313,0.3578410539736507,0.9492671927846674,0.25308947108255064,0.7469105289174494,0.05073280721533258,0.519753086419753
0.714,2910,"[[842, 1510], [45, 513]]",842,45,1510,45,887,2023,2352,558,1355,1555,0.46563573883161513,0.35799319727891155,0.9492671927846674,0.2535837864557588,0.7464162135442413,0.05073280721533258,0.5199135535659153
0.715,2910,"[[842, 1509], [45, 514]]",842,45,1509,45,887,2023,2351,559,1356,1554,0.465979381443299,0.35814547001276054,0.9492671927846674,0.2540781018289669,0.7459218981710332,0.05073280721533258,0.5200741198270539
0.716,2910,"[[842, 1509], [45, 514]]",842,45,1509,45,887,2023,2351,559,1356,1554,0.465979381443299,0.35814547001276054,0.9492671927846674,0.2540781018289669,0.7459218981710332,0.05073280721533258,0.5200741198270539
0.717,2910,"[[842, 1507], [45, 516]]",842,45,1507,45,887,2023,2349,561,1358,1552,0.4666666666666667,0.35845040442741594,0.9492671927846674,0.2550667325753831,0.7449332674246169,0.05073280721533258,0.5203955500618047
0.718,2910,"[[842, 1506], [45, 517]]",842,45,1506,45,887,2023,2348,562,1359,1551,0.4670103092783505,0.358603066439523,0.9492671927846674,0.2555610479485912,0.7444389520514088,0.05073280721533258,0.5205564142194745
0.719,2910,"[[842, 1505], [45, 518]]",842,45,1505,45,887,2023,2347,563,1360,1550,0.46735395189003437,0.3587558585428206,0.9492671927846674,0.2560553633217993,0.7439446366782007,0.05073280721533258,0.520717377860235
0.72,2910,"[[842, 1505], [45, 518]]",842,45,1505,45,887,2023,2347,563,1360,1550,0.46735395189003437,0.3587558585428206,0.9492671927846674,0.2560553633217993,0.7439446366782007,0.05073280721533258,0.520717377860235
0.721,2910,"[[842, 1505], [45, 518]]",842,45,1505,45,887,2023,2347,563,1360,1550,0.46735395189003437,0.3587558585428206,0.9492671927846674,0.2560553633217993,0.7439446366782007,0.05073280721533258,0.520717377860235
0.722,2910,"[[842, 1505], [45, 518]]",842,45,1505,45,887,2023,2347,563,1360,1550,0.46735395189003437,0.3587558585428206,0.9492671927846674,0.2560553633217993,0.7439446366782007,0.05073280721533258,0.520717377860235
0.723,2910,"[[842, 1505], [45, 518]]",842,45,1505,45,887,2023,2347,563,1360,1550,0.46735395189003437,0.3587558585428206,0.9492671927846674,0.2560553633217993,0.7439446366782007,0.05073280721533258,0.520717377860235
0.724,2910,"[[842, 1505], [45, 518]]",842,45,1505,45,887,2023,2347,563,1360,1550,0.46735395189003437,0.3587558585428206,0.9492671927846674,0.2560553633217993,0.7439446366782007,0.05073280721533258,0.520717377860235
0.725,2910,"[[842, 1505], [45, 518]]",842,45,1505,45,887,2023,2347,563,1360,1550,0.46735395189003437,0.3587558585428206,0.9492671927846674,0.2560553633217993,0.7439446366782007,0.05073280721533258,0.520717377860235
0.726,2910,"[[842, 1505], [45, 518]]",842,45,1505,45,887,2023,2347,563,1360,1550,0.46735395189003437,0.3587558585428206,0.9492671927846674,0.2560553633217993,0.7439446366782007,0.05073280721533258,0.520717377860235
0.727,2910,"[[842, 1504], [45, 519]]",842,45,1504,45,887,2023,2346,564,1361,1549,0.4676975945017182,0.3589087809036658,0.9492671927846674,0.2565496786950074,0.7434503213049926,0.05073280721533258,0.5208784410763996
0.728,2910,"[[842, 1504], [45, 519]]",842,45,1504,45,887,2023,2346,564,1361,1549,0.4676975945017182,0.3589087809036658,0.9492671927846674,0.2565496786950074,0.7434503213049926,0.05073280721533258,0.5208784410763996
0.729,2910,"[[842, 1504], [45, 519]]",842,45,1504,45,887,2023,2346,564,1361,1549,0.4676975945017182,0.3589087809036658,0.9492671927846674,0.2565496786950074,0.7434503213049926,0.05073280721533258,0.5208784410763996
0.73,2910,"[[842, 1504], [45, 519]]",842,45,1504,45,887,2023,2346,564,1361,1549,0.4676975945017182,0.3589087809036658,0.9492671927846674,0.2565496786950074,0.7434503213049926,0.05073280721533258,0.5208784410763996
0.731,2910,"[[842, 1503], [45, 520]]",842,45,1503,45,887,2023,2345,565,1362,1548,0.46804123711340206,0.35906183368869937,0.9492671927846674,0.25704399406821554,0.7429560059317845,0.05073280721533258,0.5210396039603961
0.732,2910,"[[842, 1502], [45, 521]]",842,45,1502,45,887,2023,2344,566,1363,1547,0.4683848797250859,0.35921501706484643,0.9492671927846674,0.25753830944142364,0.7424616905585764,0.05073280721533258,0.5212008666047663
0.733,2910,"[[842, 1502], [45, 521]]",842,45,1502,45,887,2023,2344,566,1363,1547,0.4683848797250859,0.35921501706484643,0.9492671927846674,0.25753830944142364,0.7424616905585764,0.05073280721533258,0.5212008666047663
0.734,2910,"[[842, 1502], [45, 521]]",842,45,1502,45,887,2023,2344,566,1363,1547,0.4683848797250859,0.35921501706484643,0.9492671927846674,0.25753830944142364,0.7424616905585764,0.05073280721533258,0.5212008666047663
0.735,2910,"[[842, 1501], [45, 522]]",842,45,1501,45,887,2023,2343,567,1364,1546,0.46872852233676976,0.3593683311993171,0.9492671927846674,0.25803262481463174,0.7419673751853683,0.05073280721533258,0.5213622291021672
0.736,2910,"[[842, 1501], [45, 522]]",842,45,1501,45,887,2023,2343,567,1364,1546,0.46872852233676976,0.3593683311993171,0.9492671927846674,0.25803262481463174,0.7419673751853683,0.05073280721533258,0.5213622291021672
0.737,2910,"[[842, 1501], [45, 522]]",842,45,1501,45,887,2023,2343,567,1364,1546,0.46872852233676976,0.3593683311993171,0.9492671927846674,0.25803262481463174,0.7419673751853683,0.05073280721533258,0.5213622291021672
0.738,2910,"[[842, 1500], [45, 523]]",842,45,1500,45,887,2023,2342,568,1365,1545,0.4690721649484536,0.3595217762596072,0.9492671927846674,0.25852694018783984,0.7414730598121602,0.05073280721533258,0.52152369154537
0.739,2910,"[[842, 1500], [45, 523]]",842,45,1500,45,887,2023,2342,568,1365,1545,0.4690721649484536,0.3595217762596072,0.9492671927846674,0.25852694018783984,0.7414730598121602,0.05073280721533258,0.52152369154537
0.74,2910,"[[842, 1500], [45, 523]]",842,45,1500,45,887,2023,2342,568,1365,1545,0.4690721649484536,0.3595217762596072,0.9492671927846674,0.25852694018783984,0.7414730598121602,0.05073280721533258,0.52152369154537
0.741,2910,"[[842, 1499], [45, 524]]",842,45,1499,45,887,2023,2341,569,1366,1544,0.46941580756013745,0.3596753524134985,0.9492671927846674,0.25902125556104794,0.7409787444389521,0.05073280721533258,0.5216852540272615
0.742,2910,"[[842, 1499], [45, 524]]",842,45,1499,45,887,2023,2341,569,1366,1544,0.46941580756013745,0.3596753524134985,0.9492671927846674,0.25902125556104794,0.7409787444389521,0.05073280721533258,0.5216852540272615
0.743,2910,"[[842, 1499], [45, 524]]",842,45,1499,45,887,2023,2341,569,1366,1544,0.46941580756013745,0.3596753524134985,0.9492671927846674,0.25902125556104794,0.7409787444389521,0.05073280721533258,0.5216852540272615
0.744,2910,"[[842, 1499], [45, 524]]",842,45,1499,45,887,2023,2341,569,1366,1544,0.46941580756013745,0.3596753524134985,0.9492671927846674,0.25902125556104794,0.7409787444389521,0.05073280721533258,0.5216852540272615
0.745,2910,"[[842, 1498], [45, 525]]",842,45,1498,45,887,2023,2340,570,1367,1543,0.4697594501718213,0.3598290598290598,0.9492671927846674,0.25951557093425603,0.740484429065744,0.05073280721533258,0.5218469166408428
0.746,2910,"[[842, 1498], [45, 525]]",842,45,1498,45,887,2023,2340,570,1367,1543,0.4697594501718213,0.3598290598290598,0.9492671927846674,0.25951557093425603,0.740484429065744,0.05073280721533258,0.5218469166408428
0.747,2910,"[[842, 1498], [45, 525]]",842,45,1498,45,887,2023,2340,570,1367,1543,0.4697594501718213,0.3598290598290598,0.9492671927846674,0.25951557093425603,0.740484429065744,0.05073280721533258,0.5218469166408428
0.748,2910,"[[842, 1498], [45, 525]]",842,45,1498,45,887,2023,2340,570,1367,1543,0.4697594501718213,0.3598290598290598,0.9492671927846674,0.25951557093425603,0.740484429065744,0.05073280721533258,0.5218469166408428
0.749,2910,"[[842, 1498], [45, 525]]",842,45,1498,45,887,2023,2340,570,1367,1543,0.4697594501718213,0.3598290598290598,0.9492671927846674,0.25951557093425603,0.740484429065744,0.05073280721533258,0.5218469166408428
0.75,2910,"[[842, 1498], [45, 525]]",842,45,1498,45,887,2023,2340,570,1367,1543,0.4697594501718213,0.3598290598290598,0.9492671927846674,0.25951557093425603,0.740484429065744,0.05073280721533258,0.5218469166408428
0.751,2910,"[[842, 1497], [45, 526]]",842,45,1497,45,887,2023,2339,571,1368,1542,0.47010309278350515,0.3599828986746473,0.9492671927846674,0.2600098863074642,0.7399901136925359,0.05073280721533258,0.5220086794792311
0.752,2910,"[[841, 1497], [46, 526]]",841,46,1497,46,887,2023,2338,572,1367,1543,0.4697594501718213,0.35970915312232676,0.9481397970687712,0.2600098863074642,0.7399901136925359,0.05186020293122886,0.5215503875968992
0.753,2910,"[[841, 1495], [46, 528]]",841,46,1495,46,887,2023,2336,574,1369,1541,0.470446735395189,0.3600171232876712,0.9481397970687712,0.2609985170538804,0.7390014829461197,0.05186020293122886,0.5218740304064535
0.754,2910,"[[841, 1495], [46, 528]]",841,46,1495,46,887,2023,2336,574,1369,1541,0.470446735395189,0.3600171232876712,0.9481397970687712,0.2609985170538804,0.7390014829461197,0.05186020293122886,0.5218740304064535
0.755,2910,"[[841, 1494], [46, 529]]",841,46,1494,46,887,2023,2335,575,1370,1540,0.47079037800687284,0.3601713062098501,0.9481397970687712,0.2614928324270885,0.7385071675729116,0.05186020293122886,0.5220360024829298
0.756,2910,"[[841, 1494], [46, 529]]",841,46,1494,46,887,2023,2335,575,1370,1540,0.47079037800687284,0.3601713062098501,0.9481397970687712,0.2614928324270885,0.7385071675729116,0.05186020293122886,0.5220360024829298
0.757,2910,"[[841, 1494], [46, 529]]",841,46,1494,46,887,2023,2335,575,1370,1540,0.47079037800687284,0.3601713062098501,0.9481397970687712,0.2614928324270885,0.7385071675729116,0.05186020293122886,0.5220360024829298
0.758,2910,"[[841, 1494], [46, 529]]",841,46,1494,46,887,2023,2335,575,1370,1540,0.47079037800687284,0.3601713062098501,0.9481397970687712,0.2614928324270885,0.7385071675729116,0.05186020293122886,0.5220360024829298
0.759,2910,"[[841, 1494], [46, 529]]",841,46,1494,46,887,2023,2335,575,1370,1540,0.47079037800687284,0.3601713062098501,0.9481397970687712,0.2614928324270885,0.7385071675729116,0.05186020293122886,0.5220360024829298
0.76,2910,"[[840, 1494], [47, 529]]",840,47,1494,47,887,2023,2334,576,1369,1541,0.470446735395189,0.35989717223650386,0.9470124013528749,0.2614928324270885,0.7385071675729116,0.05298759864712514,0.5215771499534306
0.761,2910,"[[840, 1494], [47, 529]]",840,47,1494,47,887,2023,2334,576,1369,1541,0.470446735395189,0.35989717223650386,0.9470124013528749,0.2614928324270885,0.7385071675729116,0.05298759864712514,0.5215771499534306
0.762,2910,"[[840, 1493], [47, 530]]",840,47,1493,47,887,2023,2333,577,1370,1540,0.47079037800687284,0.3600514359194171,0.9470124013528749,0.2619871478002966,0.7380128521997034,0.05298759864712514,0.5217391304347826
0.763,2910,"[[840, 1493], [47, 530]]",840,47,1493,47,887,2023,2333,577,1370,1540,0.47079037800687284,0.3600514359194171,0.9470124013528749,0.2619871478002966,0.7380128521997034,0.05298759864712514,0.5217391304347826
0.764,2910,"[[840, 1493], [47, 530]]",840,47,1493,47,887,2023,2333,577,1370,1540,0.47079037800687284,0.3600514359194171,0.9470124013528749,0.2619871478002966,0.7380128521997034,0.05298759864712514,0.5217391304347826
0.765,2910,"[[840, 1493], [47, 530]]",840,47,1493,47,887,2023,2333,577,1370,1540,0.47079037800687284,0.3600514359194171,0.9470124013528749,0.2619871478002966,0.7380128521997034,0.05298759864712514,0.5217391304347826
0.766,2910,"[[840, 1493], [47, 530]]",840,47,1493,47,887,2023,2333,577,1370,1540,0.47079037800687284,0.3600514359194171,0.9470124013528749,0.2619871478002966,0.7380128521997034,0.05298759864712514,0.5217391304347826
0.767,2910,"[[840, 1490], [47, 533]]",840,47,1490,47,887,2023,2330,580,1373,1537,0.4718213058419244,0.3605150214592275,0.9470124013528749,0.26347009391992093,0.7365299060800791,0.05298759864712514,0.5222256760957414
0.768,2910,"[[840, 1490], [47, 533]]",840,47,1490,47,887,2023,2330,580,1373,1537,0.4718213058419244,0.3605150214592275,0.9470124013528749,0.26347009391992093,0.7365299060800791,0.05298759864712514,0.5222256760957414
0.769,2910,"[[840, 1489], [47, 534]]",840,47,1489,47,887,2023,2329,581,1374,1536,0.47216494845360824,0.360669815371404,0.9470124013528749,0.26396440929312903,0.736035590706871,0.05298759864712514,0.5223880597014925
0.77,2910,"[[840, 1488], [47, 535]]",840,47,1488,47,887,2023,2328,582,1375,1535,0.4725085910652921,0.36082474226804123,0.9470124013528749,0.26445872466633713,0.7355412753336629,0.05298759864712514,0.5225505443234836
0.771,2910,"[[840, 1488], [47, 535]]",840,47,1488,47,887,2023,2328,582,1375,1535,0.4725085910652921,0.36082474226804123,0.9470124013528749,0.26445872466633713,0.7355412753336629,0.05298759864712514,0.5225505443234836
0.772,2910,"[[840, 1486], [47, 537]]",840,47,1486,47,887,2023,2326,584,1377,1533,0.4731958762886598,0.36113499570077384,0.9470124013528749,0.2654473554127533,0.7345526445872467,0.05298759864712514,0.522875816993464
0.773,2910,"[[840, 1486], [47, 537]]",840,47,1486,47,887,2023,2326,584,1377,1533,0.4731958762886598,0.36113499570077384,0.9470124013528749,0.2654473554127533,0.7345526445872467,0.05298759864712514,0.522875816993464
0.774,2910,"[[840, 1486], [47, 537]]",840,47,1486,47,887,2023,2326,584,1377,1533,0.4731958762886598,0.36113499570077384,0.9470124013528749,0.2654473554127533,0.7345526445872467,0.05298759864712514,0.522875816993464
0.775,2910,"[[840, 1484], [47, 539]]",840,47,1484,47,887,2023,2324,586,1379,1531,0.4738831615120275,0.3614457831325301,0.9470124013528749,0.2664359861591695,0.7335640138408305,0.05298759864712514,0.5232014948614139
0.776,2910,"[[840, 1484], [47, 539]]",840,47,1484,47,887,2023,2324,586,1379,1531,0.4738831615120275,0.3614457831325301,0.9470124013528749,0.2664359861591695,0.7335640138408305,0.05298759864712514,0.5232014948614139
0.777,2910,"[[840, 1482], [47, 541]]",840,47,1482,47,887,2023,2322,588,1381,1529,0.47457044673539517,0.36175710594315247,0.9470124013528749,0.2674246169055858,0.7325753830944143,0.05298759864712514,0.5235275786849486
0.778,2910,"[[840, 1482], [47, 541]]",840,47,1482,47,887,2023,2322,588,1381,1529,0.47457044673539517,0.36175710594315247,0.9470124013528749,0.2674246169055858,0.7325753830944143,0.05298759864712514,0.5235275786849486
0.779,2910,"[[839, 1481], [48, 542]]",839,48,1481,48,887,2023,2320,590,1381,1529,0.47457044673539517,0.3616379310344828,0.9458850056369785,0.2679189322787939,0.7320810677212062,0.05411499436302142,0.5232304334268787
0.78,2910,"[[839, 1480], [48, 543]]",839,48,1480,48,887,2023,2319,591,1382,1528,0.474914089347079,0.3617938766709789,0.9458850056369785,0.268413247652002,0.731586752347998,0.05411499436302142,0.5233936369307548
0.781,2910,"[[839, 1479], [48, 544]]",839,48,1479,48,887,2023,2318,592,1383,1527,0.47525773195876286,0.36194995685936154,0.9458850056369785,0.2689075630252101,0.7310924369747899,0.05411499436302142,0.5235569422776911
0.782,2910,"[[838, 1478], [49, 545]]",838,49,1478,49,887,2023,2316,594,1383,1527,0.47525773195876286,0.36183074265975823,0.9447576099210823,0.26940187839841817,0.7305981216015818,0.0552423900789177,0.5232594442709959
0.783,2910,"[[838, 1477], [49, 546]]",838,49,1477,49,887,2023,2315,595,1384,1526,0.4756013745704467,0.3619870410367171,0.9447576099210823,0.2698961937716263,0.7301038062283737,0.0552423900789177,0.523422860712055
0.784,2910,"[[838, 1477], [49, 546]]",838,49,1477,49,887,2023,2315,595,1384,1526,0.4756013745704467,0.3619870410367171,0.9447576099210823,0.2698961937716263,0.7301038062283737,0.0552423900789177,0.523422860712055
0.785,2910,"[[838, 1476], [49, 547]]",838,49,1476,49,887,2023,2314,596,1385,1525,0.47594501718213056,0.3621434745030251,0.9447576099210823,0.2703905091448344,0.7296094908551656,0.0552423900789177,0.5235863792564824
0.786,2910,"[[837, 1476], [50, 547]]",837,50,1476,50,887,2023,2313,597,1384,1526,0.4756013745704467,0.36186770428015563,0.943630214205186,0.2703905091448344,0.7296094908551656,0.05636978579481398,0.523125
0.787,2910,"[[837, 1476], [50, 547]]",837,50,1476,50,887,2023,2313,597,1384,1526,0.4756013745704467,0.36186770428015563,0.943630214205186,0.2703905091448344,0.7296094908551656,0.05636978579481398,0.523125
0.788,2910,"[[837, 1476], [50, 547]]",837,50,1476,50,887,2023,2313,597,1384,1526,0.4756013745704467,0.36186770428015563,0.943630214205186,0.2703905091448344,0.7296094908551656,0.05636978579481398,0.523125
0.789,2910,"[[837, 1476], [50, 547]]",837,50,1476,50,887,2023,2313,597,1384,1526,0.4756013745704467,0.36186770428015563,0.943630214205186,0.2703905091448344,0.7296094908551656,0.05636978579481398,0.523125
0.79,2910,"[[836, 1476], [51, 547]]",836,51,1476,51,887,2023,2312,598,1383,1527,0.47525773195876286,0.3615916955017301,0.9425028184892897,0.2703905091448344,0.7296094908551656,0.05749718151071026,0.5226633322913411
0.791,2910,"[[836, 1475], [51, 548]]",836,51,1475,51,887,2023,2311,599,1384,1526,0.4756013745704467,0.36174816096927737,0.9425028184892897,0.2708848245180425,0.7291151754819575,0.05749718151071026,0.5228267667292058
0.792,2910,"[[835, 1475], [52, 548]]",835,52,1475,52,887,2023,2310,600,1383,1527,0.47525773195876286,0.36147186147186144,0.9413754227733935,0.2708848245180425,0.7291151754819575,0.058624577226606536,0.5223647169221145
0.793,2910,"[[835, 1475], [52, 548]]",835,52,1475,52,887,2023,2310,600,1383,1527,0.47525773195876286,0.36147186147186144,0.9413754227733935,0.2708848245180425,0.7291151754819575,0.058624577226606536,0.5223647169221145
0.794,2910,"[[835, 1475], [52, 548]]",835,52,1475,52,887,2023,2310,600,1383,1527,0.47525773195876286,0.36147186147186144,0.9413754227733935,0.2708848245180425,0.7291151754819575,0.058624577226606536,0.5223647169221145
0.795,2910,"[[835, 1475], [52, 548]]",835,52,1475,52,887,2023,2310,600,1383,1527,0.47525773195876286,0.36147186147186144,0.9413754227733935,0.2708848245180425,0.7291151754819575,0.058624577226606536,0.5223647169221145
0.796,2910,"[[835, 1475], [52, 548]]",835,52,1475,52,887,2023,2310,600,1383,1527,0.47525773195876286,0.36147186147186144,0.9413754227733935,0.2708848245180425,0.7291151754819575,0.058624577226606536,0.5223647169221145
0.797,2910,"[[834, 1470], [53, 553]]",834,53,1470,53,887,2023,2304,606,1387,1523,0.4766323024054983,0.3619791666666667,0.9402480270574972,0.27335640138408307,0.726643598615917,0.05975197294250282,0.522720150423065
0.798,2910,"[[834, 1470], [53, 553]]",834,53,1470,53,887,2023,2304,606,1387,1523,0.4766323024054983,0.3619791666666667,0.9402480270574972,0.27335640138408307,0.726643598615917,0.05975197294250282,0.522720150423065
0.799,2910,"[[834, 1469], [53, 554]]",834,53,1469,53,887,2023,2303,607,1388,1522,0.47697594501718216,0.36213634389926186,0.9402480270574972,0.27385071675729117,0.7261492832427089,0.05975197294250282,0.5228840125391849
0.8,2910,"[[834, 1468], [53, 555]]",834,53,1468,53,887,2023,2302,608,1389,1521,0.477319587628866,0.3622936576889661,0.9402480270574972,0.27434503213049927,0.7256549678695008,0.05975197294250282,0.5230479774223895
0.801,2910,"[[833, 1468], [54, 555]]",833,54,1468,54,887,2023,2301,609,1388,1522,0.47697594501718216,0.36201651455888745,0.939120631341601,0.27434503213049927,0.7256549678695008,0.060879368658399095,0.5225846925972396
0.802,2910,"[[833, 1468], [54, 555]]",833,54,1468,54,887,2023,2301,609,1388,1522,0.47697594501718216,0.36201651455888745,0.939120631341601,0.27434503213049927,0.7256549678695008,0.060879368658399095,0.5225846925972396
0.803,2910,"[[833, 1468], [54, 555]]",833,54,1468,54,887,2023,2301,609,1388,1522,0.47697594501718216,0.36201651455888745,0.939120631341601,0.27434503213049927,0.7256549678695008,0.060879368658399095,0.5225846925972396
0.804,2910,"[[833, 1468], [54, 555]]",833,54,1468,54,887,2023,2301,609,1388,1522,0.47697594501718216,0.36201651455888745,0.939120631341601,0.27434503213049927,0.7256549678695008,0.060879368658399095,0.5225846925972396
0.805,2910,"[[833, 1468], [54, 555]]",833,54,1468,54,887,2023,2301,609,1388,1522,0.47697594501718216,0.36201651455888745,0.939120631341601,0.27434503213049927,0.7256549678695008,0.060879368658399095,0.5225846925972396
0.806,2910,"[[833, 1468], [54, 555]]",833,54,1468,54,887,2023,2301,609,1388,1522,0.47697594501718216,0.36201651455888745,0.939120631341601,0.27434503213049927,0.7256549678695008,0.060879368658399095,0.5225846925972396
0.807,2910,"[[833, 1468], [54, 555]]",833,54,1468,54,887,2023,2301,609,1388,1522,0.47697594501718216,0.36201651455888745,0.939120631341601,0.27434503213049927,0.7256549678695008,0.060879368658399095,0.5225846925972396
0.808,2910,"[[833, 1466], [54, 557]]",833,54,1466,54,887,2023,2299,611,1390,1520,0.47766323024054985,0.36233144845585036,0.939120631341601,0.27533366287691546,0.7246663371230845,0.060879368658399095,0.5229127432517263
0.809,2910,"[[833, 1466], [54, 557]]",833,54,1466,54,887,2023,2299,611,1390,1520,0.47766323024054985,0.36233144845585036,0.939120631341601,0.27533366287691546,0.7246663371230845,0.060879368658399095,0.5229127432517263
0.81,2910,"[[833, 1466], [54, 557]]",833,54,1466,54,887,2023,2299,611,1390,1520,0.47766323024054985,0.36233144845585036,0.939120631341601,0.27533366287691546,0.7246663371230845,0.060879368658399095,0.5229127432517263
0.811,2910,"[[833, 1466], [54, 557]]",833,54,1466,54,887,2023,2299,611,1390,1520,0.47766323024054985,0.36233144845585036,0.939120631341601,0.27533366287691546,0.7246663371230845,0.060879368658399095,0.5229127432517263
0.812,2910,"[[831, 1465], [56, 558]]",831,56,1465,56,887,2023,2296,614,1389,1521,0.477319587628866,0.36193379790940766,0.9368658399098083,0.27582797825012356,0.7241720217498764,0.06313416009019165,0.5221489161168709
0.813,2910,"[[831, 1464], [56, 559]]",831,56,1464,56,887,2023,2295,615,1390,1520,0.47766323024054985,0.36209150326797385,0.9368658399098083,0.27632229362333166,0.7236777063766683,0.06313416009019165,0.5223130106851037
0.814,2910,"[[831, 1464], [56, 559]]",831,56,1464,56,887,2023,2295,615,1390,1520,0.47766323024054985,0.36209150326797385,0.9368658399098083,0.27632229362333166,0.7236777063766683,0.06313416009019165,0.5223130106851037
0.815,2910,"[[831, 1464], [56, 559]]",831,56,1464,56,887,2023,2295,615,1390,1520,0.47766323024054985,0.36209150326797385,0.9368658399098083,0.27632229362333166,0.7236777063766683,0.06313416009019165,0.5223130106851037
0.816,2910,"[[831, 1464], [56, 559]]",831,56,1464,56,887,2023,2295,615,1390,1520,0.47766323024054985,0.36209150326797385,0.9368658399098083,0.27632229362333166,0.7236777063766683,0.06313416009019165,0.5223130106851037
0.817,2910,"[[831, 1464], [56, 559]]",831,56,1464,56,887,2023,2295,615,1390,1520,0.47766323024054985,0.36209150326797385,0.9368658399098083,0.27632229362333166,0.7236777063766683,0.06313416009019165,0.5223130106851037
0.818,2910,"[[831, 1463], [56, 560]]",831,56,1463,56,887,2023,2294,616,1391,1519,0.4780068728522337,0.36224934612031384,0.9368658399098083,0.2768166089965398,0.7231833910034602,0.06313416009019165,0.5224772084250235
0.819,2910,"[[831, 1463], [56, 560]]",831,56,1463,56,887,2023,2294,616,1391,1519,0.4780068728522337,0.36224934612031384,0.9368658399098083,0.2768166089965398,0.7231833910034602,0.06313416009019165,0.5224772084250235
0.82,2910,"[[831, 1462], [56, 561]]",831,56,1462,56,887,2023,2293,617,1392,1518,0.47835051546391755,0.36240732664631486,0.9368658399098083,0.2773109243697479,0.7226890756302521,0.06313416009019165,0.5226415094339623
0.821,2910,"[[831, 1461], [56, 562]]",831,56,1461,56,887,2023,2292,618,1393,1517,0.4786941580756014,0.362565445026178,0.9368658399098083,0.277805239742956,0.722194760257044,0.06313416009019165,0.5228059138093739
0.822,2910,"[[831, 1461], [56, 562]]",831,56,1461,56,887,2023,2292,618,1393,1517,0.4786941580756014,0.362565445026178,0.9368658399098083,0.277805239742956,0.722194760257044,0.06313416009019165,0.5228059138093739
0.823,2910,"[[831, 1461], [56, 562]]",831,56,1461,56,887,2023,2292,618,1393,1517,0.4786941580756014,0.362565445026178,0.9368658399098083,0.277805239742956,0.722194760257044,0.06313416009019165,0.5228059138093739
0.824,2910,"[[831, 1460], [56, 563]]",831,56,1460,56,887,2023,2291,619,1394,1516,0.47903780068728524,0.36272370144041904,0.9368658399098083,0.2782995551161641,0.7217004448838359,0.06313416009019165,0.5229704216488357
0.825,2910,"[[830, 1460], [57, 563]]",830,57,1460,57,887,2023,2290,620,1393,1517,0.4786941580756014,0.3624454148471616,0.9357384441939121,0.2782995551161641,0.7217004448838359,0.06426155580608793,0.5225055083412024
0.826,2910,"[[830, 1460], [57, 563]]",830,57,1460,57,887,2023,2290,620,1393,1517,0.4786941580756014,0.3624454148471616,0.9357384441939121,0.2782995551161641,0.7217004448838359,0.06426155580608793,0.5225055083412024
0.827,2910,"[[830, 1460], [57, 563]]",830,57,1460,57,887,2023,2290,620,1393,1517,0.4786941580756014,0.3624454148471616,0.9357384441939121,0.2782995551161641,0.7217004448838359,0.06426155580608793,0.5225055083412024
0.828,2910,"[[830, 1460], [57, 563]]",830,57,1460,57,887,2023,2290,620,1393,1517,0.4786941580756014,0.3624454148471616,0.9357384441939121,0.2782995551161641,0.7217004448838359,0.06426155580608793,0.5225055083412024
0.829,2910,"[[830, 1459], [57, 564]]",830,57,1459,57,887,2023,2289,621,1394,1516,0.47903780068728524,0.3626037570991699,0.9357384441939121,0.2787938704893722,0.7212061295106278,0.06426155580608793,0.5226700251889168
0.83,2910,"[[830, 1458], [57, 565]]",830,57,1458,57,887,2023,2288,622,1395,1515,0.4793814432989691,0.36276223776223776,0.9357384441939121,0.2792881858625803,0.7207118141374197,0.06426155580608793,0.5228346456692914
0.831,2910,"[[830, 1458], [57, 565]]",830,57,1458,57,887,2023,2288,622,1395,1515,0.4793814432989691,0.36276223776223776,0.9357384441939121,0.2792881858625803,0.7207118141374197,0.06426155580608793,0.5228346456692914
0.832,2910,"[[830, 1457], [57, 566]]",830,57,1457,57,887,2023,2287,623,1396,1514,0.47972508591065294,0.3629208570179274,0.9357384441939121,0.2797825012357884,0.7202174987642116,0.06426155580608793,0.5229993698802772
0.833,2910,"[[830, 1457], [57, 566]]",830,57,1457,57,887,2023,2287,623,1396,1514,0.47972508591065294,0.3629208570179274,0.9357384441939121,0.2797825012357884,0.7202174987642116,0.06426155580608793,0.5229993698802772
0.834,2910,"[[830, 1457], [57, 566]]",830,57,1457,57,887,2023,2287,623,1396,1514,0.47972508591065294,0.3629208570179274,0.9357384441939121,0.2797825012357884,0.7202174987642116,0.06426155580608793,0.5229993698802772
0.835,2910,"[[830, 1457], [57, 566]]",830,57,1457,57,887,2023,2287,623,1396,1514,0.47972508591065294,0.3629208570179274,0.9357384441939121,0.2797825012357884,0.7202174987642116,0.06426155580608793,0.5229993698802772
0.836,2910,"[[830, 1457], [57, 566]]",830,57,1457,57,887,2023,2287,623,1396,1514,0.47972508591065294,0.3629208570179274,0.9357384441939121,0.2797825012357884,0.7202174987642116,0.06426155580608793,0.5229993698802772
0.837,2910,"[[830, 1455], [57, 568]]",830,57,1455,57,887,2023,2285,625,1398,1512,0.48041237113402063,0.36323851203501095,0.9357384441939121,0.28077113198220466,0.7192288680177954,0.06426155580608793,0.5233291298865069
0.838,2910,"[[830, 1455], [57, 568]]",830,57,1455,57,887,2023,2285,625,1398,1512,0.48041237113402063,0.36323851203501095,0.9357384441939121,0.28077113198220466,0.7192288680177954,0.06426155580608793,0.5233291298865069
0.839,2910,"[[829, 1453], [58, 570]]",829,58,1453,58,887,2023,2282,628,1399,1511,0.4807560137457045,0.3632778264680105,0.9346110484780158,0.28175976272862086,0.7182402372713791,0.06538895152198422,0.5231934364152729
0.84,2910,"[[829, 1452], [58, 571]]",829,58,1452,58,887,2023,2281,629,1400,1510,0.48109965635738833,0.36343708899605437,0.9346110484780158,0.28225407810182895,0.717745921898171,0.06538895152198422,0.5233585858585859
0.841,2910,"[[829, 1451], [58, 572]]",829,58,1451,58,887,2023,2280,630,1401,1509,0.4814432989690722,0.3635964912280702,0.9346110484780158,0.28274839347503705,0.7172516065249629,0.06538895152198422,0.523523839595832
0.842,2910,"[[828, 1449], [59, 574]]",828,59,1449,59,887,2023,2277,633,1402,1508,0.481786941580756,0.36363636363636365,0.9334836527621195,0.2837370242214533,0.7162629757785467,0.0665163472378805,0.5233881163084704
0.843,2910,"[[828, 1448], [59, 575]]",828,59,1448,59,887,2023,2276,634,1403,1507,0.48213058419243987,0.36379613356766255,0.9334836527621195,0.2842313395946614,0.7157686604053386,0.0665163472378805,0.5235535883654758
0.844,2910,"[[828, 1448], [59, 575]]",828,59,1448,59,887,2023,2276,634,1403,1507,0.48213058419243987,0.36379613356766255,0.9334836527621195,0.2842313395946614,0.7157686604053386,0.0665163472378805,0.5235535883654758
0.845,2910,"[[828, 1446], [59, 577]]",828,59,1446,59,887,2023,2274,636,1405,1505,0.48281786941580757,0.3641160949868074,0.9334836527621195,0.2852199703410776,0.7147800296589224,0.0665163472378805,0.523884846567542
0.846,2910,"[[828, 1445], [59, 578]]",828,59,1445,59,887,2023,2273,637,1406,1504,0.4831615120274914,0.36427628684557856,0.9334836527621195,0.2857142857142857,0.7142857142857143,0.0665163472378805,0.5240506329113924
0.847,2910,"[[828, 1444], [59, 579]]",828,59,1444,59,887,2023,2272,638,1407,1503,0.48350515463917526,0.3644366197183099,0.9334836527621195,0.2862086010874938,0.7137913989125062,0.0665163472378805,0.5242165242165243
0.848,2910,"[[826, 1444], [61, 579]]",826,61,1444,61,887,2023,2270,640,1405,1505,0.48281786941580757,0.36387665198237884,0.9312288613303269,0.2862086010874938,0.7137913989125062,0.06877113866967305,0.5232815964523282
0.849,2910,"[[825, 1443], [62, 580]]",825,62,1443,62,887,2023,2268,642,1405,1505,0.48281786941580757,0.3637566137566138,0.9301014656144306,0.28670291646070195,0.7132970835392981,0.06989853438556934,0.5229793977812995
0.85,2910,"[[825, 1442], [62, 581]]",825,62,1442,62,887,2023,2267,643,1406,1504,0.4831615120274914,0.3639170710189678,0.9301014656144306,0.28719723183391005,0.71280276816609,0.06989853438556934,0.523145212428662
0.851,2910,"[[824, 1442], [63, 581]]",824,63,1442,63,887,2023,2266,644,1405,1505,0.48281786941580757,0.36363636363636365,0.9289740698985344,0.28719723183391005,0.71280276816609,0.07102593010146561,0.5226768157310497
0.852,2910,"[[824, 1441], [63, 582]]",824,63,1441,63,887,2023,2265,645,1406,1504,0.4831615120274914,0.3637969094922737,0.9289740698985344,0.28769154720711815,0.7123084527928819,0.07102593010146561,0.5228426395939086
0.853,2910,"[[824, 1441], [63, 582]]",824,63,1441,63,887,2023,2265,645,1406,1504,0.4831615120274914,0.3637969094922737,0.9289740698985344,0.28769154720711815,0.7123084527928819,0.07102593010146561,0.5228426395939086
0.854,2910,"[[824, 1438], [63, 585]]",824,63,1438,63,887,2023,2262,648,1409,1501,0.48419243986254296,0.36427939876215737,0.9289740698985344,0.28917449332674244,0.7108255066732575,0.07102593010146561,0.5233407430930453
0.855,2910,"[[824, 1438], [63, 585]]",824,63,1438,63,887,2023,2262,648,1409,1501,0.48419243986254296,0.36427939876215737,0.9289740698985344,0.28917449332674244,0.7108255066732575,0.07102593010146561,0.5233407430930453
0.856,2910,"[[824, 1438], [63, 585]]",824,63,1438,63,887,2023,2262,648,1409,1501,0.48419243986254296,0.36427939876215737,0.9289740698985344,0.28917449332674244,0.7108255066732575,0.07102593010146561,0.5233407430930453
0.857,2910,"[[824, 1436], [63, 587]]",824,63,1436,63,887,2023,2260,650,1411,1499,0.48487972508591065,0.36460176991150445,0.9289740698985344,0.2901631240731587,0.7098368759268413,0.07102593010146561,0.5236733396885923
0.858,2910,"[[824, 1436], [63, 587]]",824,63,1436,63,887,2023,2260,650,1411,1499,0.48487972508591065,0.36460176991150445,0.9289740698985344,0.2901631240731587,0.7098368759268413,0.07102593010146561,0.5236733396885923
0.859,2910,"[[824, 1436], [63, 587]]",824,63,1436,63,887,2023,2260,650,1411,1499,0.48487972508591065,0.36460176991150445,0.9289740698985344,0.2901631240731587,0.7098368759268413,0.07102593010146561,0.5236733396885923
0.86,2910,"[[824, 1435], [63, 588]]",824,63,1435,63,887,2023,2259,651,1412,1498,0.4852233676975945,0.36476316954404603,0.9289740698985344,0.2906574394463668,0.7093425605536332,0.07102593010146561,0.5238397965670694
0.861,2910,"[[824, 1435], [63, 588]]",824,63,1435,63,887,2023,2259,651,1412,1498,0.4852233676975945,0.36476316954404603,0.9289740698985344,0.2906574394463668,0.7093425605536332,0.07102593010146561,0.5238397965670694
0.862,2910,"[[824, 1435], [63, 588]]",824,63,1435,63,887,2023,2259,651,1412,1498,0.4852233676975945,0.36476316954404603,0.9289740698985344,0.2906574394463668,0.7093425605536332,0.07102593010146561,0.5238397965670694
0.863,2910,"[[824, 1435], [63, 588]]",824,63,1435,63,887,2023,2259,651,1412,1498,0.4852233676975945,0.36476316954404603,0.9289740698985344,0.2906574394463668,0.7093425605536332,0.07102593010146561,0.5238397965670694
0.864,2910,"[[824, 1435], [63, 588]]",824,63,1435,63,887,2023,2259,651,1412,1498,0.4852233676975945,0.36476316954404603,0.9289740698985344,0.2906574394463668,0.7093425605536332,0.07102593010146561,0.5238397965670694
0.865,2910,"[[824, 1435], [63, 588]]",824,63,1435,63,887,2023,2259,651,1412,1498,0.4852233676975945,0.36476316954404603,0.9289740698985344,0.2906574394463668,0.7093425605536332,0.07102593010146561,0.5238397965670694
0.866,2910,"[[824, 1435], [63, 588]]",824,63,1435,63,887,2023,2259,651,1412,1498,0.4852233676975945,0.36476316954404603,0.9289740698985344,0.2906574394463668,0.7093425605536332,0.07102593010146561,0.5238397965670694
0.867,2910,"[[824, 1434], [63, 589]]",824,63,1434,63,887,2023,2258,652,1413,1497,0.48556701030927835,0.3649247121346324,0.9289740698985344,0.2911517548195749,0.7088482451804251,0.07102593010146561,0.524006359300477
0.868,2910,"[[824, 1432], [63, 591]]",824,63,1432,63,887,2023,2256,654,1415,1495,0.48625429553264604,0.36524822695035464,0.9289740698985344,0.2921403855659911,0.7078596144340089,0.07102593010146561,0.5243398027362393
0.869,2910,"[[824, 1432], [63, 591]]",824,63,1432,63,887,2023,2256,654,1415,1495,0.48625429553264604,0.36524822695035464,0.9289740698985344,0.2921403855659911,0.7078596144340089,0.07102593010146561,0.5243398027362393
0.87,2910,"[[824, 1431], [63, 592]]",824,63,1431,63,887,2023,2255,655,1416,1494,0.4865979381443299,0.365410199556541,0.9289740698985344,0.2926347009391992,0.7073652990608008,0.07102593010146561,0.5245066836409931
0.871,2910,"[[824, 1431], [63, 592]]",824,63,1431,63,887,2023,2255,655,1416,1494,0.4865979381443299,0.365410199556541,0.9289740698985344,0.2926347009391992,0.7073652990608008,0.07102593010146561,0.5245066836409931
0.872,2910,"[[824, 1430], [63, 593]]",824,63,1430,63,887,2023,2254,656,1417,1493,0.48694158075601374,0.36557231588287487,0.9289740698985344,0.29312901631240734,0.7068709836875927,0.07102593010146561,0.5246736708054759
0.873,2910,"[[824, 1429], [63, 594]]",824,63,1429,63,887,2023,2253,657,1418,1492,0.4872852233676976,0.3657345761207279,0.9289740698985344,0.29362333168561544,0.7063766683143846,0.07102593010146561,0.5248407643312102
0.874,2910,"[[824, 1427], [63, 596]]",824,63,1427,63,887,2023,2251,659,1420,1490,0.4879725085910653,0.36605952909817857,0.9289740698985344,0.29461196243203164,0.7053880375679684,0.07102593010146561,0.5251752708731676
0.875,2910,"[[824, 1426], [63, 597]]",824,63,1426,63,887,2023,2250,660,1421,1489,0.4883161512027491,0.3662222222222222,0.9289740698985344,0.29510627780523974,0.7048937221947602,0.07102593010146561,0.5253426840930825
0.876,2910,"[[824, 1423], [63, 600]]",824,63,1423,63,887,2023,2247,663,1424,1486,0.48934707903780067,0.3667111704494882,0.9289740698985344,0.2965892239248641,0.7034107760751359,0.07102593010146561,0.5258455647734525
0.877,2910,"[[824, 1423], [63, 600]]",824,63,1423,63,887,2023,2247,663,1424,1486,0.48934707903780067,0.3667111704494882,0.9289740698985344,0.2965892239248641,0.7034107760751359,0.07102593010146561,0.5258455647734525
0.878,2910,"[[824, 1422], [63, 601]]",824,63,1422,63,887,2023,2246,664,1425,1485,0.4896907216494845,0.3668744434550312,0.9289740698985344,0.2970835392980722,0.7029164607019278,0.07102593010146561,0.5260134056814555
0.879,2910,"[[823, 1421], [64, 602]]",823,64,1421,64,887,2023,2244,666,1425,1485,0.4896907216494845,0.36675579322638147,0.9278466741826381,0.2975778546712803,0.7024221453287197,0.07215332581736189,0.525710635579687
0.88,2910,"[[823, 1420], [64, 603]]",823,64,1420,64,887,2023,2243,667,1426,1484,0.49003436426116836,0.3669193045028979,0.9278466741826381,0.2980721700444884,0.7019278299555116,0.07215332581736189,0.5258785942492012
0.881,2910,"[[823, 1420], [64, 603]]",823,64,1420,64,887,2023,2243,667,1426,1484,0.49003436426116836,0.3669193045028979,0.9278466741826381,0.2980721700444884,0.7019278299555116,0.07215332581736189,0.5258785942492012
0.882,2910,"[[823, 1419], [64, 604]]",823,64,1419,64,887,2023,2242,668,1427,1483,0.4903780068728522,0.3670829616413916,0.9278466741826381,0.2985664854176965,0.7014335145823035,0.07215332581736189,0.5260466602748481
0.883,2910,"[[823, 1417], [64, 606]]",823,64,1417,64,887,2023,2240,670,1429,1481,0.4910652920962199,0.3674107142857143,0.9278466741826381,0.2995551161641127,0.7004448838358873,0.07215332581736189,0.5263831148065239
0.884,2910,"[[822, 1416], [65, 607]]",822,65,1416,65,887,2023,2238,672,1429,1481,0.4910652920962199,0.3672922252010724,0.9267192784667418,0.30004943153732083,0.6999505684626792,0.07328072153325817,0.52608
0.885,2910,"[[822, 1416], [65, 607]]",822,65,1416,65,887,2023,2238,672,1429,1481,0.4910652920962199,0.3672922252010724,0.9267192784667418,0.30004943153732083,0.6999505684626792,0.07328072153325817,0.52608
0.886,2910,"[[822, 1415], [65, 608]]",822,65,1415,65,887,2023,2237,673,1430,1480,0.49140893470790376,0.3674564148413053,0.9267192784667418,0.30054374691052893,0.6994562530894711,0.07328072153325817,0.5262483994878362
0.887,2910,"[[822, 1415], [65, 608]]",822,65,1415,65,887,2023,2237,673,1430,1480,0.49140893470790376,0.3674564148413053,0.9267192784667418,0.30054374691052893,0.6994562530894711,0.07328072153325817,0.5262483994878362
0.888,2910,"[[821, 1411], [66, 612]]",821,66,1411,66,887,2023,2232,678,1433,1477,0.49243986254295535,0.367831541218638,0.9255918827508456,0.3025210084033613,0.6974789915966386,0.07440811724915446,0.5264507855081757
0.889,2910,"[[820, 1409], [67, 614]]",820,67,1409,67,887,2023,2229,681,1434,1476,0.4927835051546392,0.36787797218483625,0.9244644870349493,0.3035096391497776,0.6964903608502224,0.07553551296505073,0.5263157894736842
0.89,2910,"[[820, 1409], [67, 614]]",820,67,1409,67,887,2023,2229,681,1434,1476,0.4927835051546392,0.36787797218483625,0.9244644870349493,0.3035096391497776,0.6964903608502224,0.07553551296505073,0.5263157894736842
0.891,2910,"[[820, 1408], [67, 615]]",820,67,1408,67,887,2023,2228,682,1435,1475,0.49312714776632305,0.36804308797127466,0.9244644870349493,0.3040039545229857,0.6959960454770143,0.07553551296505073,0.5264847512038523
0.892,2910,"[[820, 1406], [67, 617]]",820,67,1406,67,887,2023,2226,684,1437,1473,0.49381443298969074,0.3683737646001797,0.9244644870349493,0.3049925852694019,0.6950074147305981,0.07553551296505073,0.5268230003212336
0.893,2910,"[[820, 1406], [67, 617]]",820,67,1406,67,887,2023,2226,684,1437,1473,0.49381443298969074,0.3683737646001797,0.9244644870349493,0.3049925852694019,0.6950074147305981,0.07553551296505073,0.5268230003212336
0.894,2910,"[[820, 1403], [67, 620]]",820,67,1403,67,887,2023,2223,687,1440,1470,0.4948453608247423,0.36887089518668464,0.9244644870349493,0.3064755313890262,0.6935244686109738,0.07553551296505073,0.5273311897106109
0.895,2910,"[[820, 1403], [67, 620]]",820,67,1403,67,887,2023,2223,687,1440,1470,0.4948453608247423,0.36887089518668464,0.9244644870349493,0.3064755313890262,0.6935244686109738,0.07553551296505073,0.5273311897106109
0.896,2910,"[[820, 1400], [67, 623]]",820,67,1400,67,887,2023,2220,690,1443,1467,0.49587628865979383,0.36936936936936937,0.9244644870349493,0.3079584775086505,0.6920415224913494,0.07553551296505073,0.5278403604763436
0.897,2910,"[[820, 1398], [67, 625]]",820,67,1398,67,887,2023,2218,692,1445,1465,0.4965635738831615,0.369702434625789,0.9244644870349493,0.3089471082550667,0.6910528917449332,0.07553551296505073,0.5281803542673108
0.898,2910,"[[820, 1398], [67, 625]]",820,67,1398,67,887,2023,2218,692,1445,1465,0.4965635738831615,0.369702434625789,0.9244644870349493,0.3089471082550667,0.6910528917449332,0.07553551296505073,0.5281803542673108
0.899,2910,"[[820, 1398], [67, 625]]",820,67,1398,67,887,2023,2218,692,1445,1465,0.4965635738831615,0.369702434625789,0.9244644870349493,0.3089471082550667,0.6910528917449332,0.07553551296505073,0.5281803542673108
0.9,2910,"[[820, 1396], [67, 627]]",820,67,1396,67,887,2023,2216,694,1447,1463,0.4972508591065292,0.3700361010830325,0.9244644870349493,0.30993573900148297,0.690064260998517,0.07553551296505073,0.528520786335804
0.901,2910,"[[820, 1396], [67, 627]]",820,67,1396,67,887,2023,2216,694,1447,1463,0.4972508591065292,0.3700361010830325,0.9244644870349493,0.30993573900148297,0.690064260998517,0.07553551296505073,0.528520786335804
0.902,2910,"[[820, 1394], [67, 629]]",820,67,1394,67,887,2023,2214,696,1449,1461,0.4979381443298969,0.37037037037037035,0.9244644870349493,0.31092436974789917,0.6890756302521008,0.07553551296505073,0.528861657529829
0.903,2910,"[[819, 1394], [68, 629]]",819,68,1394,68,887,2023,2213,697,1448,1462,0.49759450171821307,0.3700858563036602,0.923337091319053,0.31092436974789917,0.6890756302521008,0.07666290868094701,0.5283870967741935
0.904,2910,"[[819, 1392], [68, 631]]",819,68,1392,68,887,2023,2211,699,1450,1460,0.49828178694158076,0.3704206241519674,0.923337091319053,0.31191300049431536,0.6880869995056846,0.07666290868094701,0.5287282117495158
0.905,2910,"[[819, 1388], [68, 635]]",819,68,1388,68,887,2023,2207,703,1454,1456,0.49965635738831615,0.3710919800634345,0.923337091319053,0.3138902619871478,0.6861097380128522,0.07666290868094701,0.5294117647058824
0.906,2910,"[[819, 1387], [68, 636]]",819,68,1387,68,887,2023,2206,704,1455,1455,0.5,0.371260199456029,0.923337091319053,0.3143845773603559,0.6856154226396441,0.07666290868094701,0.5295829291949563
0.907,2910,"[[819, 1387], [68, 636]]",819,68,1387,68,887,2023,2206,704,1455,1455,0.5,0.371260199456029,0.923337091319053,0.3143845773603559,0.6856154226396441,0.07666290868094701,0.5295829291949563
0.908,2910,"[[819, 1386], [68, 637]]",819,68,1386,68,887,2023,2205,705,1456,1454,0.5003436426116838,0.37142857142857144,0.923337091319053,0.314878892733564,0.6851211072664359,0.07666290868094701,0.5297542043984477
0.909,2910,"[[819, 1386], [68, 637]]",819,68,1386,68,887,2023,2205,705,1456,1454,0.5003436426116838,0.37142857142857144,0.923337091319053,0.314878892733564,0.6851211072664359,0.07666290868094701,0.5297542043984477
0.91,2910,"[[819, 1385], [68, 638]]",819,68,1385,68,887,2023,2204,706,1457,1453,0.5006872852233677,0.37159709618874776,0.923337091319053,0.3153732081067721,0.6846267918932278,0.07666290868094701,0.5299255904238112
0.911,2910,"[[819, 1384], [68, 639]]",819,68,1384,68,887,2023,2203,707,1458,1452,0.5010309278350515,0.37176577394462096,0.923337091319053,0.3158675234799802,0.6841324765200197,0.07666290868094701,0.5300970873786407
0.912,2910,"[[819, 1383], [68, 640]]",819,68,1383,68,887,2023,2202,708,1459,1451,0.5013745704467354,0.37193460490463215,0.923337091319053,0.31636183885318836,0.6836381611468116,0.07666290868094701,0.5302686953706701
0.913,2910,"[[819, 1382], [68, 641]]",819,68,1382,68,887,2023,2201,709,1460,1450,0.5017182130584192,0.37210358927760107,0.923337091319053,0.31685615422639646,0.6831438457736035,0.07666290868094701,0.530440414507772
0.914,2910,"[[819, 1381], [68, 642]]",819,68,1381,68,887,2023,2200,710,1461,1449,0.5020618556701031,0.37227272727272726,0.923337091319053,0.31735046959960456,0.6826495304003954,0.07666290868094701,0.5306122448979592
0.915,2910,"[[819, 1381], [68, 642]]",819,68,1381,68,887,2023,2200,710,1461,1449,0.5020618556701031,0.37227272727272726,0.923337091319053,0.31735046959960456,0.6826495304003954,0.07666290868094701,0.5306122448979592
0.916,2910,"[[819, 1380], [68, 643]]",819,68,1380,68,887,2023,2199,711,1462,1448,0.5024054982817869,0.37244201909959074,0.923337091319053,0.31784478497281266,0.6821552150271873,0.07666290868094701,0.5307841866493843
0.917,2910,"[[818, 1380], [69, 643]]",818,69,1380,69,887,2023,2198,712,1461,1449,0.5020618556701031,0.3721565059144677,0.9222096956031567,0.31784478497281266,0.6821552150271873,0.0777903043968433,0.5303079416531604
0.918,2910,"[[818, 1380], [69, 643]]",818,69,1380,69,887,2023,2198,712,1461,1449,0.5020618556701031,0.3721565059144677,0.9222096956031567,0.31784478497281266,0.6821552150271873,0.0777903043968433,0.5303079416531604
0.919,2910,"[[818, 1380], [69, 643]]",818,69,1380,69,887,2023,2198,712,1461,1449,0.5020618556701031,0.3721565059144677,0.9222096956031567,0.31784478497281266,0.6821552150271873,0.0777903043968433,0.5303079416531604
0.92,2910,"[[818, 1380], [69, 643]]",818,69,1380,69,887,2023,2198,712,1461,1449,0.5020618556701031,0.3721565059144677,0.9222096956031567,0.31784478497281266,0.6821552150271873,0.0777903043968433,0.5303079416531604
0.921,2910,"[[818, 1377], [69, 646]]",818,69,1377,69,887,2023,2195,715,1464,1446,0.5030927835051546,0.3726651480637813,0.9222096956031567,0.31932773109243695,0.680672268907563,0.0777903043968433,0.5308241401687217
0.922,2910,"[[817, 1374], [70, 649]]",817,70,1374,70,887,2023,2191,719,1466,1444,0.5037800687285223,0.372889091738932,0.9210822998872604,0.3208106772120613,0.6791893227879388,0.07891770011273957,0.5308641975308642
0.923,2910,"[[817, 1374], [70, 649]]",817,70,1374,70,887,2023,2191,719,1466,1444,0.5037800687285223,0.372889091738932,0.9210822998872604,0.3208106772120613,0.6791893227879388,0.07891770011273957,0.5308641975308642
0.924,2910,"[[817, 1370], [70, 653]]",817,70,1370,70,887,2023,2187,723,1470,1440,0.5051546391752577,0.3735711019661637,0.9210822998872604,0.3227879387048937,0.6772120612951062,0.07891770011273957,0.531554977228367
0.925,2910,"[[817, 1370], [70, 653]]",817,70,1370,70,887,2023,2187,723,1470,1440,0.5051546391752577,0.3735711019661637,0.9210822998872604,0.3227879387048937,0.6772120612951062,0.07891770011273957,0.531554977228367
0.926,2910,"[[817, 1370], [70, 653]]",817,70,1370,70,887,2023,2187,723,1470,1440,0.5051546391752577,0.3735711019661637,0.9210822998872604,0.3227879387048937,0.6772120612951062,0.07891770011273957,0.531554977228367
0.927,2910,"[[817, 1369], [70, 654]]",817,70,1369,70,887,2023,2186,724,1471,1439,0.5054982817869416,0.3737419945105215,0.9210822998872604,0.32328225407810185,0.6767177459218982,0.07891770011273957,0.5317279531402538
0.928,2910,"[[817, 1369], [70, 654]]",817,70,1369,70,887,2023,2186,724,1471,1439,0.5054982817869416,0.3737419945105215,0.9210822998872604,0.32328225407810185,0.6767177459218982,0.07891770011273957,0.5317279531402538
0.929,2910,"[[817, 1368], [70, 655]]",817,70,1368,70,887,2023,2185,725,1472,1438,0.5058419243986254,0.3739130434782609,0.9210822998872604,0.32377656945130995,0.67622343054869,0.07891770011273957,0.5319010416666667
0.93,2910,"[[816, 1368], [71, 655]]",816,71,1368,71,887,2023,2184,726,1471,1439,0.5054982817869416,0.37362637362637363,0.9199549041713642,0.32377656945130995,0.67622343054869,0.08004509582863585,0.5314229892543145
0.931,2910,"[[816, 1366], [71, 657]]",816,71,1366,71,887,2023,2182,728,1473,1437,0.5061855670103093,0.37396883593033914,0.9199549041713642,0.32476520019772614,0.6752347998022739,0.08004509582863585,0.5317693059628543
0.932,2910,"[[816, 1365], [71, 658]]",816,71,1365,71,887,2023,2181,729,1474,1436,0.5065292096219931,0.3741403026134801,0.9199549041713642,0.32525951557093424,0.6747404844290658,0.08004509582863585,0.5319426336375489
0.933,2910,"[[816, 1362], [71, 661]]",816,71,1362,71,887,2023,2178,732,1477,1433,0.5075601374570446,0.3746556473829201,0.9199549041713642,0.3267424616905586,0.6732575383094415,0.08004509582863585,0.532463295269168
0.934,2910,"[[816, 1361], [71, 662]]",816,71,1361,71,887,2023,2177,733,1478,1432,0.5079037800687285,0.3748277446026642,0.9199549041713642,0.3272367770637667,0.6727632229362334,0.08004509582863585,0.5326370757180157
0.935,2910,"[[816, 1360], [71, 663]]",816,71,1360,71,887,2023,2176,734,1479,1431,0.5082474226804123,0.375,0.9199549041713642,0.3277310924369748,0.6722689075630253,0.08004509582863585,0.5328109696376102
0.936,2910,"[[816, 1357], [71, 666]]",816,71,1357,71,887,2023,2173,737,1482,1428,0.5092783505154639,0.37551771744132534,0.9199549041713642,0.3292140385565991,0.6707859614434009,0.08004509582863585,0.5333333333333333
0.937,2910,"[[816, 1355], [71, 668]]",816,71,1355,71,887,2023,2171,739,1484,1426,0.5099656357388316,0.375863657300783,0.9199549041713642,0.33020266930301534,0.6697973306969847,0.08004509582863585,0.5336821451929366
0.938,2910,"[[816, 1355], [71, 668]]",816,71,1355,71,887,2023,2171,739,1484,1426,0.5099656357388316,0.375863657300783,0.9199549041713642,0.33020266930301534,0.6697973306969847,0.08004509582863585,0.5336821451929366
0.939,2910,"[[816, 1354], [71, 669]]",816,71,1354,71,887,2023,2170,740,1485,1425,0.5103092783505154,0.376036866359447,0.9199549041713642,0.33069698467622344,0.6693030153237766,0.08004509582863585,0.533856722276742
0.94,2910,"[[816, 1353], [71, 670]]",816,71,1353,71,887,2023,2169,741,1486,1424,0.5106529209621993,0.37621023513139695,0.9199549041713642,0.33119130004943154,0.6688086999505685,0.08004509582863585,0.5340314136125655
0.941,2910,"[[816, 1352], [71, 671]]",816,71,1352,71,887,2023,2168,742,1487,1423,0.5109965635738831,0.3763837638376384,0.9199549041713642,0.33168561542263963,0.6683143845773604,0.08004509582863585,0.5342062193126023
0.942,2910,"[[816, 1351], [71, 672]]",816,71,1351,71,887,2023,2167,743,1488,1422,0.511340206185567,0.3765574526995847,0.9199549041713642,0.33217993079584773,0.6678200692041523,0.08004509582863585,0.5343811394891944
0.943,2910,"[[815, 1349], [72, 674]]",815,72,1349,72,887,2023,2164,746,1489,1421,0.5116838487972508,0.3766173752310536,0.9188275084554679,0.333168561542264,0.6668314384577361,0.08117249154453213,0.5342510652245165
0.944,2910,"[[815, 1347], [72, 676]]",815,72,1347,72,887,2023,2162,748,1491,1419,0.5123711340206185,0.37696577243293244,0.9188275084554679,0.3341571922886802,0.6658428077113199,0.08117249154453213,0.5346015086913742
0.945,2910,"[[815, 1347], [72, 676]]",815,72,1347,72,887,2023,2162,748,1491,1419,0.5123711340206185,0.37696577243293244,0.9188275084554679,0.3341571922886802,0.6658428077113199,0.08117249154453213,0.5346015086913742
0.946,2910,"[[815, 1346], [72, 677]]",815,72,1346,72,887,2023,2161,749,1492,1418,0.5127147766323024,0.3771402128644146,0.9188275084554679,0.3346515076618883,0.6653484923381117,0.08117249154453213,0.5347769028871391
0.947,2910,"[[815, 1344], [72, 679]]",815,72,1344,72,887,2023,2159,751,1494,1416,0.51340206185567,0.3774895785085688,0.9188275084554679,0.3356401384083045,0.6643598615916955,0.08117249154453213,0.5351280367695339
0.948,2910,"[[815, 1341], [72, 682]]",815,72,1341,72,887,2023,2156,754,1497,1413,0.5144329896907216,0.3780148423005566,0.9188275084554679,0.33712308452792883,0.6628769154720712,0.08117249154453213,0.5356556030233323
0.949,2910,"[[815, 1339], [72, 684]]",815,72,1339,72,887,2023,2154,756,1499,1411,0.5151202749140893,0.37836583101207055,0.9188275084554679,0.338111715274345,0.661888284725655,0.08117249154453213,0.5360078921407431
0.95,2910,"[[815, 1336], [72, 687]]",815,72,1336,72,887,2023,2151,759,1502,1408,0.516151202749141,0.3788935378893538,0.9188275084554679,0.3395946613939694,0.6604053386060307,0.08117249154453213,0.5365371955233706
0.951,2910,"[[814, 1334], [73, 689]]",814,73,1334,73,887,2023,2148,762,1503,1407,0.5164948453608248,0.3789571694599628,0.9177001127395716,0.3405832921403856,0.6594167078596145,0.08229988726042842,0.5364085667215815
0.952,2910,"[[814, 1332], [73, 691]]",814,73,1332,73,887,2023,2146,764,1505,1405,0.5171821305841925,0.3793103448275862,0.9177001127395716,0.34157192288680177,0.6584280771131982,0.08229988726042842,0.5367622815694032
0.953,2910,"[[814, 1332], [73, 691]]",814,73,1332,73,887,2023,2146,764,1505,1405,0.5171821305841925,0.3793103448275862,0.9177001127395716,0.34157192288680177,0.6584280771131982,0.08229988726042842,0.5367622815694032
0.954,2910,"[[813, 1327], [74, 696]]",813,74,1327,74,887,2023,2140,770,1509,1401,0.5185567010309279,0.37990654205607477,0.9165727170236753,0.3440434997528423,0.6559565002471577,0.0834272829763247,0.537165510406343
0.955,2910,"[[813, 1324], [74, 699]]",813,74,1324,74,887,2023,2137,773,1512,1398,0.5195876288659794,0.3804398689751989,0.9165727170236753,0.3455264458724666,0.6544735541275334,0.0834272829763247,0.5376984126984127
0.956,2910,"[[813, 1322], [74, 701]]",813,74,1322,74,887,2023,2135,775,1514,1396,0.5202749140893471,0.3807962529274005,0.9165727170236753,0.34651507661888287,0.6534849233811172,0.0834272829763247,0.5380542686962276
0.957,2910,"[[813, 1320], [74, 703]]",813,74,1320,74,887,2023,2133,777,1516,1394,0.5209621993127148,0.38115330520393814,0.9165727170236753,0.34750370736529906,0.652496292634701,0.0834272829763247,0.5384105960264901
0.958,2910,"[[813, 1318], [74, 705]]",813,74,1318,74,887,2023,2131,779,1518,1392,0.5216494845360825,0.38151102768653217,0.9165727170236753,0.34849233811171526,0.6515076618882847,0.0834272829763247,0.5387673956262425
0.959,2910,"[[813, 1317], [74, 706]]",813,74,1317,74,887,2023,2130,780,1519,1391,0.5219931271477664,0.3816901408450704,0.9165727170236753,0.34898665348492336,0.6510133465150766,0.0834272829763247,0.5389459728206828
0.96,2910,"[[812, 1312], [75, 711]]",812,75,1312,75,887,2023,2124,786,1523,1387,0.5233676975945017,0.3822975517890772,0.915445321307779,0.3514582303509639,0.6485417696490361,0.08455467869222097,0.5393556957821322
0.961,2910,"[[812, 1308], [75, 715]]",812,75,1308,75,887,2023,2120,790,1527,1383,0.5247422680412371,0.38301886792452833,0.915445321307779,0.35343549184379636,0.6465645081562037,0.08455467869222097,0.5400731626205522
0.962,2910,"[[812, 1301], [75, 722]]",812,75,1301,75,887,2023,2113,797,1534,1376,0.5271477663230241,0.38428774254614295,0.915445321307779,0.3568956994562531,0.6431043005437469,0.08455467869222097,0.5413333333333333
0.963,2910,"[[812, 1298], [75, 725]]",812,75,1298,75,887,2023,2110,800,1537,1373,0.5281786941580756,0.3848341232227488,0.915445321307779,0.3583786455758774,0.6416213544241226,0.08455467869222097,0.5418752085418752
0.964,2910,"[[811, 1296], [76, 727]]",811,76,1296,76,887,2023,2107,803,1538,1372,0.5285223367697595,0.3849074513526341,0.9143179255918827,0.35936727632229365,0.6406327236777064,0.08568207440811725,0.541750167000668
0.965,2910,"[[811, 1294], [76, 729]]",811,76,1294,76,887,2023,2105,805,1540,1370,0.5292096219931272,0.38527315914489313,0.9143179255918827,0.36035590706870985,0.6396440929312902,0.08568207440811725,0.5421122994652408
0.966,2910,"[[810, 1293], [77, 730]]",810,77,1293,77,887,2023,2103,807,1540,1370,0.5292096219931272,0.38516405135520687,0.9131905298759865,0.36085022244191794,0.6391497775580821,0.08680947012401354,0.5418060200668896
0.967,2910,"[[809, 1290], [78, 733]]",809,78,1290,78,887,2023,2099,811,1542,1368,0.5298969072164949,0.3854216293473082,0.9120631341600902,0.36233316856154224,0.6376668314384577,0.08793686583990981,0.5418620227729404
0.968,2910,"[[808, 1288], [79, 735]]",808,79,1288,79,887,2023,2096,814,1543,1367,0.5302405498281787,0.38549618320610685,0.910935738444194,0.3633217993079585,0.6366782006920415,0.08906426155580609,0.5417365068722763
0.969,2910,"[[808, 1286], [79, 737]]",808,79,1286,79,887,2023,2094,816,1545,1365,0.5309278350515464,0.3858643744030564,0.910935738444194,0.3643104300543747,0.6356895699456253,0.08906426155580609,0.54209996645421
0.97,2910,"[[808, 1281], [79, 742]]",808,79,1281,79,887,2023,2089,821,1550,1360,0.5326460481099656,0.38678793681187174,0.910935738444194,0.36678200692041524,0.6332179930795848,0.08906426155580609,0.5430107526881721
0.971,2910,"[[807, 1276], [80, 747]]",807,80,1276,80,887,2023,2083,827,1554,1356,0.534020618556701,0.3874219875180029,0.9098083427282976,0.3692535837864558,0.6307464162135442,0.09019165727170236,0.5434343434343435
0.972,2910,"[[807, 1276], [80, 747]]",807,80,1276,80,887,2023,2083,827,1554,1356,0.534020618556701,0.3874219875180029,0.9098083427282976,0.3692535837864558,0.6307464162135442,0.09019165727170236,0.5434343434343435
0.973,2910,"[[807, 1272], [80, 751]]",807,80,1272,80,887,2023,2079,831,1558,1352,0.5353951890034364,0.38816738816738816,0.9098083427282976,0.3712308452792882,0.6287691547207118,0.09019165727170236,0.5441672285906946
0.974,2910,"[[805, 1270], [82, 753]]",805,82,1270,82,887,2023,2075,835,1558,1352,0.5353951890034364,0.38795180722891565,0.9075535512965051,0.3722194760257044,0.6277805239742956,0.09244644870349493,0.5435516542876434
0.975,2910,"[[805, 1268], [82, 755]]",805,82,1268,82,887,2023,2073,837,1560,1350,0.5360824742268041,0.38832609744331886,0.9075535512965051,0.37320810677212063,0.6267918932278794,0.09244644870349493,0.543918918918919
0.976,2910,"[[804, 1264], [83, 759]]",804,83,1264,83,887,2023,2068,842,1563,1347,0.5371134020618556,0.38878143133462284,0.9064261555806088,0.375185368264953,0.6248146317350469,0.0935738444193912,0.5441624365482234
0.977,2910,"[[804, 1257], [83, 766]]",804,83,1257,83,887,2023,2061,849,1570,1340,0.5395189003436426,0.3901018922852984,0.9064261555806088,0.37864557587740977,0.6213544241225902,0.0935738444193912,0.5454545454545455
0.978,2910,"[[803, 1253], [84, 770]]",803,84,1253,84,887,2023,2056,854,1573,1337,0.5405498281786941,0.39056420233463035,0.9052987598647125,0.3806228373702422,0.6193771626297578,0.09470124013528748,0.54570166496772
0.979,2910,"[[803, 1250], [84, 773]]",803,84,1250,84,887,2023,2053,857,1576,1334,0.5415807560137457,0.3911349245007306,0.9052987598647125,0.3821057834898665,0.6178942165101334,0.09470124013528748,0.5462585034013605
0.98,2910,"[[803, 1239], [84, 784]]",803,84,1239,84,887,2023,2042,868,1587,1323,0.545360824742268,0.3932419196865818,0.9052987598647125,0.3875432525951557,0.6124567474048442,0.09470124013528748,0.5483100034141345
0.981,2910,"[[802, 1236], [85, 787]]",802,85,1236,85,887,2023,2038,872,1589,1321,0.5460481099656357,0.39352306182531893,0.9041713641488163,0.38902619871478,0.6109738012852199,0.09582863585118377,0.5483760683760683
0.982,2910,"[[802, 1229], [85, 794]]",802,85,1229,85,887,2023,2031,879,1596,1314,0.5484536082474227,0.3948793697685869,0.9041713641488163,0.3924864063272368,0.6075135936727633,0.09582863585118377,0.5496915695681974
0.983,2910,"[[799, 1222], [88, 801]]",799,88,1222,88,887,2023,2021,889,1600,1310,0.5498281786941581,0.3953488372093023,0.9007891770011274,0.39594661393969355,0.6040533860603065,0.0992108229988726,0.5495185694635488
0.984,2910,"[[797, 1219], [90, 804]]",797,90,1219,90,887,2023,2016,894,1601,1309,0.550171821305842,0.39533730158730157,0.8985343855693348,0.39742956005931784,0.6025704399406822,0.10146561443066517,0.5490871512228729
0.985,2910,"[[797, 1216], [90, 807]]",797,90,1216,90,887,2023,2013,897,1604,1306,0.5512027491408935,0.395926477893691,0.8985343855693348,0.39891250617894214,0.6010874938210579,0.10146561443066517,0.549655172413793
0.986,2910,"[[797, 1212], [90, 811]]",797,90,1212,90,887,2023,2009,901,1608,1302,0.5525773195876289,0.39671478347436534,0.8985343855693348,0.4008897676717746,0.5991102323282254,0.10146561443066517,0.550414364640884
0.987,2910,"[[797, 1207], [90, 816]]",797,90,1207,90,887,2023,2004,906,1613,1297,0.5542955326460481,0.3977045908183633,0.8985343855693348,0.40336134453781514,0.5966386554621849,0.10146561443066517,0.5513663092355587
0.988,2910,"[[795, 1197], [92, 826]]",795,92,1197,92,887,2023,1992,918,1621,1289,0.5570446735395189,0.3990963855421687,0.8962795941375423,0.4083044982698962,0.5916955017301038,0.10372040586245772,0.5522750955192776
0.989,2910,"[[794, 1187], [93, 836]]",794,93,1187,93,887,2023,1981,929,1630,1280,0.5601374570446735,0.40080767289247854,0.895152198421646,0.4132476520019773,0.5867523479980228,0.10484780157835401,0.5536959553695956
0.99,2910,"[[793, 1171], [94, 852]]",793,94,1171,94,887,2023,1964,946,1645,1265,0.5652920962199313,0.40376782077393075,0.8940248027057497,0.42115669797330696,0.578843302026693,0.10597519729425028,0.5562960364784286
0.991,2910,"[[791, 1162], [96, 861]]",791,96,1162,96,887,2023,1953,957,1652,1258,0.5676975945017182,0.4050179211469534,0.8917700112739572,0.42560553633217996,0.5743944636678201,0.10822998872604284,0.5570422535211268
0.992,2910,"[[789, 1148], [98, 875]]",789,98,1148,98,887,2023,1937,973,1664,1246,0.5718213058419244,0.4073309241094476,0.8895152198421646,0.43252595155709345,0.5674740484429066,0.1104847801578354,0.5587818696883852
0.993,2910,"[[786, 1134], [101, 889]]",786,101,1134,101,887,2023,1920,990,1675,1235,0.5756013745704467,0.409375,0.8861330326944757,0.43944636678200694,0.5605536332179931,0.11386696730552424,0.5600285001781261
0.994,2910,"[[782, 1120], [105, 903]]",782,105,1120,105,887,2023,1902,1008,1685,1225,0.5790378006872853,0.41114616193480547,0.8816234498308907,0.4463667820069204,0.5536332179930796,0.11837655016910936,0.5607744711366082
0.995,2910,"[[778, 1099], [109, 924]]",778,109,1099,109,887,2023,1877,1033,1702,1208,0.5848797250859107,0.4144912093766649,0.8771138669673055,0.45674740484429066,0.5432525951557093,0.12288613303269448,0.5629522431259045
0.996,2910,"[[773, 1076], [114, 947]]",773,114,1076,114,887,2023,1849,1061,1720,1190,0.5910652920962199,0.41806381828015143,0.8714768883878241,0.4681166584280771,0.5318833415719229,0.12852311161217586,0.5650584795321637
0.997,2910,"[[767, 1044], [120, 979]]",767,120,1044,120,887,2023,1811,1099,1746,1164,0.6,0.42352291551628934,0.8647125140924464,0.4839347503707365,0.5160652496292635,0.13528748590755355,0.5685693106004448
0.998,2910,"[[758, 992], [129, 1031]]",758,129,992,129,887,2023,1750,1160,1789,1121,0.6147766323024055,0.43314285714285716,0.85456595264938,0.5096391497775581,0.4903608502224419,0.14543404735062007,0.5748957148274555
0.999,2910,"[[738, 926], [149, 1097]]",738,149,926,149,887,2023,1664,1246,1835,1075,0.6305841924398625,0.44350961538461536,0.8320180383314544,0.5422639644092931,0.45773603559070686,0.16798196166854565,0.5785966287730301
1.0,2910,"[[469, 124], [418, 1899]]",469,418,124,418,887,2023,593,2317,2368,542,0.813745704467354,0.790893760539629,0.5287485907553551,0.9387048937221948,0.06129510627780524,0.47125140924464487,0.6337837837837837
1.001,2910,"[[0, 0], [887, 2023]]",0,887,0,887,887,2023,0,2910,2023,887,0.6951890034364261,,0.0,1.0,0.0,1.0,
