Score Threshold,Measurements (M),Confusion Matrix (cm),True Pos.s (TP),True Neg.s (TN),False Pos.s (FP),*False Neg.s* (FN),Positives (P),Negatives (N),Meas.Pos.s (MP),Meas.Neg.s (MN),Correct Meas.s (CM),Incorrect Meas.s (IM),Accuracy (ACC),Precision (PPV),Recall/Sensitivity (TPR),Specificity/Selectivity (TNR),Fallout (FPR),Miss Rate (FNR),F1 Score (F1)
0.0,400,"[[200, 200], [0, 0]]",200,0,200,0,200,200,400,0,200,200,0.5,0.5,1.0,0.0,1.0,0.0,0.6666666666666666
0.001,400,"[[200, 199], [0, 1]]",200,0,199,0,200,200,399,1,201,199,0.5025,0.5012531328320802,1.0,0.005,0.995,0.0,0.667779632721202
0.002,400,"[[197, 199], [3, 1]]",197,3,199,3,200,200,396,4,198,202,0.495,0.49747474747474746,0.985,0.005,0.995,0.015,0.6610738255033557
0.003,400,"[[196, 198], [4, 2]]",196,4,198,4,200,200,394,6,198,202,0.495,0.49746192893401014,0.98,0.01,0.99,0.02,0.6599326599326599
0.004,400,"[[195, 196], [5, 4]]",195,5,196,5,200,200,391,9,199,201,0.4975,0.49872122762148335,0.975,0.02,0.98,0.025,0.6598984771573604
0.005,400,"[[193, 195], [7, 5]]",193,7,195,7,200,200,388,12,198,202,0.495,0.49742268041237114,0.965,0.025,0.975,0.035,0.6564625850340137
0.006,400,"[[193, 194], [7, 6]]",193,7,194,7,200,200,387,13,199,201,0.4975,0.49870801033591733,0.965,0.03,0.97,0.035,0.657580919931857
0.007,400,"[[192, 193], [8, 7]]",192,8,193,8,200,200,385,15,199,201,0.4975,0.4987012987012987,0.96,0.035,0.965,0.04,0.6564102564102564
0.008,400,"[[192, 189], [8, 11]]",192,8,189,8,200,200,381,19,203,197,0.5075,0.5039370078740157,0.96,0.055,0.945,0.04,0.6609294320137693
0.009,400,"[[192, 189], [8, 11]]",192,8,189,8,200,200,381,19,203,197,0.5075,0.5039370078740157,0.96,0.055,0.945,0.04,0.6609294320137693
0.01,400,"[[191, 187], [9, 13]]",191,9,187,9,200,200,378,22,204,196,0.51,0.5052910052910053,0.955,0.065,0.935,0.045,0.6608996539792388
0.011,400,"[[191, 187], [9, 13]]",191,9,187,9,200,200,378,22,204,196,0.51,0.5052910052910053,0.955,0.065,0.935,0.045,0.6608996539792388
0.012,400,"[[191, 186], [9, 14]]",191,9,186,9,200,200,377,23,205,195,0.5125,0.506631299734748,0.955,0.07,0.93,0.045,0.6620450606585788
0.013,400,"[[191, 185], [9, 15]]",191,9,185,9,200,200,376,24,206,194,0.515,0.5079787234042553,0.955,0.075,0.925,0.045,0.6631944444444444
0.014,400,"[[191, 185], [9, 15]]",191,9,185,9,200,200,376,24,206,194,0.515,0.5079787234042553,0.955,0.075,0.925,0.045,0.6631944444444444
0.015,400,"[[191, 184], [9, 16]]",191,9,184,9,200,200,375,25,207,193,0.5175,0.5093333333333333,0.955,0.08,0.92,0.045,0.6643478260869565
0.016,400,"[[191, 183], [9, 17]]",191,9,183,9,200,200,374,26,208,192,0.52,0.5106951871657754,0.955,0.085,0.915,0.045,0.6655052264808362
0.017,400,"[[191, 183], [9, 17]]",191,9,183,9,200,200,374,26,208,192,0.52,0.5106951871657754,0.955,0.085,0.915,0.045,0.6655052264808362
0.018,400,"[[191, 182], [9, 18]]",191,9,182,9,200,200,373,27,209,191,0.5225,0.5120643431635389,0.955,0.09,0.91,0.045,0.6666666666666666
0.019,400,"[[191, 182], [9, 18]]",191,9,182,9,200,200,373,27,209,191,0.5225,0.5120643431635389,0.955,0.09,0.91,0.045,0.6666666666666666
0.02,400,"[[191, 182], [9, 18]]",191,9,182,9,200,200,373,27,209,191,0.5225,0.5120643431635389,0.955,0.09,0.91,0.045,0.6666666666666666
0.021,400,"[[191, 182], [9, 18]]",191,9,182,9,200,200,373,27,209,191,0.5225,0.5120643431635389,0.955,0.09,0.91,0.045,0.6666666666666666
0.022,400,"[[191, 182], [9, 18]]",191,9,182,9,200,200,373,27,209,191,0.5225,0.5120643431635389,0.955,0.09,0.91,0.045,0.6666666666666666
0.023,400,"[[190, 182], [10, 18]]",190,10,182,10,200,200,372,28,208,192,0.52,0.510752688172043,0.95,0.09,0.91,0.05,0.6643356643356643
0.024,400,"[[183, 180], [17, 20]]",183,17,180,17,200,200,363,37,203,197,0.5075,0.5041322314049587,0.915,0.1,0.9,0.085,0.6500888099467141
0.025,400,"[[183, 180], [17, 20]]",183,17,180,17,200,200,363,37,203,197,0.5075,0.5041322314049587,0.915,0.1,0.9,0.085,0.6500888099467141
0.026,400,"[[183, 180], [17, 20]]",183,17,180,17,200,200,363,37,203,197,0.5075,0.5041322314049587,0.915,0.1,0.9,0.085,0.6500888099467141
0.027,400,"[[182, 178], [18, 22]]",182,18,178,18,200,200,360,40,204,196,0.51,0.5055555555555555,0.91,0.11,0.89,0.09,0.6499999999999999
0.028,400,"[[182, 178], [18, 22]]",182,18,178,18,200,200,360,40,204,196,0.51,0.5055555555555555,0.91,0.11,0.89,0.09,0.6499999999999999
0.029,400,"[[182, 178], [18, 22]]",182,18,178,18,200,200,360,40,204,196,0.51,0.5055555555555555,0.91,0.11,0.89,0.09,0.6499999999999999
0.03,400,"[[182, 176], [18, 24]]",182,18,176,18,200,200,358,42,206,194,0.515,0.5083798882681564,0.91,0.12,0.88,0.09,0.6523297491039426
0.031,400,"[[182, 175], [18, 25]]",182,18,175,18,200,200,357,43,207,193,0.5175,0.5098039215686274,0.91,0.125,0.875,0.09,0.6535008976660682
0.032,400,"[[182, 175], [18, 25]]",182,18,175,18,200,200,357,43,207,193,0.5175,0.5098039215686274,0.91,0.125,0.875,0.09,0.6535008976660682
0.033,400,"[[181, 175], [19, 25]]",181,19,175,19,200,200,356,44,206,194,0.515,0.5084269662921348,0.905,0.125,0.875,0.095,0.6510791366906475
0.034,400,"[[181, 174], [19, 26]]",181,19,174,19,200,200,355,45,207,193,0.5175,0.5098591549295775,0.905,0.13,0.87,0.095,0.6522522522522523
0.035,400,"[[180, 173], [20, 27]]",180,20,173,20,200,200,353,47,207,193,0.5175,0.509915014164306,0.9,0.135,0.865,0.1,0.650994575045208
0.036,400,"[[169, 172], [31, 28]]",169,31,172,31,200,200,341,59,197,203,0.4925,0.49560117302052786,0.845,0.14,0.86,0.155,0.6247689463955638
0.037,400,"[[169, 171], [31, 29]]",169,31,171,31,200,200,340,60,198,202,0.495,0.4970588235294118,0.845,0.145,0.855,0.155,0.625925925925926
0.038,400,"[[169, 170], [31, 30]]",169,31,170,31,200,200,339,61,199,201,0.4975,0.49852507374631266,0.845,0.15,0.85,0.155,0.6270871985157699
0.039,400,"[[167, 168], [33, 32]]",167,33,168,33,200,200,335,65,199,201,0.4975,0.49850746268656715,0.835,0.16,0.84,0.165,0.6242990654205607
0.04,400,"[[167, 168], [33, 32]]",167,33,168,33,200,200,335,65,199,201,0.4975,0.49850746268656715,0.835,0.16,0.84,0.165,0.6242990654205607
0.041,400,"[[167, 167], [33, 33]]",167,33,167,33,200,200,334,66,200,200,0.5,0.5,0.835,0.165,0.835,0.165,0.6254681647940075
0.042,400,"[[167, 167], [33, 33]]",167,33,167,33,200,200,334,66,200,200,0.5,0.5,0.835,0.165,0.835,0.165,0.6254681647940075
0.043,400,"[[167, 167], [33, 33]]",167,33,167,33,200,200,334,66,200,200,0.5,0.5,0.835,0.165,0.835,0.165,0.6254681647940075
0.044,400,"[[167, 167], [33, 33]]",167,33,167,33,200,200,334,66,200,200,0.5,0.5,0.835,0.165,0.835,0.165,0.6254681647940075
0.045,400,"[[167, 167], [33, 33]]",167,33,167,33,200,200,334,66,200,200,0.5,0.5,0.835,0.165,0.835,0.165,0.6254681647940075
0.046,400,"[[167, 167], [33, 33]]",167,33,167,33,200,200,334,66,200,200,0.5,0.5,0.835,0.165,0.835,0.165,0.6254681647940075
0.047,400,"[[167, 165], [33, 35]]",167,33,165,33,200,200,332,68,202,198,0.505,0.5030120481927711,0.835,0.175,0.825,0.165,0.6278195488721805
0.048,400,"[[167, 165], [33, 35]]",167,33,165,33,200,200,332,68,202,198,0.505,0.5030120481927711,0.835,0.175,0.825,0.165,0.6278195488721805
0.049,400,"[[167, 165], [33, 35]]",167,33,165,33,200,200,332,68,202,198,0.505,0.5030120481927711,0.835,0.175,0.825,0.165,0.6278195488721805
0.05,400,"[[167, 164], [33, 36]]",167,33,164,33,200,200,331,69,203,197,0.5075,0.5045317220543807,0.835,0.18,0.82,0.165,0.6290018832391713
0.051,400,"[[167, 164], [33, 36]]",167,33,164,33,200,200,331,69,203,197,0.5075,0.5045317220543807,0.835,0.18,0.82,0.165,0.6290018832391713
0.052,400,"[[166, 163], [34, 37]]",166,34,163,34,200,200,329,71,203,197,0.5075,0.5045592705167173,0.83,0.185,0.815,0.17,0.6275992438563327
0.053,400,"[[166, 163], [34, 37]]",166,34,163,34,200,200,329,71,203,197,0.5075,0.5045592705167173,0.83,0.185,0.815,0.17,0.6275992438563327
0.054,400,"[[166, 163], [34, 37]]",166,34,163,34,200,200,329,71,203,197,0.5075,0.5045592705167173,0.83,0.185,0.815,0.17,0.6275992438563327
0.055,400,"[[166, 163], [34, 37]]",166,34,163,34,200,200,329,71,203,197,0.5075,0.5045592705167173,0.83,0.185,0.815,0.17,0.6275992438563327
0.056,400,"[[164, 161], [36, 39]]",164,36,161,36,200,200,325,75,203,197,0.5075,0.5046153846153846,0.82,0.195,0.805,0.18,0.6247619047619046
0.057,400,"[[163, 161], [37, 39]]",163,37,161,37,200,200,324,76,202,198,0.505,0.5030864197530864,0.815,0.195,0.805,0.185,0.6221374045801527
0.058,400,"[[162, 161], [38, 39]]",162,38,161,38,200,200,323,77,201,199,0.5025,0.5015479876160991,0.81,0.195,0.805,0.19,0.6195028680688337
0.059,400,"[[162, 161], [38, 39]]",162,38,161,38,200,200,323,77,201,199,0.5025,0.5015479876160991,0.81,0.195,0.805,0.19,0.6195028680688337
0.06,400,"[[162, 161], [38, 39]]",162,38,161,38,200,200,323,77,201,199,0.5025,0.5015479876160991,0.81,0.195,0.805,0.19,0.6195028680688337
0.061,400,"[[162, 161], [38, 39]]",162,38,161,38,200,200,323,77,201,199,0.5025,0.5015479876160991,0.81,0.195,0.805,0.19,0.6195028680688337
0.062,400,"[[162, 161], [38, 39]]",162,38,161,38,200,200,323,77,201,199,0.5025,0.5015479876160991,0.81,0.195,0.805,0.19,0.6195028680688337
0.063,400,"[[162, 161], [38, 39]]",162,38,161,38,200,200,323,77,201,199,0.5025,0.5015479876160991,0.81,0.195,0.805,0.19,0.6195028680688337
0.064,400,"[[162, 161], [38, 39]]",162,38,161,38,200,200,323,77,201,199,0.5025,0.5015479876160991,0.81,0.195,0.805,0.19,0.6195028680688337
0.065,400,"[[162, 161], [38, 39]]",162,38,161,38,200,200,323,77,201,199,0.5025,0.5015479876160991,0.81,0.195,0.805,0.19,0.6195028680688337
0.066,400,"[[162, 161], [38, 39]]",162,38,161,38,200,200,323,77,201,199,0.5025,0.5015479876160991,0.81,0.195,0.805,0.19,0.6195028680688337
0.067,400,"[[162, 161], [38, 39]]",162,38,161,38,200,200,323,77,201,199,0.5025,0.5015479876160991,0.81,0.195,0.805,0.19,0.6195028680688337
0.068,400,"[[160, 161], [40, 39]]",160,40,161,40,200,200,321,79,199,201,0.4975,0.4984423676012461,0.8,0.195,0.805,0.2,0.6142034548944338
0.069,400,"[[160, 161], [40, 39]]",160,40,161,40,200,200,321,79,199,201,0.4975,0.4984423676012461,0.8,0.195,0.805,0.2,0.6142034548944338
0.07,400,"[[160, 161], [40, 39]]",160,40,161,40,200,200,321,79,199,201,0.4975,0.4984423676012461,0.8,0.195,0.805,0.2,0.6142034548944338
0.071,400,"[[160, 161], [40, 39]]",160,40,161,40,200,200,321,79,199,201,0.4975,0.4984423676012461,0.8,0.195,0.805,0.2,0.6142034548944338
0.072,400,"[[160, 161], [40, 39]]",160,40,161,40,200,200,321,79,199,201,0.4975,0.4984423676012461,0.8,0.195,0.805,0.2,0.6142034548944338
0.073,400,"[[159, 161], [41, 39]]",159,41,161,41,200,200,320,80,198,202,0.495,0.496875,0.795,0.195,0.805,0.205,0.6115384615384616
0.074,400,"[[159, 161], [41, 39]]",159,41,161,41,200,200,320,80,198,202,0.495,0.496875,0.795,0.195,0.805,0.205,0.6115384615384616
0.075,400,"[[159, 161], [41, 39]]",159,41,161,41,200,200,320,80,198,202,0.495,0.496875,0.795,0.195,0.805,0.205,0.6115384615384616
0.076,400,"[[159, 161], [41, 39]]",159,41,161,41,200,200,320,80,198,202,0.495,0.496875,0.795,0.195,0.805,0.205,0.6115384615384616
0.077,400,"[[158, 161], [42, 39]]",158,42,161,42,200,200,319,81,197,203,0.4925,0.4952978056426332,0.79,0.195,0.805,0.21,0.6088631984585742
0.078,400,"[[157, 161], [43, 39]]",157,43,161,43,200,200,318,82,196,204,0.49,0.4937106918238994,0.785,0.195,0.805,0.215,0.6061776061776062
0.079,400,"[[157, 161], [43, 39]]",157,43,161,43,200,200,318,82,196,204,0.49,0.4937106918238994,0.785,0.195,0.805,0.215,0.6061776061776062
0.08,400,"[[157, 161], [43, 39]]",157,43,161,43,200,200,318,82,196,204,0.49,0.4937106918238994,0.785,0.195,0.805,0.215,0.6061776061776062
0.081,400,"[[157, 161], [43, 39]]",157,43,161,43,200,200,318,82,196,204,0.49,0.4937106918238994,0.785,0.195,0.805,0.215,0.6061776061776062
0.082,400,"[[157, 160], [43, 40]]",157,43,160,43,200,200,317,83,197,203,0.4925,0.4952681388012618,0.785,0.2,0.8,0.215,0.6073500967117988
0.083,400,"[[157, 158], [43, 42]]",157,43,158,43,200,200,315,85,199,201,0.4975,0.4984126984126984,0.785,0.21,0.79,0.215,0.6097087378640776
0.084,400,"[[157, 158], [43, 42]]",157,43,158,43,200,200,315,85,199,201,0.4975,0.4984126984126984,0.785,0.21,0.79,0.215,0.6097087378640776
0.085,400,"[[157, 158], [43, 42]]",157,43,158,43,200,200,315,85,199,201,0.4975,0.4984126984126984,0.785,0.21,0.79,0.215,0.6097087378640776
0.086,400,"[[157, 158], [43, 42]]",157,43,158,43,200,200,315,85,199,201,0.4975,0.4984126984126984,0.785,0.21,0.79,0.215,0.6097087378640776
0.087,400,"[[156, 158], [44, 42]]",156,44,158,44,200,200,314,86,198,202,0.495,0.4968152866242038,0.78,0.21,0.79,0.22,0.6070038910505836
0.088,400,"[[156, 158], [44, 42]]",156,44,158,44,200,200,314,86,198,202,0.495,0.4968152866242038,0.78,0.21,0.79,0.22,0.6070038910505836
0.089,400,"[[156, 158], [44, 42]]",156,44,158,44,200,200,314,86,198,202,0.495,0.4968152866242038,0.78,0.21,0.79,0.22,0.6070038910505836
0.09,400,"[[155, 157], [45, 43]]",155,45,157,45,200,200,312,88,198,202,0.495,0.4967948717948718,0.775,0.215,0.785,0.225,0.6054687500000001
0.091,400,"[[155, 157], [45, 43]]",155,45,157,45,200,200,312,88,198,202,0.495,0.4967948717948718,0.775,0.215,0.785,0.225,0.6054687500000001
0.092,400,"[[155, 155], [45, 45]]",155,45,155,45,200,200,310,90,200,200,0.5,0.5,0.775,0.225,0.775,0.225,0.607843137254902
0.093,400,"[[155, 155], [45, 45]]",155,45,155,45,200,200,310,90,200,200,0.5,0.5,0.775,0.225,0.775,0.225,0.607843137254902
0.094,400,"[[155, 154], [45, 46]]",155,45,154,45,200,200,309,91,201,199,0.5025,0.5016181229773463,0.775,0.23,0.77,0.225,0.6090373280943026
0.095,400,"[[155, 154], [45, 46]]",155,45,154,45,200,200,309,91,201,199,0.5025,0.5016181229773463,0.775,0.23,0.77,0.225,0.6090373280943026
0.096,400,"[[155, 154], [45, 46]]",155,45,154,45,200,200,309,91,201,199,0.5025,0.5016181229773463,0.775,0.23,0.77,0.225,0.6090373280943026
0.097,400,"[[155, 154], [45, 46]]",155,45,154,45,200,200,309,91,201,199,0.5025,0.5016181229773463,0.775,0.23,0.77,0.225,0.6090373280943026
0.098,400,"[[155, 152], [45, 48]]",155,45,152,45,200,200,307,93,203,197,0.5075,0.504885993485342,0.775,0.24,0.76,0.225,0.6114398422090729
0.099,400,"[[155, 152], [45, 48]]",155,45,152,45,200,200,307,93,203,197,0.5075,0.504885993485342,0.775,0.24,0.76,0.225,0.6114398422090729
0.1,400,"[[155, 152], [45, 48]]",155,45,152,45,200,200,307,93,203,197,0.5075,0.504885993485342,0.775,0.24,0.76,0.225,0.6114398422090729
0.101,400,"[[154, 152], [46, 48]]",154,46,152,46,200,200,306,94,202,198,0.505,0.5032679738562091,0.77,0.24,0.76,0.23,0.608695652173913
0.102,400,"[[154, 151], [46, 49]]",154,46,151,46,200,200,305,95,203,197,0.5075,0.5049180327868853,0.77,0.245,0.755,0.23,0.60990099009901
0.103,400,"[[154, 151], [46, 49]]",154,46,151,46,200,200,305,95,203,197,0.5075,0.5049180327868853,0.77,0.245,0.755,0.23,0.60990099009901
0.104,400,"[[154, 150], [46, 50]]",154,46,150,46,200,200,304,96,204,196,0.51,0.506578947368421,0.77,0.25,0.75,0.23,0.611111111111111
0.105,400,"[[154, 150], [46, 50]]",154,46,150,46,200,200,304,96,204,196,0.51,0.506578947368421,0.77,0.25,0.75,0.23,0.611111111111111
0.106,400,"[[153, 150], [47, 50]]",153,47,150,47,200,200,303,97,203,197,0.5075,0.504950495049505,0.765,0.25,0.75,0.235,0.6083499005964215
0.107,400,"[[153, 150], [47, 50]]",153,47,150,47,200,200,303,97,203,197,0.5075,0.504950495049505,0.765,0.25,0.75,0.235,0.6083499005964215
0.108,400,"[[153, 150], [47, 50]]",153,47,150,47,200,200,303,97,203,197,0.5075,0.504950495049505,0.765,0.25,0.75,0.235,0.6083499005964215
0.109,400,"[[153, 150], [47, 50]]",153,47,150,47,200,200,303,97,203,197,0.5075,0.504950495049505,0.765,0.25,0.75,0.235,0.6083499005964215
0.11,400,"[[153, 150], [47, 50]]",153,47,150,47,200,200,303,97,203,197,0.5075,0.504950495049505,0.765,0.25,0.75,0.235,0.6083499005964215
0.111,400,"[[153, 149], [47, 51]]",153,47,149,47,200,200,302,98,204,196,0.51,0.5066225165562914,0.765,0.255,0.745,0.235,0.6095617529880479
0.112,400,"[[153, 149], [47, 51]]",153,47,149,47,200,200,302,98,204,196,0.51,0.5066225165562914,0.765,0.255,0.745,0.235,0.6095617529880479
0.113,400,"[[153, 149], [47, 51]]",153,47,149,47,200,200,302,98,204,196,0.51,0.5066225165562914,0.765,0.255,0.745,0.235,0.6095617529880479
0.114,400,"[[153, 148], [47, 52]]",153,47,148,47,200,200,301,99,205,195,0.5125,0.5083056478405316,0.765,0.26,0.74,0.235,0.6107784431137725
0.115,400,"[[153, 148], [47, 52]]",153,47,148,47,200,200,301,99,205,195,0.5125,0.5083056478405316,0.765,0.26,0.74,0.235,0.6107784431137725
0.116,400,"[[153, 146], [47, 54]]",153,47,146,47,200,200,299,101,207,193,0.5175,0.5117056856187291,0.765,0.27,0.73,0.235,0.6132264529058116
0.117,400,"[[153, 145], [47, 55]]",153,47,145,47,200,200,298,102,208,192,0.52,0.5134228187919463,0.765,0.275,0.725,0.235,0.6144578313253012
0.118,400,"[[153, 145], [47, 55]]",153,47,145,47,200,200,298,102,208,192,0.52,0.5134228187919463,0.765,0.275,0.725,0.235,0.6144578313253012
0.119,400,"[[152, 144], [48, 56]]",152,48,144,48,200,200,296,104,208,192,0.52,0.5135135135135135,0.76,0.28,0.72,0.24,0.6129032258064517
0.12,400,"[[151, 143], [49, 57]]",151,49,143,49,200,200,294,106,208,192,0.52,0.5136054421768708,0.755,0.285,0.715,0.245,0.611336032388664
0.121,400,"[[151, 143], [49, 57]]",151,49,143,49,200,200,294,106,208,192,0.52,0.5136054421768708,0.755,0.285,0.715,0.245,0.611336032388664
0.122,400,"[[151, 143], [49, 57]]",151,49,143,49,200,200,294,106,208,192,0.52,0.5136054421768708,0.755,0.285,0.715,0.245,0.611336032388664
0.123,400,"[[151, 143], [49, 57]]",151,49,143,49,200,200,294,106,208,192,0.52,0.5136054421768708,0.755,0.285,0.715,0.245,0.611336032388664
0.124,400,"[[151, 143], [49, 57]]",151,49,143,49,200,200,294,106,208,192,0.52,0.5136054421768708,0.755,0.285,0.715,0.245,0.611336032388664
0.125,400,"[[151, 143], [49, 57]]",151,49,143,49,200,200,294,106,208,192,0.52,0.5136054421768708,0.755,0.285,0.715,0.245,0.611336032388664
0.126,400,"[[150, 143], [50, 57]]",150,50,143,50,200,200,293,107,207,193,0.5175,0.5119453924914675,0.75,0.285,0.715,0.25,0.6085192697768761
0.127,400,"[[149, 143], [51, 57]]",149,51,143,51,200,200,292,108,206,194,0.515,0.5102739726027398,0.745,0.285,0.715,0.255,0.6056910569105691
0.128,400,"[[149, 143], [51, 57]]",149,51,143,51,200,200,292,108,206,194,0.515,0.5102739726027398,0.745,0.285,0.715,0.255,0.6056910569105691
0.129,400,"[[149, 141], [51, 59]]",149,51,141,51,200,200,290,110,208,192,0.52,0.5137931034482759,0.745,0.295,0.705,0.255,0.6081632653061224
0.13,400,"[[149, 141], [51, 59]]",149,51,141,51,200,200,290,110,208,192,0.52,0.5137931034482759,0.745,0.295,0.705,0.255,0.6081632653061224
0.131,400,"[[149, 141], [51, 59]]",149,51,141,51,200,200,290,110,208,192,0.52,0.5137931034482759,0.745,0.295,0.705,0.255,0.6081632653061224
0.132,400,"[[149, 141], [51, 59]]",149,51,141,51,200,200,290,110,208,192,0.52,0.5137931034482759,0.745,0.295,0.705,0.255,0.6081632653061224
0.133,400,"[[149, 140], [51, 60]]",149,51,140,51,200,200,289,111,209,191,0.5225,0.5155709342560554,0.745,0.3,0.7,0.255,0.6094069529652352
0.134,400,"[[149, 140], [51, 60]]",149,51,140,51,200,200,289,111,209,191,0.5225,0.5155709342560554,0.745,0.3,0.7,0.255,0.6094069529652352
0.135,400,"[[149, 140], [51, 60]]",149,51,140,51,200,200,289,111,209,191,0.5225,0.5155709342560554,0.745,0.3,0.7,0.255,0.6094069529652352
0.136,400,"[[148, 139], [52, 61]]",148,52,139,52,200,200,287,113,209,191,0.5225,0.5156794425087108,0.74,0.305,0.695,0.26,0.6078028747433265
0.137,400,"[[148, 139], [52, 61]]",148,52,139,52,200,200,287,113,209,191,0.5225,0.5156794425087108,0.74,0.305,0.695,0.26,0.6078028747433265
0.138,400,"[[148, 139], [52, 61]]",148,52,139,52,200,200,287,113,209,191,0.5225,0.5156794425087108,0.74,0.305,0.695,0.26,0.6078028747433265
0.139,400,"[[148, 138], [52, 62]]",148,52,138,52,200,200,286,114,210,190,0.525,0.5174825174825175,0.74,0.31,0.69,0.26,0.6090534979423868
0.14,400,"[[148, 138], [52, 62]]",148,52,138,52,200,200,286,114,210,190,0.525,0.5174825174825175,0.74,0.31,0.69,0.26,0.6090534979423868
0.141,400,"[[148, 138], [52, 62]]",148,52,138,52,200,200,286,114,210,190,0.525,0.5174825174825175,0.74,0.31,0.69,0.26,0.6090534979423868
0.142,400,"[[148, 138], [52, 62]]",148,52,138,52,200,200,286,114,210,190,0.525,0.5174825174825175,0.74,0.31,0.69,0.26,0.6090534979423868
0.143,400,"[[148, 138], [52, 62]]",148,52,138,52,200,200,286,114,210,190,0.525,0.5174825174825175,0.74,0.31,0.69,0.26,0.6090534979423868
0.144,400,"[[148, 138], [52, 62]]",148,52,138,52,200,200,286,114,210,190,0.525,0.5174825174825175,0.74,0.31,0.69,0.26,0.6090534979423868
0.145,400,"[[148, 138], [52, 62]]",148,52,138,52,200,200,286,114,210,190,0.525,0.5174825174825175,0.74,0.31,0.69,0.26,0.6090534979423868
0.146,400,"[[148, 138], [52, 62]]",148,52,138,52,200,200,286,114,210,190,0.525,0.5174825174825175,0.74,0.31,0.69,0.26,0.6090534979423868
0.147,400,"[[148, 137], [52, 63]]",148,52,137,52,200,200,285,115,211,189,0.5275,0.519298245614035,0.74,0.315,0.685,0.26,0.6103092783505154
0.148,400,"[[148, 137], [52, 63]]",148,52,137,52,200,200,285,115,211,189,0.5275,0.519298245614035,0.74,0.315,0.685,0.26,0.6103092783505154
0.149,400,"[[148, 137], [52, 63]]",148,52,137,52,200,200,285,115,211,189,0.5275,0.519298245614035,0.74,0.315,0.685,0.26,0.6103092783505154
0.15,400,"[[146, 137], [54, 63]]",146,54,137,54,200,200,283,117,209,191,0.5225,0.5159010600706714,0.73,0.315,0.685,0.27,0.6045548654244306
0.151,400,"[[146, 137], [54, 63]]",146,54,137,54,200,200,283,117,209,191,0.5225,0.5159010600706714,0.73,0.315,0.685,0.27,0.6045548654244306
0.152,400,"[[146, 136], [54, 64]]",146,54,136,54,200,200,282,118,210,190,0.525,0.5177304964539007,0.73,0.32,0.68,0.27,0.6058091286307055
0.153,400,"[[146, 136], [54, 64]]",146,54,136,54,200,200,282,118,210,190,0.525,0.5177304964539007,0.73,0.32,0.68,0.27,0.6058091286307055
0.154,400,"[[146, 135], [54, 65]]",146,54,135,54,200,200,281,119,211,189,0.5275,0.5195729537366548,0.73,0.325,0.675,0.27,0.6070686070686071
0.155,400,"[[146, 135], [54, 65]]",146,54,135,54,200,200,281,119,211,189,0.5275,0.5195729537366548,0.73,0.325,0.675,0.27,0.6070686070686071
0.156,400,"[[146, 135], [54, 65]]",146,54,135,54,200,200,281,119,211,189,0.5275,0.5195729537366548,0.73,0.325,0.675,0.27,0.6070686070686071
0.157,400,"[[146, 135], [54, 65]]",146,54,135,54,200,200,281,119,211,189,0.5275,0.5195729537366548,0.73,0.325,0.675,0.27,0.6070686070686071
0.158,400,"[[146, 135], [54, 65]]",146,54,135,54,200,200,281,119,211,189,0.5275,0.5195729537366548,0.73,0.325,0.675,0.27,0.6070686070686071
0.159,400,"[[146, 135], [54, 65]]",146,54,135,54,200,200,281,119,211,189,0.5275,0.5195729537366548,0.73,0.325,0.675,0.27,0.6070686070686071
0.16,400,"[[146, 135], [54, 65]]",146,54,135,54,200,200,281,119,211,189,0.5275,0.5195729537366548,0.73,0.325,0.675,0.27,0.6070686070686071
0.161,400,"[[146, 135], [54, 65]]",146,54,135,54,200,200,281,119,211,189,0.5275,0.5195729537366548,0.73,0.325,0.675,0.27,0.6070686070686071
0.162,400,"[[146, 135], [54, 65]]",146,54,135,54,200,200,281,119,211,189,0.5275,0.5195729537366548,0.73,0.325,0.675,0.27,0.6070686070686071
0.163,400,"[[146, 134], [54, 66]]",146,54,134,54,200,200,280,120,212,188,0.53,0.5214285714285715,0.73,0.33,0.67,0.27,0.6083333333333334
0.164,400,"[[146, 134], [54, 66]]",146,54,134,54,200,200,280,120,212,188,0.53,0.5214285714285715,0.73,0.33,0.67,0.27,0.6083333333333334
0.165,400,"[[146, 134], [54, 66]]",146,54,134,54,200,200,280,120,212,188,0.53,0.5214285714285715,0.73,0.33,0.67,0.27,0.6083333333333334
0.166,400,"[[146, 134], [54, 66]]",146,54,134,54,200,200,280,120,212,188,0.53,0.5214285714285715,0.73,0.33,0.67,0.27,0.6083333333333334
0.167,400,"[[146, 134], [54, 66]]",146,54,134,54,200,200,280,120,212,188,0.53,0.5214285714285715,0.73,0.33,0.67,0.27,0.6083333333333334
0.168,400,"[[146, 134], [54, 66]]",146,54,134,54,200,200,280,120,212,188,0.53,0.5214285714285715,0.73,0.33,0.67,0.27,0.6083333333333334
0.169,400,"[[146, 134], [54, 66]]",146,54,134,54,200,200,280,120,212,188,0.53,0.5214285714285715,0.73,0.33,0.67,0.27,0.6083333333333334
0.17,400,"[[146, 134], [54, 66]]",146,54,134,54,200,200,280,120,212,188,0.53,0.5214285714285715,0.73,0.33,0.67,0.27,0.6083333333333334
0.171,400,"[[146, 134], [54, 66]]",146,54,134,54,200,200,280,120,212,188,0.53,0.5214285714285715,0.73,0.33,0.67,0.27,0.6083333333333334
0.172,400,"[[146, 134], [54, 66]]",146,54,134,54,200,200,280,120,212,188,0.53,0.5214285714285715,0.73,0.33,0.67,0.27,0.6083333333333334
0.173,400,"[[146, 134], [54, 66]]",146,54,134,54,200,200,280,120,212,188,0.53,0.5214285714285715,0.73,0.33,0.67,0.27,0.6083333333333334
0.174,400,"[[145, 134], [55, 66]]",145,55,134,55,200,200,279,121,211,189,0.5275,0.5197132616487455,0.725,0.33,0.67,0.275,0.605427974947808
0.175,400,"[[145, 134], [55, 66]]",145,55,134,55,200,200,279,121,211,189,0.5275,0.5197132616487455,0.725,0.33,0.67,0.275,0.605427974947808
0.176,400,"[[145, 134], [55, 66]]",145,55,134,55,200,200,279,121,211,189,0.5275,0.5197132616487455,0.725,0.33,0.67,0.275,0.605427974947808
0.177,400,"[[145, 134], [55, 66]]",145,55,134,55,200,200,279,121,211,189,0.5275,0.5197132616487455,0.725,0.33,0.67,0.275,0.605427974947808
0.178,400,"[[145, 134], [55, 66]]",145,55,134,55,200,200,279,121,211,189,0.5275,0.5197132616487455,0.725,0.33,0.67,0.275,0.605427974947808
0.179,400,"[[144, 134], [56, 66]]",144,56,134,56,200,200,278,122,210,190,0.525,0.5179856115107914,0.72,0.33,0.67,0.28,0.6025104602510459
0.18,400,"[[144, 134], [56, 66]]",144,56,134,56,200,200,278,122,210,190,0.525,0.5179856115107914,0.72,0.33,0.67,0.28,0.6025104602510459
0.181,400,"[[144, 134], [56, 66]]",144,56,134,56,200,200,278,122,210,190,0.525,0.5179856115107914,0.72,0.33,0.67,0.28,0.6025104602510459
0.182,400,"[[143, 134], [57, 66]]",143,57,134,57,200,200,277,123,209,191,0.5225,0.516245487364621,0.715,0.33,0.67,0.285,0.59958071278826
0.183,400,"[[143, 134], [57, 66]]",143,57,134,57,200,200,277,123,209,191,0.5225,0.516245487364621,0.715,0.33,0.67,0.285,0.59958071278826
0.184,400,"[[143, 134], [57, 66]]",143,57,134,57,200,200,277,123,209,191,0.5225,0.516245487364621,0.715,0.33,0.67,0.285,0.59958071278826
0.185,400,"[[143, 134], [57, 66]]",143,57,134,57,200,200,277,123,209,191,0.5225,0.516245487364621,0.715,0.33,0.67,0.285,0.59958071278826
0.186,400,"[[143, 134], [57, 66]]",143,57,134,57,200,200,277,123,209,191,0.5225,0.516245487364621,0.715,0.33,0.67,0.285,0.59958071278826
0.187,400,"[[143, 132], [57, 68]]",143,57,132,57,200,200,275,125,211,189,0.5275,0.52,0.715,0.34,0.66,0.285,0.6021052631578948
0.188,400,"[[143, 132], [57, 68]]",143,57,132,57,200,200,275,125,211,189,0.5275,0.52,0.715,0.34,0.66,0.285,0.6021052631578948
0.189,400,"[[143, 132], [57, 68]]",143,57,132,57,200,200,275,125,211,189,0.5275,0.52,0.715,0.34,0.66,0.285,0.6021052631578948
0.19,400,"[[143, 132], [57, 68]]",143,57,132,57,200,200,275,125,211,189,0.5275,0.52,0.715,0.34,0.66,0.285,0.6021052631578948
0.191,400,"[[143, 132], [57, 68]]",143,57,132,57,200,200,275,125,211,189,0.5275,0.52,0.715,0.34,0.66,0.285,0.6021052631578948
0.192,400,"[[143, 132], [57, 68]]",143,57,132,57,200,200,275,125,211,189,0.5275,0.52,0.715,0.34,0.66,0.285,0.6021052631578948
0.193,400,"[[143, 132], [57, 68]]",143,57,132,57,200,200,275,125,211,189,0.5275,0.52,0.715,0.34,0.66,0.285,0.6021052631578948
0.194,400,"[[143, 132], [57, 68]]",143,57,132,57,200,200,275,125,211,189,0.5275,0.52,0.715,0.34,0.66,0.285,0.6021052631578948
0.195,400,"[[143, 132], [57, 68]]",143,57,132,57,200,200,275,125,211,189,0.5275,0.52,0.715,0.34,0.66,0.285,0.6021052631578948
0.196,400,"[[143, 132], [57, 68]]",143,57,132,57,200,200,275,125,211,189,0.5275,0.52,0.715,0.34,0.66,0.285,0.6021052631578948
0.197,400,"[[143, 132], [57, 68]]",143,57,132,57,200,200,275,125,211,189,0.5275,0.52,0.715,0.34,0.66,0.285,0.6021052631578948
0.198,400,"[[143, 132], [57, 68]]",143,57,132,57,200,200,275,125,211,189,0.5275,0.52,0.715,0.34,0.66,0.285,0.6021052631578948
0.199,400,"[[141, 132], [59, 68]]",141,59,132,59,200,200,273,127,209,191,0.5225,0.5164835164835165,0.705,0.34,0.66,0.295,0.5961945031712474
0.2,400,"[[141, 132], [59, 68]]",141,59,132,59,200,200,273,127,209,191,0.5225,0.5164835164835165,0.705,0.34,0.66,0.295,0.5961945031712474
0.201,400,"[[141, 132], [59, 68]]",141,59,132,59,200,200,273,127,209,191,0.5225,0.5164835164835165,0.705,0.34,0.66,0.295,0.5961945031712474
0.202,400,"[[141, 132], [59, 68]]",141,59,132,59,200,200,273,127,209,191,0.5225,0.5164835164835165,0.705,0.34,0.66,0.295,0.5961945031712474
0.203,400,"[[141, 132], [59, 68]]",141,59,132,59,200,200,273,127,209,191,0.5225,0.5164835164835165,0.705,0.34,0.66,0.295,0.5961945031712474
0.204,400,"[[141, 132], [59, 68]]",141,59,132,59,200,200,273,127,209,191,0.5225,0.5164835164835165,0.705,0.34,0.66,0.295,0.5961945031712474
0.205,400,"[[141, 132], [59, 68]]",141,59,132,59,200,200,273,127,209,191,0.5225,0.5164835164835165,0.705,0.34,0.66,0.295,0.5961945031712474
0.206,400,"[[141, 132], [59, 68]]",141,59,132,59,200,200,273,127,209,191,0.5225,0.5164835164835165,0.705,0.34,0.66,0.295,0.5961945031712474
0.207,400,"[[141, 132], [59, 68]]",141,59,132,59,200,200,273,127,209,191,0.5225,0.5164835164835165,0.705,0.34,0.66,0.295,0.5961945031712474
0.208,400,"[[140, 132], [60, 68]]",140,60,132,60,200,200,272,128,208,192,0.52,0.5147058823529411,0.7,0.34,0.66,0.3,0.5932203389830508
0.209,400,"[[140, 131], [60, 69]]",140,60,131,60,200,200,271,129,209,191,0.5225,0.5166051660516605,0.7,0.345,0.655,0.3,0.59447983014862
0.21,400,"[[140, 131], [60, 69]]",140,60,131,60,200,200,271,129,209,191,0.5225,0.5166051660516605,0.7,0.345,0.655,0.3,0.59447983014862
0.211,400,"[[140, 131], [60, 69]]",140,60,131,60,200,200,271,129,209,191,0.5225,0.5166051660516605,0.7,0.345,0.655,0.3,0.59447983014862
0.212,400,"[[140, 131], [60, 69]]",140,60,131,60,200,200,271,129,209,191,0.5225,0.5166051660516605,0.7,0.345,0.655,0.3,0.59447983014862
0.213,400,"[[140, 131], [60, 69]]",140,60,131,60,200,200,271,129,209,191,0.5225,0.5166051660516605,0.7,0.345,0.655,0.3,0.59447983014862
0.214,400,"[[140, 131], [60, 69]]",140,60,131,60,200,200,271,129,209,191,0.5225,0.5166051660516605,0.7,0.345,0.655,0.3,0.59447983014862
0.215,400,"[[140, 131], [60, 69]]",140,60,131,60,200,200,271,129,209,191,0.5225,0.5166051660516605,0.7,0.345,0.655,0.3,0.59447983014862
0.216,400,"[[140, 131], [60, 69]]",140,60,131,60,200,200,271,129,209,191,0.5225,0.5166051660516605,0.7,0.345,0.655,0.3,0.59447983014862
0.217,400,"[[140, 131], [60, 69]]",140,60,131,60,200,200,271,129,209,191,0.5225,0.5166051660516605,0.7,0.345,0.655,0.3,0.59447983014862
0.218,400,"[[140, 131], [60, 69]]",140,60,131,60,200,200,271,129,209,191,0.5225,0.5166051660516605,0.7,0.345,0.655,0.3,0.59447983014862
0.219,400,"[[140, 131], [60, 69]]",140,60,131,60,200,200,271,129,209,191,0.5225,0.5166051660516605,0.7,0.345,0.655,0.3,0.59447983014862
0.22,400,"[[140, 131], [60, 69]]",140,60,131,60,200,200,271,129,209,191,0.5225,0.5166051660516605,0.7,0.345,0.655,0.3,0.59447983014862
0.221,400,"[[140, 131], [60, 69]]",140,60,131,60,200,200,271,129,209,191,0.5225,0.5166051660516605,0.7,0.345,0.655,0.3,0.59447983014862
0.222,400,"[[140, 131], [60, 69]]",140,60,131,60,200,200,271,129,209,191,0.5225,0.5166051660516605,0.7,0.345,0.655,0.3,0.59447983014862
0.223,400,"[[140, 131], [60, 69]]",140,60,131,60,200,200,271,129,209,191,0.5225,0.5166051660516605,0.7,0.345,0.655,0.3,0.59447983014862
0.224,400,"[[140, 131], [60, 69]]",140,60,131,60,200,200,271,129,209,191,0.5225,0.5166051660516605,0.7,0.345,0.655,0.3,0.59447983014862
0.225,400,"[[140, 131], [60, 69]]",140,60,131,60,200,200,271,129,209,191,0.5225,0.5166051660516605,0.7,0.345,0.655,0.3,0.59447983014862
0.226,400,"[[140, 131], [60, 69]]",140,60,131,60,200,200,271,129,209,191,0.5225,0.5166051660516605,0.7,0.345,0.655,0.3,0.59447983014862
0.227,400,"[[140, 131], [60, 69]]",140,60,131,60,200,200,271,129,209,191,0.5225,0.5166051660516605,0.7,0.345,0.655,0.3,0.59447983014862
0.228,400,"[[140, 130], [60, 70]]",140,60,130,60,200,200,270,130,210,190,0.525,0.5185185185185185,0.7,0.35,0.65,0.3,0.5957446808510639
0.229,400,"[[140, 130], [60, 70]]",140,60,130,60,200,200,270,130,210,190,0.525,0.5185185185185185,0.7,0.35,0.65,0.3,0.5957446808510639
0.23,400,"[[140, 130], [60, 70]]",140,60,130,60,200,200,270,130,210,190,0.525,0.5185185185185185,0.7,0.35,0.65,0.3,0.5957446808510639
0.231,400,"[[140, 129], [60, 71]]",140,60,129,60,200,200,269,131,211,189,0.5275,0.5204460966542751,0.7,0.355,0.645,0.3,0.5970149253731343
0.232,400,"[[140, 129], [60, 71]]",140,60,129,60,200,200,269,131,211,189,0.5275,0.5204460966542751,0.7,0.355,0.645,0.3,0.5970149253731343
0.233,400,"[[140, 129], [60, 71]]",140,60,129,60,200,200,269,131,211,189,0.5275,0.5204460966542751,0.7,0.355,0.645,0.3,0.5970149253731343
0.234,400,"[[140, 129], [60, 71]]",140,60,129,60,200,200,269,131,211,189,0.5275,0.5204460966542751,0.7,0.355,0.645,0.3,0.5970149253731343
0.235,400,"[[140, 129], [60, 71]]",140,60,129,60,200,200,269,131,211,189,0.5275,0.5204460966542751,0.7,0.355,0.645,0.3,0.5970149253731343
0.236,400,"[[140, 129], [60, 71]]",140,60,129,60,200,200,269,131,211,189,0.5275,0.5204460966542751,0.7,0.355,0.645,0.3,0.5970149253731343
0.237,400,"[[140, 129], [60, 71]]",140,60,129,60,200,200,269,131,211,189,0.5275,0.5204460966542751,0.7,0.355,0.645,0.3,0.5970149253731343
0.238,400,"[[140, 129], [60, 71]]",140,60,129,60,200,200,269,131,211,189,0.5275,0.5204460966542751,0.7,0.355,0.645,0.3,0.5970149253731343
0.239,400,"[[140, 129], [60, 71]]",140,60,129,60,200,200,269,131,211,189,0.5275,0.5204460966542751,0.7,0.355,0.645,0.3,0.5970149253731343
0.24,400,"[[138, 129], [62, 71]]",138,62,129,62,200,200,267,133,209,191,0.5225,0.5168539325842697,0.69,0.355,0.645,0.31,0.5910064239828695
0.241,400,"[[138, 129], [62, 71]]",138,62,129,62,200,200,267,133,209,191,0.5225,0.5168539325842697,0.69,0.355,0.645,0.31,0.5910064239828695
0.242,400,"[[138, 129], [62, 71]]",138,62,129,62,200,200,267,133,209,191,0.5225,0.5168539325842697,0.69,0.355,0.645,0.31,0.5910064239828695
0.243,400,"[[138, 128], [62, 72]]",138,62,128,62,200,200,266,134,210,190,0.525,0.518796992481203,0.69,0.36,0.64,0.31,0.592274678111588
0.244,400,"[[138, 128], [62, 72]]",138,62,128,62,200,200,266,134,210,190,0.525,0.518796992481203,0.69,0.36,0.64,0.31,0.592274678111588
0.245,400,"[[138, 128], [62, 72]]",138,62,128,62,200,200,266,134,210,190,0.525,0.518796992481203,0.69,0.36,0.64,0.31,0.592274678111588
0.246,400,"[[138, 128], [62, 72]]",138,62,128,62,200,200,266,134,210,190,0.525,0.518796992481203,0.69,0.36,0.64,0.31,0.592274678111588
0.247,400,"[[138, 128], [62, 72]]",138,62,128,62,200,200,266,134,210,190,0.525,0.518796992481203,0.69,0.36,0.64,0.31,0.592274678111588
0.248,400,"[[138, 127], [62, 73]]",138,62,127,62,200,200,265,135,211,189,0.5275,0.5207547169811321,0.69,0.365,0.635,0.31,0.5935483870967743
0.249,400,"[[138, 127], [62, 73]]",138,62,127,62,200,200,265,135,211,189,0.5275,0.5207547169811321,0.69,0.365,0.635,0.31,0.5935483870967743
0.25,400,"[[138, 127], [62, 73]]",138,62,127,62,200,200,265,135,211,189,0.5275,0.5207547169811321,0.69,0.365,0.635,0.31,0.5935483870967743
0.251,400,"[[138, 127], [62, 73]]",138,62,127,62,200,200,265,135,211,189,0.5275,0.5207547169811321,0.69,0.365,0.635,0.31,0.5935483870967743
0.252,400,"[[138, 127], [62, 73]]",138,62,127,62,200,200,265,135,211,189,0.5275,0.5207547169811321,0.69,0.365,0.635,0.31,0.5935483870967743
0.253,400,"[[138, 127], [62, 73]]",138,62,127,62,200,200,265,135,211,189,0.5275,0.5207547169811321,0.69,0.365,0.635,0.31,0.5935483870967743
0.254,400,"[[138, 127], [62, 73]]",138,62,127,62,200,200,265,135,211,189,0.5275,0.5207547169811321,0.69,0.365,0.635,0.31,0.5935483870967743
0.255,400,"[[138, 126], [62, 74]]",138,62,126,62,200,200,264,136,212,188,0.53,0.5227272727272727,0.69,0.37,0.63,0.31,0.5948275862068966
0.256,400,"[[138, 126], [62, 74]]",138,62,126,62,200,200,264,136,212,188,0.53,0.5227272727272727,0.69,0.37,0.63,0.31,0.5948275862068966
0.257,400,"[[138, 126], [62, 74]]",138,62,126,62,200,200,264,136,212,188,0.53,0.5227272727272727,0.69,0.37,0.63,0.31,0.5948275862068966
0.258,400,"[[138, 125], [62, 75]]",138,62,125,62,200,200,263,137,213,187,0.5325,0.5247148288973384,0.69,0.375,0.625,0.31,0.5961123110151187
0.259,400,"[[137, 125], [63, 75]]",137,63,125,63,200,200,262,138,212,188,0.53,0.5229007633587787,0.685,0.375,0.625,0.315,0.5930735930735931
0.26,400,"[[137, 125], [63, 75]]",137,63,125,63,200,200,262,138,212,188,0.53,0.5229007633587787,0.685,0.375,0.625,0.315,0.5930735930735931
0.261,400,"[[137, 125], [63, 75]]",137,63,125,63,200,200,262,138,212,188,0.53,0.5229007633587787,0.685,0.375,0.625,0.315,0.5930735930735931
0.262,400,"[[137, 125], [63, 75]]",137,63,125,63,200,200,262,138,212,188,0.53,0.5229007633587787,0.685,0.375,0.625,0.315,0.5930735930735931
0.263,400,"[[137, 125], [63, 75]]",137,63,125,63,200,200,262,138,212,188,0.53,0.5229007633587787,0.685,0.375,0.625,0.315,0.5930735930735931
0.264,400,"[[137, 125], [63, 75]]",137,63,125,63,200,200,262,138,212,188,0.53,0.5229007633587787,0.685,0.375,0.625,0.315,0.5930735930735931
0.265,400,"[[137, 125], [63, 75]]",137,63,125,63,200,200,262,138,212,188,0.53,0.5229007633587787,0.685,0.375,0.625,0.315,0.5930735930735931
0.266,400,"[[137, 124], [63, 76]]",137,63,124,63,200,200,261,139,213,187,0.5325,0.524904214559387,0.685,0.38,0.62,0.315,0.5943600867678959
0.267,400,"[[137, 124], [63, 76]]",137,63,124,63,200,200,261,139,213,187,0.5325,0.524904214559387,0.685,0.38,0.62,0.315,0.5943600867678959
0.268,400,"[[137, 123], [63, 77]]",137,63,123,63,200,200,260,140,214,186,0.535,0.5269230769230769,0.685,0.385,0.615,0.315,0.5956521739130436
0.269,400,"[[137, 123], [63, 77]]",137,63,123,63,200,200,260,140,214,186,0.535,0.5269230769230769,0.685,0.385,0.615,0.315,0.5956521739130436
0.27,400,"[[137, 123], [63, 77]]",137,63,123,63,200,200,260,140,214,186,0.535,0.5269230769230769,0.685,0.385,0.615,0.315,0.5956521739130436
0.271,400,"[[137, 123], [63, 77]]",137,63,123,63,200,200,260,140,214,186,0.535,0.5269230769230769,0.685,0.385,0.615,0.315,0.5956521739130436
0.272,400,"[[137, 123], [63, 77]]",137,63,123,63,200,200,260,140,214,186,0.535,0.5269230769230769,0.685,0.385,0.615,0.315,0.5956521739130436
0.273,400,"[[137, 122], [63, 78]]",137,63,122,63,200,200,259,141,215,185,0.5375,0.528957528957529,0.685,0.39,0.61,0.315,0.5969498910675383
0.274,400,"[[137, 122], [63, 78]]",137,63,122,63,200,200,259,141,215,185,0.5375,0.528957528957529,0.685,0.39,0.61,0.315,0.5969498910675383
0.275,400,"[[137, 122], [63, 78]]",137,63,122,63,200,200,259,141,215,185,0.5375,0.528957528957529,0.685,0.39,0.61,0.315,0.5969498910675383
0.276,400,"[[137, 122], [63, 78]]",137,63,122,63,200,200,259,141,215,185,0.5375,0.528957528957529,0.685,0.39,0.61,0.315,0.5969498910675383
0.277,400,"[[137, 121], [63, 79]]",137,63,121,63,200,200,258,142,216,184,0.54,0.5310077519379846,0.685,0.395,0.605,0.315,0.5982532751091704
0.278,400,"[[137, 121], [63, 79]]",137,63,121,63,200,200,258,142,216,184,0.54,0.5310077519379846,0.685,0.395,0.605,0.315,0.5982532751091704
0.279,400,"[[137, 120], [63, 80]]",137,63,120,63,200,200,257,143,217,183,0.5425,0.5330739299610895,0.685,0.4,0.6,0.315,0.5995623632385121
0.28,400,"[[137, 120], [63, 80]]",137,63,120,63,200,200,257,143,217,183,0.5425,0.5330739299610895,0.685,0.4,0.6,0.315,0.5995623632385121
0.281,400,"[[137, 120], [63, 80]]",137,63,120,63,200,200,257,143,217,183,0.5425,0.5330739299610895,0.685,0.4,0.6,0.315,0.5995623632385121
0.282,400,"[[137, 120], [63, 80]]",137,63,120,63,200,200,257,143,217,183,0.5425,0.5330739299610895,0.685,0.4,0.6,0.315,0.5995623632385121
0.283,400,"[[137, 120], [63, 80]]",137,63,120,63,200,200,257,143,217,183,0.5425,0.5330739299610895,0.685,0.4,0.6,0.315,0.5995623632385121
0.284,400,"[[137, 120], [63, 80]]",137,63,120,63,200,200,257,143,217,183,0.5425,0.5330739299610895,0.685,0.4,0.6,0.315,0.5995623632385121
0.285,400,"[[137, 120], [63, 80]]",137,63,120,63,200,200,257,143,217,183,0.5425,0.5330739299610895,0.685,0.4,0.6,0.315,0.5995623632385121
0.286,400,"[[137, 120], [63, 80]]",137,63,120,63,200,200,257,143,217,183,0.5425,0.5330739299610895,0.685,0.4,0.6,0.315,0.5995623632385121
0.287,400,"[[137, 119], [63, 81]]",137,63,119,63,200,200,256,144,218,182,0.545,0.53515625,0.685,0.405,0.595,0.315,0.6008771929824562
0.288,400,"[[137, 118], [63, 82]]",137,63,118,63,200,200,255,145,219,181,0.5475,0.5372549019607843,0.685,0.41,0.59,0.315,0.6021978021978023
0.289,400,"[[137, 118], [63, 82]]",137,63,118,63,200,200,255,145,219,181,0.5475,0.5372549019607843,0.685,0.41,0.59,0.315,0.6021978021978023
0.29,400,"[[137, 118], [63, 82]]",137,63,118,63,200,200,255,145,219,181,0.5475,0.5372549019607843,0.685,0.41,0.59,0.315,0.6021978021978023
0.291,400,"[[137, 118], [63, 82]]",137,63,118,63,200,200,255,145,219,181,0.5475,0.5372549019607843,0.685,0.41,0.59,0.315,0.6021978021978023
0.292,400,"[[137, 118], [63, 82]]",137,63,118,63,200,200,255,145,219,181,0.5475,0.5372549019607843,0.685,0.41,0.59,0.315,0.6021978021978023
0.293,400,"[[137, 118], [63, 82]]",137,63,118,63,200,200,255,145,219,181,0.5475,0.5372549019607843,0.685,0.41,0.59,0.315,0.6021978021978023
0.294,400,"[[137, 118], [63, 82]]",137,63,118,63,200,200,255,145,219,181,0.5475,0.5372549019607843,0.685,0.41,0.59,0.315,0.6021978021978023
0.295,400,"[[137, 118], [63, 82]]",137,63,118,63,200,200,255,145,219,181,0.5475,0.5372549019607843,0.685,0.41,0.59,0.315,0.6021978021978023
0.296,400,"[[137, 118], [63, 82]]",137,63,118,63,200,200,255,145,219,181,0.5475,0.5372549019607843,0.685,0.41,0.59,0.315,0.6021978021978023
0.297,400,"[[137, 118], [63, 82]]",137,63,118,63,200,200,255,145,219,181,0.5475,0.5372549019607843,0.685,0.41,0.59,0.315,0.6021978021978023
0.298,400,"[[137, 118], [63, 82]]",137,63,118,63,200,200,255,145,219,181,0.5475,0.5372549019607843,0.685,0.41,0.59,0.315,0.6021978021978023
0.299,400,"[[137, 118], [63, 82]]",137,63,118,63,200,200,255,145,219,181,0.5475,0.5372549019607843,0.685,0.41,0.59,0.315,0.6021978021978023
0.3,400,"[[137, 118], [63, 82]]",137,63,118,63,200,200,255,145,219,181,0.5475,0.5372549019607843,0.685,0.41,0.59,0.315,0.6021978021978023
0.301,400,"[[137, 118], [63, 82]]",137,63,118,63,200,200,255,145,219,181,0.5475,0.5372549019607843,0.685,0.41,0.59,0.315,0.6021978021978023
0.302,400,"[[137, 118], [63, 82]]",137,63,118,63,200,200,255,145,219,181,0.5475,0.5372549019607843,0.685,0.41,0.59,0.315,0.6021978021978023
0.303,400,"[[137, 118], [63, 82]]",137,63,118,63,200,200,255,145,219,181,0.5475,0.5372549019607843,0.685,0.41,0.59,0.315,0.6021978021978023
0.304,400,"[[137, 118], [63, 82]]",137,63,118,63,200,200,255,145,219,181,0.5475,0.5372549019607843,0.685,0.41,0.59,0.315,0.6021978021978023
0.305,400,"[[137, 118], [63, 82]]",137,63,118,63,200,200,255,145,219,181,0.5475,0.5372549019607843,0.685,0.41,0.59,0.315,0.6021978021978023
0.306,400,"[[137, 118], [63, 82]]",137,63,118,63,200,200,255,145,219,181,0.5475,0.5372549019607843,0.685,0.41,0.59,0.315,0.6021978021978023
0.307,400,"[[137, 118], [63, 82]]",137,63,118,63,200,200,255,145,219,181,0.5475,0.5372549019607843,0.685,0.41,0.59,0.315,0.6021978021978023
0.308,400,"[[137, 118], [63, 82]]",137,63,118,63,200,200,255,145,219,181,0.5475,0.5372549019607843,0.685,0.41,0.59,0.315,0.6021978021978023
0.309,400,"[[137, 118], [63, 82]]",137,63,118,63,200,200,255,145,219,181,0.5475,0.5372549019607843,0.685,0.41,0.59,0.315,0.6021978021978023
0.31,400,"[[137, 118], [63, 82]]",137,63,118,63,200,200,255,145,219,181,0.5475,0.5372549019607843,0.685,0.41,0.59,0.315,0.6021978021978023
0.311,400,"[[137, 118], [63, 82]]",137,63,118,63,200,200,255,145,219,181,0.5475,0.5372549019607843,0.685,0.41,0.59,0.315,0.6021978021978023
0.312,400,"[[137, 118], [63, 82]]",137,63,118,63,200,200,255,145,219,181,0.5475,0.5372549019607843,0.685,0.41,0.59,0.315,0.6021978021978023
0.313,400,"[[137, 118], [63, 82]]",137,63,118,63,200,200,255,145,219,181,0.5475,0.5372549019607843,0.685,0.41,0.59,0.315,0.6021978021978023
0.314,400,"[[137, 118], [63, 82]]",137,63,118,63,200,200,255,145,219,181,0.5475,0.5372549019607843,0.685,0.41,0.59,0.315,0.6021978021978023
0.315,400,"[[137, 118], [63, 82]]",137,63,118,63,200,200,255,145,219,181,0.5475,0.5372549019607843,0.685,0.41,0.59,0.315,0.6021978021978023
0.316,400,"[[137, 118], [63, 82]]",137,63,118,63,200,200,255,145,219,181,0.5475,0.5372549019607843,0.685,0.41,0.59,0.315,0.6021978021978023
0.317,400,"[[137, 118], [63, 82]]",137,63,118,63,200,200,255,145,219,181,0.5475,0.5372549019607843,0.685,0.41,0.59,0.315,0.6021978021978023
0.318,400,"[[137, 118], [63, 82]]",137,63,118,63,200,200,255,145,219,181,0.5475,0.5372549019607843,0.685,0.41,0.59,0.315,0.6021978021978023
0.319,400,"[[137, 117], [63, 83]]",137,63,117,63,200,200,254,146,220,180,0.55,0.5393700787401575,0.685,0.415,0.585,0.315,0.6035242290748899
0.32,400,"[[137, 117], [63, 83]]",137,63,117,63,200,200,254,146,220,180,0.55,0.5393700787401575,0.685,0.415,0.585,0.315,0.6035242290748899
0.321,400,"[[137, 117], [63, 83]]",137,63,117,63,200,200,254,146,220,180,0.55,0.5393700787401575,0.685,0.415,0.585,0.315,0.6035242290748899
0.322,400,"[[137, 117], [63, 83]]",137,63,117,63,200,200,254,146,220,180,0.55,0.5393700787401575,0.685,0.415,0.585,0.315,0.6035242290748899
0.323,400,"[[137, 117], [63, 83]]",137,63,117,63,200,200,254,146,220,180,0.55,0.5393700787401575,0.685,0.415,0.585,0.315,0.6035242290748899
0.324,400,"[[137, 117], [63, 83]]",137,63,117,63,200,200,254,146,220,180,0.55,0.5393700787401575,0.685,0.415,0.585,0.315,0.6035242290748899
0.325,400,"[[137, 117], [63, 83]]",137,63,117,63,200,200,254,146,220,180,0.55,0.5393700787401575,0.685,0.415,0.585,0.315,0.6035242290748899
0.326,400,"[[136, 117], [64, 83]]",136,64,117,64,200,200,253,147,219,181,0.5475,0.5375494071146245,0.68,0.415,0.585,0.32,0.6004415011037527
0.327,400,"[[136, 117], [64, 83]]",136,64,117,64,200,200,253,147,219,181,0.5475,0.5375494071146245,0.68,0.415,0.585,0.32,0.6004415011037527
0.328,400,"[[136, 116], [64, 84]]",136,64,116,64,200,200,252,148,220,180,0.55,0.5396825396825397,0.68,0.42,0.58,0.32,0.6017699115044247
0.329,400,"[[136, 115], [64, 85]]",136,64,115,64,200,200,251,149,221,179,0.5525,0.5418326693227091,0.68,0.425,0.575,0.32,0.6031042128603104
0.33,400,"[[136, 115], [64, 85]]",136,64,115,64,200,200,251,149,221,179,0.5525,0.5418326693227091,0.68,0.425,0.575,0.32,0.6031042128603104
0.331,400,"[[136, 115], [64, 85]]",136,64,115,64,200,200,251,149,221,179,0.5525,0.5418326693227091,0.68,0.425,0.575,0.32,0.6031042128603104
0.332,400,"[[136, 115], [64, 85]]",136,64,115,64,200,200,251,149,221,179,0.5525,0.5418326693227091,0.68,0.425,0.575,0.32,0.6031042128603104
0.333,400,"[[136, 115], [64, 85]]",136,64,115,64,200,200,251,149,221,179,0.5525,0.5418326693227091,0.68,0.425,0.575,0.32,0.6031042128603104
0.334,400,"[[136, 115], [64, 85]]",136,64,115,64,200,200,251,149,221,179,0.5525,0.5418326693227091,0.68,0.425,0.575,0.32,0.6031042128603104
0.335,400,"[[136, 115], [64, 85]]",136,64,115,64,200,200,251,149,221,179,0.5525,0.5418326693227091,0.68,0.425,0.575,0.32,0.6031042128603104
0.336,400,"[[136, 115], [64, 85]]",136,64,115,64,200,200,251,149,221,179,0.5525,0.5418326693227091,0.68,0.425,0.575,0.32,0.6031042128603104
0.337,400,"[[136, 115], [64, 85]]",136,64,115,64,200,200,251,149,221,179,0.5525,0.5418326693227091,0.68,0.425,0.575,0.32,0.6031042128603104
0.338,400,"[[135, 115], [65, 85]]",135,65,115,65,200,200,250,150,220,180,0.55,0.54,0.675,0.425,0.575,0.325,0.6000000000000001
0.339,400,"[[135, 115], [65, 85]]",135,65,115,65,200,200,250,150,220,180,0.55,0.54,0.675,0.425,0.575,0.325,0.6000000000000001
0.34,400,"[[135, 115], [65, 85]]",135,65,115,65,200,200,250,150,220,180,0.55,0.54,0.675,0.425,0.575,0.325,0.6000000000000001
0.341,400,"[[135, 115], [65, 85]]",135,65,115,65,200,200,250,150,220,180,0.55,0.54,0.675,0.425,0.575,0.325,0.6000000000000001
0.342,400,"[[135, 115], [65, 85]]",135,65,115,65,200,200,250,150,220,180,0.55,0.54,0.675,0.425,0.575,0.325,0.6000000000000001
0.343,400,"[[135, 115], [65, 85]]",135,65,115,65,200,200,250,150,220,180,0.55,0.54,0.675,0.425,0.575,0.325,0.6000000000000001
0.344,400,"[[135, 114], [65, 86]]",135,65,114,65,200,200,249,151,221,179,0.5525,0.5421686746987951,0.675,0.43,0.57,0.325,0.601336302895323
0.345,400,"[[135, 113], [65, 87]]",135,65,113,65,200,200,248,152,222,178,0.555,0.5443548387096774,0.675,0.435,0.565,0.325,0.6026785714285715
0.346,400,"[[135, 112], [65, 88]]",135,65,112,65,200,200,247,153,223,177,0.5575,0.5465587044534413,0.675,0.44,0.56,0.325,0.604026845637584
0.347,400,"[[135, 112], [65, 88]]",135,65,112,65,200,200,247,153,223,177,0.5575,0.5465587044534413,0.675,0.44,0.56,0.325,0.604026845637584
0.348,400,"[[135, 110], [65, 90]]",135,65,110,65,200,200,245,155,225,175,0.5625,0.5510204081632653,0.675,0.45,0.55,0.325,0.6067415730337078
0.349,400,"[[135, 110], [65, 90]]",135,65,110,65,200,200,245,155,225,175,0.5625,0.5510204081632653,0.675,0.45,0.55,0.325,0.6067415730337078
0.35,400,"[[135, 109], [65, 91]]",135,65,109,65,200,200,244,156,226,174,0.565,0.5532786885245902,0.675,0.455,0.545,0.325,0.6081081081081081
0.351,400,"[[135, 108], [65, 92]]",135,65,108,65,200,200,243,157,227,173,0.5675,0.5555555555555556,0.675,0.46,0.54,0.325,0.6094808126410836
0.352,400,"[[135, 108], [65, 92]]",135,65,108,65,200,200,243,157,227,173,0.5675,0.5555555555555556,0.675,0.46,0.54,0.325,0.6094808126410836
0.353,400,"[[135, 108], [65, 92]]",135,65,108,65,200,200,243,157,227,173,0.5675,0.5555555555555556,0.675,0.46,0.54,0.325,0.6094808126410836
0.354,400,"[[135, 108], [65, 92]]",135,65,108,65,200,200,243,157,227,173,0.5675,0.5555555555555556,0.675,0.46,0.54,0.325,0.6094808126410836
0.355,400,"[[135, 108], [65, 92]]",135,65,108,65,200,200,243,157,227,173,0.5675,0.5555555555555556,0.675,0.46,0.54,0.325,0.6094808126410836
0.356,400,"[[135, 108], [65, 92]]",135,65,108,65,200,200,243,157,227,173,0.5675,0.5555555555555556,0.675,0.46,0.54,0.325,0.6094808126410836
0.357,400,"[[134, 108], [66, 92]]",134,66,108,66,200,200,242,158,226,174,0.565,0.5537190082644629,0.67,0.46,0.54,0.33,0.6063348416289593
0.358,400,"[[134, 108], [66, 92]]",134,66,108,66,200,200,242,158,226,174,0.565,0.5537190082644629,0.67,0.46,0.54,0.33,0.6063348416289593
0.359,400,"[[134, 108], [66, 92]]",134,66,108,66,200,200,242,158,226,174,0.565,0.5537190082644629,0.67,0.46,0.54,0.33,0.6063348416289593
0.36,400,"[[133, 108], [67, 92]]",133,67,108,67,200,200,241,159,225,175,0.5625,0.5518672199170125,0.665,0.46,0.54,0.335,0.6031746031746033
0.361,400,"[[133, 108], [67, 92]]",133,67,108,67,200,200,241,159,225,175,0.5625,0.5518672199170125,0.665,0.46,0.54,0.335,0.6031746031746033
0.362,400,"[[133, 108], [67, 92]]",133,67,108,67,200,200,241,159,225,175,0.5625,0.5518672199170125,0.665,0.46,0.54,0.335,0.6031746031746033
0.363,400,"[[133, 108], [67, 92]]",133,67,108,67,200,200,241,159,225,175,0.5625,0.5518672199170125,0.665,0.46,0.54,0.335,0.6031746031746033
0.364,400,"[[133, 108], [67, 92]]",133,67,108,67,200,200,241,159,225,175,0.5625,0.5518672199170125,0.665,0.46,0.54,0.335,0.6031746031746033
0.365,400,"[[133, 108], [67, 92]]",133,67,108,67,200,200,241,159,225,175,0.5625,0.5518672199170125,0.665,0.46,0.54,0.335,0.6031746031746033
0.366,400,"[[133, 107], [67, 93]]",133,67,107,67,200,200,240,160,226,174,0.565,0.5541666666666667,0.665,0.465,0.535,0.335,0.6045454545454545
0.367,400,"[[132, 107], [68, 93]]",132,68,107,68,200,200,239,161,225,175,0.5625,0.5523012552301255,0.66,0.465,0.535,0.34,0.601366742596811
0.368,400,"[[132, 107], [68, 93]]",132,68,107,68,200,200,239,161,225,175,0.5625,0.5523012552301255,0.66,0.465,0.535,0.34,0.601366742596811
0.369,400,"[[132, 107], [68, 93]]",132,68,107,68,200,200,239,161,225,175,0.5625,0.5523012552301255,0.66,0.465,0.535,0.34,0.601366742596811
0.37,400,"[[132, 107], [68, 93]]",132,68,107,68,200,200,239,161,225,175,0.5625,0.5523012552301255,0.66,0.465,0.535,0.34,0.601366742596811
0.371,400,"[[132, 107], [68, 93]]",132,68,107,68,200,200,239,161,225,175,0.5625,0.5523012552301255,0.66,0.465,0.535,0.34,0.601366742596811
0.372,400,"[[132, 107], [68, 93]]",132,68,107,68,200,200,239,161,225,175,0.5625,0.5523012552301255,0.66,0.465,0.535,0.34,0.601366742596811
0.373,400,"[[129, 107], [71, 93]]",129,71,107,71,200,200,236,164,222,178,0.555,0.5466101694915254,0.645,0.465,0.535,0.355,0.591743119266055
0.374,400,"[[129, 107], [71, 93]]",129,71,107,71,200,200,236,164,222,178,0.555,0.5466101694915254,0.645,0.465,0.535,0.355,0.591743119266055
0.375,400,"[[129, 107], [71, 93]]",129,71,107,71,200,200,236,164,222,178,0.555,0.5466101694915254,0.645,0.465,0.535,0.355,0.591743119266055
0.376,400,"[[129, 107], [71, 93]]",129,71,107,71,200,200,236,164,222,178,0.555,0.5466101694915254,0.645,0.465,0.535,0.355,0.591743119266055
0.377,400,"[[128, 107], [72, 93]]",128,72,107,72,200,200,235,165,221,179,0.5525,0.5446808510638298,0.64,0.465,0.535,0.36,0.5885057471264368
0.378,400,"[[128, 107], [72, 93]]",128,72,107,72,200,200,235,165,221,179,0.5525,0.5446808510638298,0.64,0.465,0.535,0.36,0.5885057471264368
0.379,400,"[[127, 107], [73, 93]]",127,73,107,73,200,200,234,166,220,180,0.55,0.5427350427350427,0.635,0.465,0.535,0.365,0.5852534562211981
0.38,400,"[[127, 107], [73, 93]]",127,73,107,73,200,200,234,166,220,180,0.55,0.5427350427350427,0.635,0.465,0.535,0.365,0.5852534562211981
0.381,400,"[[127, 107], [73, 93]]",127,73,107,73,200,200,234,166,220,180,0.55,0.5427350427350427,0.635,0.465,0.535,0.365,0.5852534562211981
0.382,400,"[[127, 106], [73, 94]]",127,73,106,73,200,200,233,167,221,179,0.5525,0.5450643776824035,0.635,0.47,0.53,0.365,0.5866050808314088
0.383,400,"[[127, 105], [73, 95]]",127,73,105,73,200,200,232,168,222,178,0.555,0.5474137931034483,0.635,0.475,0.525,0.365,0.587962962962963
0.384,400,"[[127, 105], [73, 95]]",127,73,105,73,200,200,232,168,222,178,0.555,0.5474137931034483,0.635,0.475,0.525,0.365,0.587962962962963
0.385,400,"[[126, 104], [74, 96]]",126,74,104,74,200,200,230,170,222,178,0.555,0.5478260869565217,0.63,0.48,0.52,0.37,0.586046511627907
0.386,400,"[[126, 102], [74, 98]]",126,74,102,74,200,200,228,172,224,176,0.56,0.5526315789473685,0.63,0.49,0.51,0.37,0.588785046728972
0.387,400,"[[126, 102], [74, 98]]",126,74,102,74,200,200,228,172,224,176,0.56,0.5526315789473685,0.63,0.49,0.51,0.37,0.588785046728972
0.388,400,"[[125, 102], [75, 98]]",125,75,102,75,200,200,227,173,223,177,0.5575,0.5506607929515418,0.625,0.49,0.51,0.375,0.585480093676815
0.389,400,"[[125, 101], [75, 99]]",125,75,101,75,200,200,226,174,224,176,0.56,0.5530973451327433,0.625,0.495,0.505,0.375,0.5868544600938966
0.39,400,"[[125, 100], [75, 100]]",125,75,100,75,200,200,225,175,225,175,0.5625,0.5555555555555556,0.625,0.5,0.5,0.375,0.5882352941176471
0.391,400,"[[125, 100], [75, 100]]",125,75,100,75,200,200,225,175,225,175,0.5625,0.5555555555555556,0.625,0.5,0.5,0.375,0.5882352941176471
0.392,400,"[[125, 100], [75, 100]]",125,75,100,75,200,200,225,175,225,175,0.5625,0.5555555555555556,0.625,0.5,0.5,0.375,0.5882352941176471
0.393,400,"[[125, 100], [75, 100]]",125,75,100,75,200,200,225,175,225,175,0.5625,0.5555555555555556,0.625,0.5,0.5,0.375,0.5882352941176471
0.394,400,"[[125, 99], [75, 101]]",125,75,99,75,200,200,224,176,226,174,0.565,0.5580357142857143,0.625,0.505,0.495,0.375,0.5896226415094339
0.395,400,"[[125, 99], [75, 101]]",125,75,99,75,200,200,224,176,226,174,0.565,0.5580357142857143,0.625,0.505,0.495,0.375,0.5896226415094339
0.396,400,"[[125, 99], [75, 101]]",125,75,99,75,200,200,224,176,226,174,0.565,0.5580357142857143,0.625,0.505,0.495,0.375,0.5896226415094339
0.397,400,"[[125, 99], [75, 101]]",125,75,99,75,200,200,224,176,226,174,0.565,0.5580357142857143,0.625,0.505,0.495,0.375,0.5896226415094339
0.398,400,"[[125, 99], [75, 101]]",125,75,99,75,200,200,224,176,226,174,0.565,0.5580357142857143,0.625,0.505,0.495,0.375,0.5896226415094339
0.399,400,"[[125, 99], [75, 101]]",125,75,99,75,200,200,224,176,226,174,0.565,0.5580357142857143,0.625,0.505,0.495,0.375,0.5896226415094339
0.4,400,"[[125, 99], [75, 101]]",125,75,99,75,200,200,224,176,226,174,0.565,0.5580357142857143,0.625,0.505,0.495,0.375,0.5896226415094339
0.401,400,"[[125, 99], [75, 101]]",125,75,99,75,200,200,224,176,226,174,0.565,0.5580357142857143,0.625,0.505,0.495,0.375,0.5896226415094339
0.402,400,"[[125, 99], [75, 101]]",125,75,99,75,200,200,224,176,226,174,0.565,0.5580357142857143,0.625,0.505,0.495,0.375,0.5896226415094339
0.403,400,"[[125, 98], [75, 102]]",125,75,98,75,200,200,223,177,227,173,0.5675,0.5605381165919282,0.625,0.51,0.49,0.375,0.5910165484633569
0.404,400,"[[125, 98], [75, 102]]",125,75,98,75,200,200,223,177,227,173,0.5675,0.5605381165919282,0.625,0.51,0.49,0.375,0.5910165484633569
0.405,400,"[[125, 98], [75, 102]]",125,75,98,75,200,200,223,177,227,173,0.5675,0.5605381165919282,0.625,0.51,0.49,0.375,0.5910165484633569
0.406,400,"[[125, 97], [75, 103]]",125,75,97,75,200,200,222,178,228,172,0.57,0.5630630630630631,0.625,0.515,0.485,0.375,0.5924170616113744
0.407,400,"[[124, 97], [76, 103]]",124,76,97,76,200,200,221,179,227,173,0.5675,0.5610859728506787,0.62,0.515,0.485,0.38,0.5890736342042756
0.408,400,"[[124, 97], [76, 103]]",124,76,97,76,200,200,221,179,227,173,0.5675,0.5610859728506787,0.62,0.515,0.485,0.38,0.5890736342042756
0.409,400,"[[124, 97], [76, 103]]",124,76,97,76,200,200,221,179,227,173,0.5675,0.5610859728506787,0.62,0.515,0.485,0.38,0.5890736342042756
0.41,400,"[[124, 96], [76, 104]]",124,76,96,76,200,200,220,180,228,172,0.57,0.5636363636363636,0.62,0.52,0.48,0.38,0.5904761904761904
0.411,400,"[[124, 96], [76, 104]]",124,76,96,76,200,200,220,180,228,172,0.57,0.5636363636363636,0.62,0.52,0.48,0.38,0.5904761904761904
0.412,400,"[[124, 96], [76, 104]]",124,76,96,76,200,200,220,180,228,172,0.57,0.5636363636363636,0.62,0.52,0.48,0.38,0.5904761904761904
0.413,400,"[[124, 96], [76, 104]]",124,76,96,76,200,200,220,180,228,172,0.57,0.5636363636363636,0.62,0.52,0.48,0.38,0.5904761904761904
0.414,400,"[[124, 96], [76, 104]]",124,76,96,76,200,200,220,180,228,172,0.57,0.5636363636363636,0.62,0.52,0.48,0.38,0.5904761904761904
0.415,400,"[[124, 96], [76, 104]]",124,76,96,76,200,200,220,180,228,172,0.57,0.5636363636363636,0.62,0.52,0.48,0.38,0.5904761904761904
0.416,400,"[[124, 95], [76, 105]]",124,76,95,76,200,200,219,181,229,171,0.5725,0.5662100456621004,0.62,0.525,0.475,0.38,0.5918854415274464
0.417,400,"[[123, 95], [77, 105]]",123,77,95,77,200,200,218,182,228,172,0.57,0.5642201834862385,0.615,0.525,0.475,0.385,0.5885167464114832
0.418,400,"[[122, 95], [78, 105]]",122,78,95,78,200,200,217,183,227,173,0.5675,0.5622119815668203,0.61,0.525,0.475,0.39,0.5851318944844125
0.419,400,"[[122, 95], [78, 105]]",122,78,95,78,200,200,217,183,227,173,0.5675,0.5622119815668203,0.61,0.525,0.475,0.39,0.5851318944844125
0.42,400,"[[122, 95], [78, 105]]",122,78,95,78,200,200,217,183,227,173,0.5675,0.5622119815668203,0.61,0.525,0.475,0.39,0.5851318944844125
0.421,400,"[[122, 95], [78, 105]]",122,78,95,78,200,200,217,183,227,173,0.5675,0.5622119815668203,0.61,0.525,0.475,0.39,0.5851318944844125
0.422,400,"[[122, 95], [78, 105]]",122,78,95,78,200,200,217,183,227,173,0.5675,0.5622119815668203,0.61,0.525,0.475,0.39,0.5851318944844125
0.423,400,"[[122, 95], [78, 105]]",122,78,95,78,200,200,217,183,227,173,0.5675,0.5622119815668203,0.61,0.525,0.475,0.39,0.5851318944844125
0.424,400,"[[122, 95], [78, 105]]",122,78,95,78,200,200,217,183,227,173,0.5675,0.5622119815668203,0.61,0.525,0.475,0.39,0.5851318944844125
0.425,400,"[[122, 95], [78, 105]]",122,78,95,78,200,200,217,183,227,173,0.5675,0.5622119815668203,0.61,0.525,0.475,0.39,0.5851318944844125
0.426,400,"[[122, 94], [78, 106]]",122,78,94,78,200,200,216,184,228,172,0.57,0.5648148148148148,0.61,0.53,0.47,0.39,0.5865384615384615
0.427,400,"[[122, 94], [78, 106]]",122,78,94,78,200,200,216,184,228,172,0.57,0.5648148148148148,0.61,0.53,0.47,0.39,0.5865384615384615
0.428,400,"[[122, 94], [78, 106]]",122,78,94,78,200,200,216,184,228,172,0.57,0.5648148148148148,0.61,0.53,0.47,0.39,0.5865384615384615
0.429,400,"[[121, 94], [79, 106]]",121,79,94,79,200,200,215,185,227,173,0.5675,0.5627906976744186,0.605,0.53,0.47,0.395,0.5831325301204819
0.43,400,"[[121, 94], [79, 106]]",121,79,94,79,200,200,215,185,227,173,0.5675,0.5627906976744186,0.605,0.53,0.47,0.395,0.5831325301204819
0.431,400,"[[121, 94], [79, 106]]",121,79,94,79,200,200,215,185,227,173,0.5675,0.5627906976744186,0.605,0.53,0.47,0.395,0.5831325301204819
0.432,400,"[[121, 94], [79, 106]]",121,79,94,79,200,200,215,185,227,173,0.5675,0.5627906976744186,0.605,0.53,0.47,0.395,0.5831325301204819
0.433,400,"[[121, 94], [79, 106]]",121,79,94,79,200,200,215,185,227,173,0.5675,0.5627906976744186,0.605,0.53,0.47,0.395,0.5831325301204819
0.434,400,"[[119, 94], [81, 106]]",119,81,94,81,200,200,213,187,225,175,0.5625,0.5586854460093896,0.595,0.53,0.47,0.405,0.5762711864406779
0.435,400,"[[119, 94], [81, 106]]",119,81,94,81,200,200,213,187,225,175,0.5625,0.5586854460093896,0.595,0.53,0.47,0.405,0.5762711864406779
0.436,400,"[[119, 94], [81, 106]]",119,81,94,81,200,200,213,187,225,175,0.5625,0.5586854460093896,0.595,0.53,0.47,0.405,0.5762711864406779
0.437,400,"[[119, 94], [81, 106]]",119,81,94,81,200,200,213,187,225,175,0.5625,0.5586854460093896,0.595,0.53,0.47,0.405,0.5762711864406779
0.438,400,"[[119, 94], [81, 106]]",119,81,94,81,200,200,213,187,225,175,0.5625,0.5586854460093896,0.595,0.53,0.47,0.405,0.5762711864406779
0.439,400,"[[119, 94], [81, 106]]",119,81,94,81,200,200,213,187,225,175,0.5625,0.5586854460093896,0.595,0.53,0.47,0.405,0.5762711864406779
0.44,400,"[[119, 94], [81, 106]]",119,81,94,81,200,200,213,187,225,175,0.5625,0.5586854460093896,0.595,0.53,0.47,0.405,0.5762711864406779
0.441,400,"[[119, 94], [81, 106]]",119,81,94,81,200,200,213,187,225,175,0.5625,0.5586854460093896,0.595,0.53,0.47,0.405,0.5762711864406779
0.442,400,"[[119, 94], [81, 106]]",119,81,94,81,200,200,213,187,225,175,0.5625,0.5586854460093896,0.595,0.53,0.47,0.405,0.5762711864406779
0.443,400,"[[119, 94], [81, 106]]",119,81,94,81,200,200,213,187,225,175,0.5625,0.5586854460093896,0.595,0.53,0.47,0.405,0.5762711864406779
0.444,400,"[[119, 94], [81, 106]]",119,81,94,81,200,200,213,187,225,175,0.5625,0.5586854460093896,0.595,0.53,0.47,0.405,0.5762711864406779
0.445,400,"[[119, 94], [81, 106]]",119,81,94,81,200,200,213,187,225,175,0.5625,0.5586854460093896,0.595,0.53,0.47,0.405,0.5762711864406779
0.446,400,"[[118, 94], [82, 106]]",118,82,94,82,200,200,212,188,224,176,0.56,0.5566037735849056,0.59,0.53,0.47,0.41,0.5728155339805824
0.447,400,"[[118, 94], [82, 106]]",118,82,94,82,200,200,212,188,224,176,0.56,0.5566037735849056,0.59,0.53,0.47,0.41,0.5728155339805824
0.448,400,"[[118, 94], [82, 106]]",118,82,94,82,200,200,212,188,224,176,0.56,0.5566037735849056,0.59,0.53,0.47,0.41,0.5728155339805824
0.449,400,"[[118, 94], [82, 106]]",118,82,94,82,200,200,212,188,224,176,0.56,0.5566037735849056,0.59,0.53,0.47,0.41,0.5728155339805824
0.45,400,"[[118, 94], [82, 106]]",118,82,94,82,200,200,212,188,224,176,0.56,0.5566037735849056,0.59,0.53,0.47,0.41,0.5728155339805824
0.451,400,"[[111, 94], [89, 106]]",111,89,94,89,200,200,205,195,217,183,0.5425,0.5414634146341464,0.555,0.53,0.47,0.445,0.5481481481481482
0.452,400,"[[111, 94], [89, 106]]",111,89,94,89,200,200,205,195,217,183,0.5425,0.5414634146341464,0.555,0.53,0.47,0.445,0.5481481481481482
0.453,400,"[[111, 94], [89, 106]]",111,89,94,89,200,200,205,195,217,183,0.5425,0.5414634146341464,0.555,0.53,0.47,0.445,0.5481481481481482
0.454,400,"[[111, 94], [89, 106]]",111,89,94,89,200,200,205,195,217,183,0.5425,0.5414634146341464,0.555,0.53,0.47,0.445,0.5481481481481482
0.455,400,"[[111, 94], [89, 106]]",111,89,94,89,200,200,205,195,217,183,0.5425,0.5414634146341464,0.555,0.53,0.47,0.445,0.5481481481481482
0.456,400,"[[111, 93], [89, 107]]",111,89,93,89,200,200,204,196,218,182,0.545,0.5441176470588235,0.555,0.535,0.465,0.445,0.5495049504950495
0.457,400,"[[111, 93], [89, 107]]",111,89,93,89,200,200,204,196,218,182,0.545,0.5441176470588235,0.555,0.535,0.465,0.445,0.5495049504950495
0.458,400,"[[111, 91], [89, 109]]",111,89,91,89,200,200,202,198,220,180,0.55,0.5495049504950495,0.555,0.545,0.455,0.445,0.5522388059701493
0.459,400,"[[111, 91], [89, 109]]",111,89,91,89,200,200,202,198,220,180,0.55,0.5495049504950495,0.555,0.545,0.455,0.445,0.5522388059701493
0.46,400,"[[109, 91], [91, 109]]",109,91,91,91,200,200,200,200,218,182,0.545,0.545,0.545,0.545,0.455,0.455,0.545
0.461,400,"[[109, 91], [91, 109]]",109,91,91,91,200,200,200,200,218,182,0.545,0.545,0.545,0.545,0.455,0.455,0.545
0.462,400,"[[109, 91], [91, 109]]",109,91,91,91,200,200,200,200,218,182,0.545,0.545,0.545,0.545,0.455,0.455,0.545
0.463,400,"[[109, 91], [91, 109]]",109,91,91,91,200,200,200,200,218,182,0.545,0.545,0.545,0.545,0.455,0.455,0.545
0.464,400,"[[109, 91], [91, 109]]",109,91,91,91,200,200,200,200,218,182,0.545,0.545,0.545,0.545,0.455,0.455,0.545
0.465,400,"[[109, 91], [91, 109]]",109,91,91,91,200,200,200,200,218,182,0.545,0.545,0.545,0.545,0.455,0.455,0.545
0.466,400,"[[109, 91], [91, 109]]",109,91,91,91,200,200,200,200,218,182,0.545,0.545,0.545,0.545,0.455,0.455,0.545
0.467,400,"[[109, 91], [91, 109]]",109,91,91,91,200,200,200,200,218,182,0.545,0.545,0.545,0.545,0.455,0.455,0.545
0.468,400,"[[109, 91], [91, 109]]",109,91,91,91,200,200,200,200,218,182,0.545,0.545,0.545,0.545,0.455,0.455,0.545
0.469,400,"[[109, 91], [91, 109]]",109,91,91,91,200,200,200,200,218,182,0.545,0.545,0.545,0.545,0.455,0.455,0.545
0.47,400,"[[109, 91], [91, 109]]",109,91,91,91,200,200,200,200,218,182,0.545,0.545,0.545,0.545,0.455,0.455,0.545
0.471,400,"[[109, 91], [91, 109]]",109,91,91,91,200,200,200,200,218,182,0.545,0.545,0.545,0.545,0.455,0.455,0.545
0.472,400,"[[109, 90], [91, 110]]",109,91,90,91,200,200,199,201,219,181,0.5475,0.5477386934673367,0.545,0.55,0.45,0.455,0.5463659147869675
0.473,400,"[[109, 90], [91, 110]]",109,91,90,91,200,200,199,201,219,181,0.5475,0.5477386934673367,0.545,0.55,0.45,0.455,0.5463659147869675
0.474,400,"[[109, 90], [91, 110]]",109,91,90,91,200,200,199,201,219,181,0.5475,0.5477386934673367,0.545,0.55,0.45,0.455,0.5463659147869675
0.475,400,"[[109, 90], [91, 110]]",109,91,90,91,200,200,199,201,219,181,0.5475,0.5477386934673367,0.545,0.55,0.45,0.455,0.5463659147869675
0.476,400,"[[109, 90], [91, 110]]",109,91,90,91,200,200,199,201,219,181,0.5475,0.5477386934673367,0.545,0.55,0.45,0.455,0.5463659147869675
0.477,400,"[[109, 90], [91, 110]]",109,91,90,91,200,200,199,201,219,181,0.5475,0.5477386934673367,0.545,0.55,0.45,0.455,0.5463659147869675
0.478,400,"[[107, 90], [93, 110]]",107,93,90,93,200,200,197,203,217,183,0.5425,0.5431472081218274,0.535,0.55,0.45,0.465,0.5390428211586902
0.479,400,"[[107, 90], [93, 110]]",107,93,90,93,200,200,197,203,217,183,0.5425,0.5431472081218274,0.535,0.55,0.45,0.465,0.5390428211586902
0.48,400,"[[107, 89], [93, 111]]",107,93,89,93,200,200,196,204,218,182,0.545,0.5459183673469388,0.535,0.555,0.445,0.465,0.5404040404040404
0.481,400,"[[107, 89], [93, 111]]",107,93,89,93,200,200,196,204,218,182,0.545,0.5459183673469388,0.535,0.555,0.445,0.465,0.5404040404040404
0.482,400,"[[107, 89], [93, 111]]",107,93,89,93,200,200,196,204,218,182,0.545,0.5459183673469388,0.535,0.555,0.445,0.465,0.5404040404040404
0.483,400,"[[107, 89], [93, 111]]",107,93,89,93,200,200,196,204,218,182,0.545,0.5459183673469388,0.535,0.555,0.445,0.465,0.5404040404040404
0.484,400,"[[107, 89], [93, 111]]",107,93,89,93,200,200,196,204,218,182,0.545,0.5459183673469388,0.535,0.555,0.445,0.465,0.5404040404040404
0.485,400,"[[107, 89], [93, 111]]",107,93,89,93,200,200,196,204,218,182,0.545,0.5459183673469388,0.535,0.555,0.445,0.465,0.5404040404040404
0.486,400,"[[107, 88], [93, 112]]",107,93,88,93,200,200,195,205,219,181,0.5475,0.5487179487179488,0.535,0.56,0.44,0.465,0.5417721518987343
0.487,400,"[[107, 88], [93, 112]]",107,93,88,93,200,200,195,205,219,181,0.5475,0.5487179487179488,0.535,0.56,0.44,0.465,0.5417721518987343
0.488,400,"[[107, 88], [93, 112]]",107,93,88,93,200,200,195,205,219,181,0.5475,0.5487179487179488,0.535,0.56,0.44,0.465,0.5417721518987343
0.489,400,"[[107, 88], [93, 112]]",107,93,88,93,200,200,195,205,219,181,0.5475,0.5487179487179488,0.535,0.56,0.44,0.465,0.5417721518987343
0.49,400,"[[107, 88], [93, 112]]",107,93,88,93,200,200,195,205,219,181,0.5475,0.5487179487179488,0.535,0.56,0.44,0.465,0.5417721518987343
0.491,400,"[[107, 88], [93, 112]]",107,93,88,93,200,200,195,205,219,181,0.5475,0.5487179487179488,0.535,0.56,0.44,0.465,0.5417721518987343
0.492,400,"[[107, 88], [93, 112]]",107,93,88,93,200,200,195,205,219,181,0.5475,0.5487179487179488,0.535,0.56,0.44,0.465,0.5417721518987343
0.493,400,"[[107, 88], [93, 112]]",107,93,88,93,200,200,195,205,219,181,0.5475,0.5487179487179488,0.535,0.56,0.44,0.465,0.5417721518987343
0.494,400,"[[107, 88], [93, 112]]",107,93,88,93,200,200,195,205,219,181,0.5475,0.5487179487179488,0.535,0.56,0.44,0.465,0.5417721518987343
0.495,400,"[[107, 88], [93, 112]]",107,93,88,93,200,200,195,205,219,181,0.5475,0.5487179487179488,0.535,0.56,0.44,0.465,0.5417721518987343
0.496,400,"[[107, 88], [93, 112]]",107,93,88,93,200,200,195,205,219,181,0.5475,0.5487179487179488,0.535,0.56,0.44,0.465,0.5417721518987343
0.497,400,"[[107, 88], [93, 112]]",107,93,88,93,200,200,195,205,219,181,0.5475,0.5487179487179488,0.535,0.56,0.44,0.465,0.5417721518987343
0.498,400,"[[107, 87], [93, 113]]",107,93,87,93,200,200,194,206,220,180,0.55,0.5515463917525774,0.535,0.565,0.435,0.465,0.5431472081218275
0.499,400,"[[107, 87], [93, 113]]",107,93,87,93,200,200,194,206,220,180,0.55,0.5515463917525774,0.535,0.565,0.435,0.465,0.5431472081218275
0.5,400,"[[107, 87], [93, 113]]",107,93,87,93,200,200,194,206,220,180,0.55,0.5515463917525774,0.535,0.565,0.435,0.465,0.5431472081218275
0.501,400,"[[107, 87], [93, 113]]",107,93,87,93,200,200,194,206,220,180,0.55,0.5515463917525774,0.535,0.565,0.435,0.465,0.5431472081218275
0.502,400,"[[107, 87], [93, 113]]",107,93,87,93,200,200,194,206,220,180,0.55,0.5515463917525774,0.535,0.565,0.435,0.465,0.5431472081218275
0.503,400,"[[107, 87], [93, 113]]",107,93,87,93,200,200,194,206,220,180,0.55,0.5515463917525774,0.535,0.565,0.435,0.465,0.5431472081218275
0.504,400,"[[107, 87], [93, 113]]",107,93,87,93,200,200,194,206,220,180,0.55,0.5515463917525774,0.535,0.565,0.435,0.465,0.5431472081218275
0.505,400,"[[107, 87], [93, 113]]",107,93,87,93,200,200,194,206,220,180,0.55,0.5515463917525774,0.535,0.565,0.435,0.465,0.5431472081218275
0.506,400,"[[107, 87], [93, 113]]",107,93,87,93,200,200,194,206,220,180,0.55,0.5515463917525774,0.535,0.565,0.435,0.465,0.5431472081218275
0.507,400,"[[107, 87], [93, 113]]",107,93,87,93,200,200,194,206,220,180,0.55,0.5515463917525774,0.535,0.565,0.435,0.465,0.5431472081218275
0.508,400,"[[107, 86], [93, 114]]",107,93,86,93,200,200,193,207,221,179,0.5525,0.5544041450777202,0.535,0.57,0.43,0.465,0.544529262086514
0.509,400,"[[107, 86], [93, 114]]",107,93,86,93,200,200,193,207,221,179,0.5525,0.5544041450777202,0.535,0.57,0.43,0.465,0.544529262086514
0.51,400,"[[107, 86], [93, 114]]",107,93,86,93,200,200,193,207,221,179,0.5525,0.5544041450777202,0.535,0.57,0.43,0.465,0.544529262086514
0.511,400,"[[107, 85], [93, 115]]",107,93,85,93,200,200,192,208,222,178,0.555,0.5572916666666666,0.535,0.575,0.425,0.465,0.5459183673469388
0.512,400,"[[107, 85], [93, 115]]",107,93,85,93,200,200,192,208,222,178,0.555,0.5572916666666666,0.535,0.575,0.425,0.465,0.5459183673469388
0.513,400,"[[107, 85], [93, 115]]",107,93,85,93,200,200,192,208,222,178,0.555,0.5572916666666666,0.535,0.575,0.425,0.465,0.5459183673469388
0.514,400,"[[107, 85], [93, 115]]",107,93,85,93,200,200,192,208,222,178,0.555,0.5572916666666666,0.535,0.575,0.425,0.465,0.5459183673469388
0.515,400,"[[107, 85], [93, 115]]",107,93,85,93,200,200,192,208,222,178,0.555,0.5572916666666666,0.535,0.575,0.425,0.465,0.5459183673469388
0.516,400,"[[107, 84], [93, 116]]",107,93,84,93,200,200,191,209,223,177,0.5575,0.5602094240837696,0.535,0.58,0.42,0.465,0.5473145780051152
0.517,400,"[[107, 84], [93, 116]]",107,93,84,93,200,200,191,209,223,177,0.5575,0.5602094240837696,0.535,0.58,0.42,0.465,0.5473145780051152
0.518,400,"[[107, 83], [93, 117]]",107,93,83,93,200,200,190,210,224,176,0.56,0.5631578947368421,0.535,0.585,0.415,0.465,0.5487179487179488
0.519,400,"[[107, 83], [93, 117]]",107,93,83,93,200,200,190,210,224,176,0.56,0.5631578947368421,0.535,0.585,0.415,0.465,0.5487179487179488
0.52,400,"[[107, 83], [93, 117]]",107,93,83,93,200,200,190,210,224,176,0.56,0.5631578947368421,0.535,0.585,0.415,0.465,0.5487179487179488
0.521,400,"[[107, 83], [93, 117]]",107,93,83,93,200,200,190,210,224,176,0.56,0.5631578947368421,0.535,0.585,0.415,0.465,0.5487179487179488
0.522,400,"[[107, 83], [93, 117]]",107,93,83,93,200,200,190,210,224,176,0.56,0.5631578947368421,0.535,0.585,0.415,0.465,0.5487179487179488
0.523,400,"[[106, 82], [94, 118]]",106,94,82,94,200,200,188,212,224,176,0.56,0.5638297872340425,0.53,0.59,0.41,0.47,0.5463917525773196
0.524,400,"[[106, 82], [94, 118]]",106,94,82,94,200,200,188,212,224,176,0.56,0.5638297872340425,0.53,0.59,0.41,0.47,0.5463917525773196
0.525,400,"[[106, 82], [94, 118]]",106,94,82,94,200,200,188,212,224,176,0.56,0.5638297872340425,0.53,0.59,0.41,0.47,0.5463917525773196
0.526,400,"[[106, 82], [94, 118]]",106,94,82,94,200,200,188,212,224,176,0.56,0.5638297872340425,0.53,0.59,0.41,0.47,0.5463917525773196
0.527,400,"[[106, 82], [94, 118]]",106,94,82,94,200,200,188,212,224,176,0.56,0.5638297872340425,0.53,0.59,0.41,0.47,0.5463917525773196
0.528,400,"[[106, 82], [94, 118]]",106,94,82,94,200,200,188,212,224,176,0.56,0.5638297872340425,0.53,0.59,0.41,0.47,0.5463917525773196
0.529,400,"[[106, 82], [94, 118]]",106,94,82,94,200,200,188,212,224,176,0.56,0.5638297872340425,0.53,0.59,0.41,0.47,0.5463917525773196
0.53,400,"[[106, 82], [94, 118]]",106,94,82,94,200,200,188,212,224,176,0.56,0.5638297872340425,0.53,0.59,0.41,0.47,0.5463917525773196
0.531,400,"[[106, 82], [94, 118]]",106,94,82,94,200,200,188,212,224,176,0.56,0.5638297872340425,0.53,0.59,0.41,0.47,0.5463917525773196
0.532,400,"[[106, 82], [94, 118]]",106,94,82,94,200,200,188,212,224,176,0.56,0.5638297872340425,0.53,0.59,0.41,0.47,0.5463917525773196
0.533,400,"[[106, 81], [94, 119]]",106,94,81,94,200,200,187,213,225,175,0.5625,0.5668449197860963,0.53,0.595,0.405,0.47,0.5478036175710594
0.534,400,"[[106, 81], [94, 119]]",106,94,81,94,200,200,187,213,225,175,0.5625,0.5668449197860963,0.53,0.595,0.405,0.47,0.5478036175710594
0.535,400,"[[106, 81], [94, 119]]",106,94,81,94,200,200,187,213,225,175,0.5625,0.5668449197860963,0.53,0.595,0.405,0.47,0.5478036175710594
0.536,400,"[[106, 81], [94, 119]]",106,94,81,94,200,200,187,213,225,175,0.5625,0.5668449197860963,0.53,0.595,0.405,0.47,0.5478036175710594
0.537,400,"[[106, 81], [94, 119]]",106,94,81,94,200,200,187,213,225,175,0.5625,0.5668449197860963,0.53,0.595,0.405,0.47,0.5478036175710594
0.538,400,"[[106, 81], [94, 119]]",106,94,81,94,200,200,187,213,225,175,0.5625,0.5668449197860963,0.53,0.595,0.405,0.47,0.5478036175710594
0.539,400,"[[106, 81], [94, 119]]",106,94,81,94,200,200,187,213,225,175,0.5625,0.5668449197860963,0.53,0.595,0.405,0.47,0.5478036175710594
0.54,400,"[[106, 81], [94, 119]]",106,94,81,94,200,200,187,213,225,175,0.5625,0.5668449197860963,0.53,0.595,0.405,0.47,0.5478036175710594
0.541,400,"[[106, 81], [94, 119]]",106,94,81,94,200,200,187,213,225,175,0.5625,0.5668449197860963,0.53,0.595,0.405,0.47,0.5478036175710594
0.542,400,"[[106, 81], [94, 119]]",106,94,81,94,200,200,187,213,225,175,0.5625,0.5668449197860963,0.53,0.595,0.405,0.47,0.5478036175710594
0.543,400,"[[105, 81], [95, 119]]",105,95,81,95,200,200,186,214,224,176,0.56,0.5645161290322581,0.525,0.595,0.405,0.475,0.544041450777202
0.544,400,"[[105, 81], [95, 119]]",105,95,81,95,200,200,186,214,224,176,0.56,0.5645161290322581,0.525,0.595,0.405,0.475,0.544041450777202
0.545,400,"[[105, 81], [95, 119]]",105,95,81,95,200,200,186,214,224,176,0.56,0.5645161290322581,0.525,0.595,0.405,0.475,0.544041450777202
0.546,400,"[[105, 80], [95, 120]]",105,95,80,95,200,200,185,215,225,175,0.5625,0.5675675675675675,0.525,0.6,0.4,0.475,0.5454545454545455
0.547,400,"[[105, 79], [95, 121]]",105,95,79,95,200,200,184,216,226,174,0.565,0.5706521739130435,0.525,0.605,0.395,0.475,0.5468750000000001
0.548,400,"[[105, 79], [95, 121]]",105,95,79,95,200,200,184,216,226,174,0.565,0.5706521739130435,0.525,0.605,0.395,0.475,0.5468750000000001
0.549,400,"[[105, 79], [95, 121]]",105,95,79,95,200,200,184,216,226,174,0.565,0.5706521739130435,0.525,0.605,0.395,0.475,0.5468750000000001
0.55,400,"[[105, 79], [95, 121]]",105,95,79,95,200,200,184,216,226,174,0.565,0.5706521739130435,0.525,0.605,0.395,0.475,0.5468750000000001
0.551,400,"[[105, 79], [95, 121]]",105,95,79,95,200,200,184,216,226,174,0.565,0.5706521739130435,0.525,0.605,0.395,0.475,0.5468750000000001
0.552,400,"[[104, 79], [96, 121]]",104,96,79,96,200,200,183,217,225,175,0.5625,0.5683060109289617,0.52,0.605,0.395,0.48,0.5430809399477807
0.553,400,"[[104, 79], [96, 121]]",104,96,79,96,200,200,183,217,225,175,0.5625,0.5683060109289617,0.52,0.605,0.395,0.48,0.5430809399477807
0.554,400,"[[104, 79], [96, 121]]",104,96,79,96,200,200,183,217,225,175,0.5625,0.5683060109289617,0.52,0.605,0.395,0.48,0.5430809399477807
0.555,400,"[[103, 79], [97, 121]]",103,97,79,97,200,200,182,218,224,176,0.56,0.5659340659340659,0.515,0.605,0.395,0.485,0.5392670157068064
0.556,400,"[[103, 78], [97, 122]]",103,97,78,97,200,200,181,219,225,175,0.5625,0.569060773480663,0.515,0.61,0.39,0.485,0.5406824146981627
0.557,400,"[[103, 78], [97, 122]]",103,97,78,97,200,200,181,219,225,175,0.5625,0.569060773480663,0.515,0.61,0.39,0.485,0.5406824146981627
0.558,400,"[[103, 78], [97, 122]]",103,97,78,97,200,200,181,219,225,175,0.5625,0.569060773480663,0.515,0.61,0.39,0.485,0.5406824146981627
0.559,400,"[[103, 78], [97, 122]]",103,97,78,97,200,200,181,219,225,175,0.5625,0.569060773480663,0.515,0.61,0.39,0.485,0.5406824146981627
0.56,400,"[[103, 78], [97, 122]]",103,97,78,97,200,200,181,219,225,175,0.5625,0.569060773480663,0.515,0.61,0.39,0.485,0.5406824146981627
0.561,400,"[[103, 78], [97, 122]]",103,97,78,97,200,200,181,219,225,175,0.5625,0.569060773480663,0.515,0.61,0.39,0.485,0.5406824146981627
0.562,400,"[[103, 77], [97, 123]]",103,97,77,97,200,200,180,220,226,174,0.565,0.5722222222222222,0.515,0.615,0.385,0.485,0.5421052631578948
0.563,400,"[[103, 76], [97, 124]]",103,97,76,97,200,200,179,221,227,173,0.5675,0.5754189944134078,0.515,0.62,0.38,0.485,0.5435356200527706
0.564,400,"[[103, 76], [97, 124]]",103,97,76,97,200,200,179,221,227,173,0.5675,0.5754189944134078,0.515,0.62,0.38,0.485,0.5435356200527706
0.565,400,"[[103, 76], [97, 124]]",103,97,76,97,200,200,179,221,227,173,0.5675,0.5754189944134078,0.515,0.62,0.38,0.485,0.5435356200527706
0.566,400,"[[103, 76], [97, 124]]",103,97,76,97,200,200,179,221,227,173,0.5675,0.5754189944134078,0.515,0.62,0.38,0.485,0.5435356200527706
0.567,400,"[[103, 76], [97, 124]]",103,97,76,97,200,200,179,221,227,173,0.5675,0.5754189944134078,0.515,0.62,0.38,0.485,0.5435356200527706
0.568,400,"[[103, 75], [97, 125]]",103,97,75,97,200,200,178,222,228,172,0.57,0.5786516853932584,0.515,0.625,0.375,0.485,0.5449735449735449
0.569,400,"[[103, 75], [97, 125]]",103,97,75,97,200,200,178,222,228,172,0.57,0.5786516853932584,0.515,0.625,0.375,0.485,0.5449735449735449
0.57,400,"[[103, 75], [97, 125]]",103,97,75,97,200,200,178,222,228,172,0.57,0.5786516853932584,0.515,0.625,0.375,0.485,0.5449735449735449
0.571,400,"[[103, 75], [97, 125]]",103,97,75,97,200,200,178,222,228,172,0.57,0.5786516853932584,0.515,0.625,0.375,0.485,0.5449735449735449
0.572,400,"[[103, 75], [97, 125]]",103,97,75,97,200,200,178,222,228,172,0.57,0.5786516853932584,0.515,0.625,0.375,0.485,0.5449735449735449
0.573,400,"[[103, 75], [97, 125]]",103,97,75,97,200,200,178,222,228,172,0.57,0.5786516853932584,0.515,0.625,0.375,0.485,0.5449735449735449
0.574,400,"[[103, 75], [97, 125]]",103,97,75,97,200,200,178,222,228,172,0.57,0.5786516853932584,0.515,0.625,0.375,0.485,0.5449735449735449
0.575,400,"[[102, 74], [98, 126]]",102,98,74,98,200,200,176,224,228,172,0.57,0.5795454545454546,0.51,0.63,0.37,0.49,0.5425531914893618
0.576,400,"[[102, 74], [98, 126]]",102,98,74,98,200,200,176,224,228,172,0.57,0.5795454545454546,0.51,0.63,0.37,0.49,0.5425531914893618
0.577,400,"[[102, 74], [98, 126]]",102,98,74,98,200,200,176,224,228,172,0.57,0.5795454545454546,0.51,0.63,0.37,0.49,0.5425531914893618
0.578,400,"[[102, 74], [98, 126]]",102,98,74,98,200,200,176,224,228,172,0.57,0.5795454545454546,0.51,0.63,0.37,0.49,0.5425531914893618
0.579,400,"[[102, 74], [98, 126]]",102,98,74,98,200,200,176,224,228,172,0.57,0.5795454545454546,0.51,0.63,0.37,0.49,0.5425531914893618
0.58,400,"[[102, 74], [98, 126]]",102,98,74,98,200,200,176,224,228,172,0.57,0.5795454545454546,0.51,0.63,0.37,0.49,0.5425531914893618
0.581,400,"[[102, 74], [98, 126]]",102,98,74,98,200,200,176,224,228,172,0.57,0.5795454545454546,0.51,0.63,0.37,0.49,0.5425531914893618
0.582,400,"[[101, 74], [99, 126]]",101,99,74,99,200,200,175,225,227,173,0.5675,0.5771428571428572,0.505,0.63,0.37,0.495,0.5386666666666666
0.583,400,"[[101, 74], [99, 126]]",101,99,74,99,200,200,175,225,227,173,0.5675,0.5771428571428572,0.505,0.63,0.37,0.495,0.5386666666666666
0.584,400,"[[101, 74], [99, 126]]",101,99,74,99,200,200,175,225,227,173,0.5675,0.5771428571428572,0.505,0.63,0.37,0.495,0.5386666666666666
0.585,400,"[[101, 74], [99, 126]]",101,99,74,99,200,200,175,225,227,173,0.5675,0.5771428571428572,0.505,0.63,0.37,0.495,0.5386666666666666
0.586,400,"[[101, 74], [99, 126]]",101,99,74,99,200,200,175,225,227,173,0.5675,0.5771428571428572,0.505,0.63,0.37,0.495,0.5386666666666666
0.587,400,"[[101, 74], [99, 126]]",101,99,74,99,200,200,175,225,227,173,0.5675,0.5771428571428572,0.505,0.63,0.37,0.495,0.5386666666666666
0.588,400,"[[101, 73], [99, 127]]",101,99,73,99,200,200,174,226,228,172,0.57,0.5804597701149425,0.505,0.635,0.365,0.495,0.5401069518716577
0.589,400,"[[101, 73], [99, 127]]",101,99,73,99,200,200,174,226,228,172,0.57,0.5804597701149425,0.505,0.635,0.365,0.495,0.5401069518716577
0.59,400,"[[100, 73], [100, 127]]",100,100,73,100,200,200,173,227,227,173,0.5675,0.5780346820809249,0.5,0.635,0.365,0.5,0.5361930294906166
0.591,400,"[[100, 73], [100, 127]]",100,100,73,100,200,200,173,227,227,173,0.5675,0.5780346820809249,0.5,0.635,0.365,0.5,0.5361930294906166
0.592,400,"[[100, 73], [100, 127]]",100,100,73,100,200,200,173,227,227,173,0.5675,0.5780346820809249,0.5,0.635,0.365,0.5,0.5361930294906166
0.593,400,"[[100, 72], [100, 128]]",100,100,72,100,200,200,172,228,228,172,0.57,0.5813953488372093,0.5,0.64,0.36,0.5,0.5376344086021505
0.594,400,"[[100, 72], [100, 128]]",100,100,72,100,200,200,172,228,228,172,0.57,0.5813953488372093,0.5,0.64,0.36,0.5,0.5376344086021505
0.595,400,"[[100, 72], [100, 128]]",100,100,72,100,200,200,172,228,228,172,0.57,0.5813953488372093,0.5,0.64,0.36,0.5,0.5376344086021505
0.596,400,"[[100, 72], [100, 128]]",100,100,72,100,200,200,172,228,228,172,0.57,0.5813953488372093,0.5,0.64,0.36,0.5,0.5376344086021505
0.597,400,"[[100, 71], [100, 129]]",100,100,71,100,200,200,171,229,229,171,0.5725,0.5847953216374269,0.5,0.645,0.355,0.5,0.5390835579514824
0.598,400,"[[100, 71], [100, 129]]",100,100,71,100,200,200,171,229,229,171,0.5725,0.5847953216374269,0.5,0.645,0.355,0.5,0.5390835579514824
0.599,400,"[[99, 71], [101, 129]]",99,101,71,101,200,200,170,230,228,172,0.57,0.5823529411764706,0.495,0.645,0.355,0.505,0.5351351351351352
0.6,400,"[[99, 71], [101, 129]]",99,101,71,101,200,200,170,230,228,172,0.57,0.5823529411764706,0.495,0.645,0.355,0.505,0.5351351351351352
0.601,400,"[[98, 71], [102, 129]]",98,102,71,102,200,200,169,231,227,173,0.5675,0.5798816568047337,0.49,0.645,0.355,0.51,0.5311653116531165
0.602,400,"[[98, 71], [102, 129]]",98,102,71,102,200,200,169,231,227,173,0.5675,0.5798816568047337,0.49,0.645,0.355,0.51,0.5311653116531165
0.603,400,"[[98, 71], [102, 129]]",98,102,71,102,200,200,169,231,227,173,0.5675,0.5798816568047337,0.49,0.645,0.355,0.51,0.5311653116531165
0.604,400,"[[98, 71], [102, 129]]",98,102,71,102,200,200,169,231,227,173,0.5675,0.5798816568047337,0.49,0.645,0.355,0.51,0.5311653116531165
0.605,400,"[[98, 71], [102, 129]]",98,102,71,102,200,200,169,231,227,173,0.5675,0.5798816568047337,0.49,0.645,0.355,0.51,0.5311653116531165
0.606,400,"[[98, 71], [102, 129]]",98,102,71,102,200,200,169,231,227,173,0.5675,0.5798816568047337,0.49,0.645,0.355,0.51,0.5311653116531165
0.607,400,"[[98, 70], [102, 130]]",98,102,70,102,200,200,168,232,228,172,0.57,0.5833333333333334,0.49,0.65,0.35,0.51,0.532608695652174
0.608,400,"[[98, 70], [102, 130]]",98,102,70,102,200,200,168,232,228,172,0.57,0.5833333333333334,0.49,0.65,0.35,0.51,0.532608695652174
0.609,400,"[[98, 70], [102, 130]]",98,102,70,102,200,200,168,232,228,172,0.57,0.5833333333333334,0.49,0.65,0.35,0.51,0.532608695652174
0.61,400,"[[98, 69], [102, 131]]",98,102,69,102,200,200,167,233,229,171,0.5725,0.5868263473053892,0.49,0.655,0.345,0.51,0.5340599455040871
0.611,400,"[[98, 69], [102, 131]]",98,102,69,102,200,200,167,233,229,171,0.5725,0.5868263473053892,0.49,0.655,0.345,0.51,0.5340599455040871
0.612,400,"[[98, 68], [102, 132]]",98,102,68,102,200,200,166,234,230,170,0.575,0.5903614457831325,0.49,0.66,0.34,0.51,0.5355191256830601
0.613,400,"[[98, 68], [102, 132]]",98,102,68,102,200,200,166,234,230,170,0.575,0.5903614457831325,0.49,0.66,0.34,0.51,0.5355191256830601
0.614,400,"[[98, 68], [102, 132]]",98,102,68,102,200,200,166,234,230,170,0.575,0.5903614457831325,0.49,0.66,0.34,0.51,0.5355191256830601
0.615,400,"[[98, 68], [102, 132]]",98,102,68,102,200,200,166,234,230,170,0.575,0.5903614457831325,0.49,0.66,0.34,0.51,0.5355191256830601
0.616,400,"[[98, 68], [102, 132]]",98,102,68,102,200,200,166,234,230,170,0.575,0.5903614457831325,0.49,0.66,0.34,0.51,0.5355191256830601
0.617,400,"[[97, 67], [103, 133]]",97,103,67,103,200,200,164,236,230,170,0.575,0.5914634146341463,0.485,0.665,0.335,0.515,0.532967032967033
0.618,400,"[[97, 67], [103, 133]]",97,103,67,103,200,200,164,236,230,170,0.575,0.5914634146341463,0.485,0.665,0.335,0.515,0.532967032967033
0.619,400,"[[97, 67], [103, 133]]",97,103,67,103,200,200,164,236,230,170,0.575,0.5914634146341463,0.485,0.665,0.335,0.515,0.532967032967033
0.62,400,"[[97, 67], [103, 133]]",97,103,67,103,200,200,164,236,230,170,0.575,0.5914634146341463,0.485,0.665,0.335,0.515,0.532967032967033
0.621,400,"[[97, 67], [103, 133]]",97,103,67,103,200,200,164,236,230,170,0.575,0.5914634146341463,0.485,0.665,0.335,0.515,0.532967032967033
0.622,400,"[[97, 67], [103, 133]]",97,103,67,103,200,200,164,236,230,170,0.575,0.5914634146341463,0.485,0.665,0.335,0.515,0.532967032967033
0.623,400,"[[97, 66], [103, 134]]",97,103,66,103,200,200,163,237,231,169,0.5775,0.5950920245398773,0.485,0.67,0.33,0.515,0.5344352617079889
0.624,400,"[[97, 66], [103, 134]]",97,103,66,103,200,200,163,237,231,169,0.5775,0.5950920245398773,0.485,0.67,0.33,0.515,0.5344352617079889
0.625,400,"[[97, 66], [103, 134]]",97,103,66,103,200,200,163,237,231,169,0.5775,0.5950920245398773,0.485,0.67,0.33,0.515,0.5344352617079889
0.626,400,"[[97, 66], [103, 134]]",97,103,66,103,200,200,163,237,231,169,0.5775,0.5950920245398773,0.485,0.67,0.33,0.515,0.5344352617079889
0.627,400,"[[97, 66], [103, 134]]",97,103,66,103,200,200,163,237,231,169,0.5775,0.5950920245398773,0.485,0.67,0.33,0.515,0.5344352617079889
0.628,400,"[[97, 65], [103, 135]]",97,103,65,103,200,200,162,238,232,168,0.58,0.5987654320987654,0.485,0.675,0.325,0.515,0.5359116022099448
0.629,400,"[[97, 65], [103, 135]]",97,103,65,103,200,200,162,238,232,168,0.58,0.5987654320987654,0.485,0.675,0.325,0.515,0.5359116022099448
0.63,400,"[[97, 65], [103, 135]]",97,103,65,103,200,200,162,238,232,168,0.58,0.5987654320987654,0.485,0.675,0.325,0.515,0.5359116022099448
0.631,400,"[[97, 65], [103, 135]]",97,103,65,103,200,200,162,238,232,168,0.58,0.5987654320987654,0.485,0.675,0.325,0.515,0.5359116022099448
0.632,400,"[[97, 65], [103, 135]]",97,103,65,103,200,200,162,238,232,168,0.58,0.5987654320987654,0.485,0.675,0.325,0.515,0.5359116022099448
0.633,400,"[[97, 65], [103, 135]]",97,103,65,103,200,200,162,238,232,168,0.58,0.5987654320987654,0.485,0.675,0.325,0.515,0.5359116022099448
0.634,400,"[[97, 65], [103, 135]]",97,103,65,103,200,200,162,238,232,168,0.58,0.5987654320987654,0.485,0.675,0.325,0.515,0.5359116022099448
0.635,400,"[[97, 64], [103, 136]]",97,103,64,103,200,200,161,239,233,167,0.5825,0.6024844720496895,0.485,0.68,0.32,0.515,0.5373961218836565
0.636,400,"[[97, 63], [103, 137]]",97,103,63,103,200,200,160,240,234,166,0.585,0.60625,0.485,0.685,0.315,0.515,0.5388888888888888
0.637,400,"[[97, 63], [103, 137]]",97,103,63,103,200,200,160,240,234,166,0.585,0.60625,0.485,0.685,0.315,0.515,0.5388888888888888
0.638,400,"[[97, 62], [103, 138]]",97,103,62,103,200,200,159,241,235,165,0.5875,0.610062893081761,0.485,0.69,0.31,0.515,0.5403899721448469
0.639,400,"[[97, 62], [103, 138]]",97,103,62,103,200,200,159,241,235,165,0.5875,0.610062893081761,0.485,0.69,0.31,0.515,0.5403899721448469
0.64,400,"[[97, 62], [103, 138]]",97,103,62,103,200,200,159,241,235,165,0.5875,0.610062893081761,0.485,0.69,0.31,0.515,0.5403899721448469
0.641,400,"[[97, 62], [103, 138]]",97,103,62,103,200,200,159,241,235,165,0.5875,0.610062893081761,0.485,0.69,0.31,0.515,0.5403899721448469
0.642,400,"[[97, 62], [103, 138]]",97,103,62,103,200,200,159,241,235,165,0.5875,0.610062893081761,0.485,0.69,0.31,0.515,0.5403899721448469
0.643,400,"[[97, 62], [103, 138]]",97,103,62,103,200,200,159,241,235,165,0.5875,0.610062893081761,0.485,0.69,0.31,0.515,0.5403899721448469
0.644,400,"[[97, 62], [103, 138]]",97,103,62,103,200,200,159,241,235,165,0.5875,0.610062893081761,0.485,0.69,0.31,0.515,0.5403899721448469
0.645,400,"[[97, 62], [103, 138]]",97,103,62,103,200,200,159,241,235,165,0.5875,0.610062893081761,0.485,0.69,0.31,0.515,0.5403899721448469
0.646,400,"[[97, 62], [103, 138]]",97,103,62,103,200,200,159,241,235,165,0.5875,0.610062893081761,0.485,0.69,0.31,0.515,0.5403899721448469
0.647,400,"[[96, 62], [104, 138]]",96,104,62,104,200,200,158,242,234,166,0.585,0.6075949367088608,0.48,0.69,0.31,0.52,0.5363128491620112
0.648,400,"[[95, 62], [105, 138]]",95,105,62,105,200,200,157,243,233,167,0.5825,0.6050955414012739,0.475,0.69,0.31,0.525,0.5322128851540616
0.649,400,"[[95, 62], [105, 138]]",95,105,62,105,200,200,157,243,233,167,0.5825,0.6050955414012739,0.475,0.69,0.31,0.525,0.5322128851540616
0.65,400,"[[95, 62], [105, 138]]",95,105,62,105,200,200,157,243,233,167,0.5825,0.6050955414012739,0.475,0.69,0.31,0.525,0.5322128851540616
0.651,400,"[[95, 62], [105, 138]]",95,105,62,105,200,200,157,243,233,167,0.5825,0.6050955414012739,0.475,0.69,0.31,0.525,0.5322128851540616
0.652,400,"[[95, 62], [105, 138]]",95,105,62,105,200,200,157,243,233,167,0.5825,0.6050955414012739,0.475,0.69,0.31,0.525,0.5322128851540616
0.653,400,"[[95, 62], [105, 138]]",95,105,62,105,200,200,157,243,233,167,0.5825,0.6050955414012739,0.475,0.69,0.31,0.525,0.5322128851540616
0.654,400,"[[95, 62], [105, 138]]",95,105,62,105,200,200,157,243,233,167,0.5825,0.6050955414012739,0.475,0.69,0.31,0.525,0.5322128851540616
0.655,400,"[[95, 62], [105, 138]]",95,105,62,105,200,200,157,243,233,167,0.5825,0.6050955414012739,0.475,0.69,0.31,0.525,0.5322128851540616
0.656,400,"[[95, 62], [105, 138]]",95,105,62,105,200,200,157,243,233,167,0.5825,0.6050955414012739,0.475,0.69,0.31,0.525,0.5322128851540616
0.657,400,"[[95, 62], [105, 138]]",95,105,62,105,200,200,157,243,233,167,0.5825,0.6050955414012739,0.475,0.69,0.31,0.525,0.5322128851540616
0.658,400,"[[95, 61], [105, 139]]",95,105,61,105,200,200,156,244,234,166,0.585,0.6089743589743589,0.475,0.695,0.305,0.525,0.5337078651685393
0.659,400,"[[95, 61], [105, 139]]",95,105,61,105,200,200,156,244,234,166,0.585,0.6089743589743589,0.475,0.695,0.305,0.525,0.5337078651685393
0.66,400,"[[94, 61], [106, 139]]",94,106,61,106,200,200,155,245,233,167,0.5825,0.6064516129032258,0.47,0.695,0.305,0.53,0.5295774647887324
0.661,400,"[[93, 61], [107, 139]]",93,107,61,107,200,200,154,246,232,168,0.58,0.6038961038961039,0.465,0.695,0.305,0.535,0.5254237288135594
0.662,400,"[[93, 61], [107, 139]]",93,107,61,107,200,200,154,246,232,168,0.58,0.6038961038961039,0.465,0.695,0.305,0.535,0.5254237288135594
0.663,400,"[[93, 61], [107, 139]]",93,107,61,107,200,200,154,246,232,168,0.58,0.6038961038961039,0.465,0.695,0.305,0.535,0.5254237288135594
0.664,400,"[[93, 61], [107, 139]]",93,107,61,107,200,200,154,246,232,168,0.58,0.6038961038961039,0.465,0.695,0.305,0.535,0.5254237288135594
0.665,400,"[[93, 61], [107, 139]]",93,107,61,107,200,200,154,246,232,168,0.58,0.6038961038961039,0.465,0.695,0.305,0.535,0.5254237288135594
0.666,400,"[[93, 61], [107, 139]]",93,107,61,107,200,200,154,246,232,168,0.58,0.6038961038961039,0.465,0.695,0.305,0.535,0.5254237288135594
0.667,400,"[[93, 61], [107, 139]]",93,107,61,107,200,200,154,246,232,168,0.58,0.6038961038961039,0.465,0.695,0.305,0.535,0.5254237288135594
0.668,400,"[[93, 60], [107, 140]]",93,107,60,107,200,200,153,247,233,167,0.5825,0.6078431372549019,0.465,0.7,0.3,0.535,0.5269121813031162
0.669,400,"[[93, 60], [107, 140]]",93,107,60,107,200,200,153,247,233,167,0.5825,0.6078431372549019,0.465,0.7,0.3,0.535,0.5269121813031162
0.67,400,"[[93, 60], [107, 140]]",93,107,60,107,200,200,153,247,233,167,0.5825,0.6078431372549019,0.465,0.7,0.3,0.535,0.5269121813031162
0.671,400,"[[93, 60], [107, 140]]",93,107,60,107,200,200,153,247,233,167,0.5825,0.6078431372549019,0.465,0.7,0.3,0.535,0.5269121813031162
0.672,400,"[[93, 60], [107, 140]]",93,107,60,107,200,200,153,247,233,167,0.5825,0.6078431372549019,0.465,0.7,0.3,0.535,0.5269121813031162
0.673,400,"[[93, 60], [107, 140]]",93,107,60,107,200,200,153,247,233,167,0.5825,0.6078431372549019,0.465,0.7,0.3,0.535,0.5269121813031162
0.674,400,"[[93, 60], [107, 140]]",93,107,60,107,200,200,153,247,233,167,0.5825,0.6078431372549019,0.465,0.7,0.3,0.535,0.5269121813031162
0.675,400,"[[93, 60], [107, 140]]",93,107,60,107,200,200,153,247,233,167,0.5825,0.6078431372549019,0.465,0.7,0.3,0.535,0.5269121813031162
0.676,400,"[[93, 59], [107, 141]]",93,107,59,107,200,200,152,248,234,166,0.585,0.6118421052631579,0.465,0.705,0.295,0.535,0.5284090909090909
0.677,400,"[[93, 59], [107, 141]]",93,107,59,107,200,200,152,248,234,166,0.585,0.6118421052631579,0.465,0.705,0.295,0.535,0.5284090909090909
0.678,400,"[[93, 59], [107, 141]]",93,107,59,107,200,200,152,248,234,166,0.585,0.6118421052631579,0.465,0.705,0.295,0.535,0.5284090909090909
0.679,400,"[[93, 59], [107, 141]]",93,107,59,107,200,200,152,248,234,166,0.585,0.6118421052631579,0.465,0.705,0.295,0.535,0.5284090909090909
0.68,400,"[[93, 57], [107, 143]]",93,107,57,107,200,200,150,250,236,164,0.59,0.62,0.465,0.715,0.285,0.535,0.5314285714285715
0.681,400,"[[93, 57], [107, 143]]",93,107,57,107,200,200,150,250,236,164,0.59,0.62,0.465,0.715,0.285,0.535,0.5314285714285715
0.682,400,"[[93, 56], [107, 144]]",93,107,56,107,200,200,149,251,237,163,0.5925,0.6241610738255033,0.465,0.72,0.28,0.535,0.5329512893982808
0.683,400,"[[93, 56], [107, 144]]",93,107,56,107,200,200,149,251,237,163,0.5925,0.6241610738255033,0.465,0.72,0.28,0.535,0.5329512893982808
0.684,400,"[[93, 56], [107, 144]]",93,107,56,107,200,200,149,251,237,163,0.5925,0.6241610738255033,0.465,0.72,0.28,0.535,0.5329512893982808
0.685,400,"[[93, 56], [107, 144]]",93,107,56,107,200,200,149,251,237,163,0.5925,0.6241610738255033,0.465,0.72,0.28,0.535,0.5329512893982808
0.686,400,"[[93, 56], [107, 144]]",93,107,56,107,200,200,149,251,237,163,0.5925,0.6241610738255033,0.465,0.72,0.28,0.535,0.5329512893982808
0.687,400,"[[93, 56], [107, 144]]",93,107,56,107,200,200,149,251,237,163,0.5925,0.6241610738255033,0.465,0.72,0.28,0.535,0.5329512893982808
0.688,400,"[[93, 56], [107, 144]]",93,107,56,107,200,200,149,251,237,163,0.5925,0.6241610738255033,0.465,0.72,0.28,0.535,0.5329512893982808
0.689,400,"[[93, 56], [107, 144]]",93,107,56,107,200,200,149,251,237,163,0.5925,0.6241610738255033,0.465,0.72,0.28,0.535,0.5329512893982808
0.69,400,"[[93, 56], [107, 144]]",93,107,56,107,200,200,149,251,237,163,0.5925,0.6241610738255033,0.465,0.72,0.28,0.535,0.5329512893982808
0.691,400,"[[93, 56], [107, 144]]",93,107,56,107,200,200,149,251,237,163,0.5925,0.6241610738255033,0.465,0.72,0.28,0.535,0.5329512893982808
0.692,400,"[[93, 56], [107, 144]]",93,107,56,107,200,200,149,251,237,163,0.5925,0.6241610738255033,0.465,0.72,0.28,0.535,0.5329512893982808
0.693,400,"[[93, 56], [107, 144]]",93,107,56,107,200,200,149,251,237,163,0.5925,0.6241610738255033,0.465,0.72,0.28,0.535,0.5329512893982808
0.694,400,"[[93, 56], [107, 144]]",93,107,56,107,200,200,149,251,237,163,0.5925,0.6241610738255033,0.465,0.72,0.28,0.535,0.5329512893982808
0.695,400,"[[93, 56], [107, 144]]",93,107,56,107,200,200,149,251,237,163,0.5925,0.6241610738255033,0.465,0.72,0.28,0.535,0.5329512893982808
0.696,400,"[[93, 56], [107, 144]]",93,107,56,107,200,200,149,251,237,163,0.5925,0.6241610738255033,0.465,0.72,0.28,0.535,0.5329512893982808
0.697,400,"[[92, 56], [108, 144]]",92,108,56,108,200,200,148,252,236,164,0.59,0.6216216216216216,0.46,0.72,0.28,0.54,0.5287356321839081
0.698,400,"[[92, 56], [108, 144]]",92,108,56,108,200,200,148,252,236,164,0.59,0.6216216216216216,0.46,0.72,0.28,0.54,0.5287356321839081
0.699,400,"[[92, 56], [108, 144]]",92,108,56,108,200,200,148,252,236,164,0.59,0.6216216216216216,0.46,0.72,0.28,0.54,0.5287356321839081
0.7,400,"[[92, 56], [108, 144]]",92,108,56,108,200,200,148,252,236,164,0.59,0.6216216216216216,0.46,0.72,0.28,0.54,0.5287356321839081
0.701,400,"[[92, 56], [108, 144]]",92,108,56,108,200,200,148,252,236,164,0.59,0.6216216216216216,0.46,0.72,0.28,0.54,0.5287356321839081
0.702,400,"[[90, 56], [110, 144]]",90,110,56,110,200,200,146,254,234,166,0.585,0.6164383561643836,0.45,0.72,0.28,0.55,0.5202312138728323
0.703,400,"[[90, 56], [110, 144]]",90,110,56,110,200,200,146,254,234,166,0.585,0.6164383561643836,0.45,0.72,0.28,0.55,0.5202312138728323
0.704,400,"[[89, 56], [111, 144]]",89,111,56,111,200,200,145,255,233,167,0.5825,0.6137931034482759,0.445,0.72,0.28,0.555,0.5159420289855072
0.705,400,"[[89, 56], [111, 144]]",89,111,56,111,200,200,145,255,233,167,0.5825,0.6137931034482759,0.445,0.72,0.28,0.555,0.5159420289855072
0.706,400,"[[89, 55], [111, 145]]",89,111,55,111,200,200,144,256,234,166,0.585,0.6180555555555556,0.445,0.725,0.275,0.555,0.5174418604651163
0.707,400,"[[89, 55], [111, 145]]",89,111,55,111,200,200,144,256,234,166,0.585,0.6180555555555556,0.445,0.725,0.275,0.555,0.5174418604651163
0.708,400,"[[89, 55], [111, 145]]",89,111,55,111,200,200,144,256,234,166,0.585,0.6180555555555556,0.445,0.725,0.275,0.555,0.5174418604651163
0.709,400,"[[89, 55], [111, 145]]",89,111,55,111,200,200,144,256,234,166,0.585,0.6180555555555556,0.445,0.725,0.275,0.555,0.5174418604651163
0.71,400,"[[89, 55], [111, 145]]",89,111,55,111,200,200,144,256,234,166,0.585,0.6180555555555556,0.445,0.725,0.275,0.555,0.5174418604651163
0.711,400,"[[89, 55], [111, 145]]",89,111,55,111,200,200,144,256,234,166,0.585,0.6180555555555556,0.445,0.725,0.275,0.555,0.5174418604651163
0.712,400,"[[88, 55], [112, 145]]",88,112,55,112,200,200,143,257,233,167,0.5825,0.6153846153846154,0.44,0.725,0.275,0.56,0.5131195335276968
0.713,400,"[[88, 55], [112, 145]]",88,112,55,112,200,200,143,257,233,167,0.5825,0.6153846153846154,0.44,0.725,0.275,0.56,0.5131195335276968
0.714,400,"[[88, 54], [112, 146]]",88,112,54,112,200,200,142,258,234,166,0.585,0.6197183098591549,0.44,0.73,0.27,0.56,0.5146198830409356
0.715,400,"[[88, 54], [112, 146]]",88,112,54,112,200,200,142,258,234,166,0.585,0.6197183098591549,0.44,0.73,0.27,0.56,0.5146198830409356
0.716,400,"[[87, 54], [113, 146]]",87,113,54,113,200,200,141,259,233,167,0.5825,0.6170212765957447,0.435,0.73,0.27,0.565,0.5102639296187683
0.717,400,"[[87, 52], [113, 148]]",87,113,52,113,200,200,139,261,235,165,0.5875,0.6258992805755396,0.435,0.74,0.26,0.565,0.5132743362831859
0.718,400,"[[87, 52], [113, 148]]",87,113,52,113,200,200,139,261,235,165,0.5875,0.6258992805755396,0.435,0.74,0.26,0.565,0.5132743362831859
0.719,400,"[[87, 52], [113, 148]]",87,113,52,113,200,200,139,261,235,165,0.5875,0.6258992805755396,0.435,0.74,0.26,0.565,0.5132743362831859
0.72,400,"[[87, 52], [113, 148]]",87,113,52,113,200,200,139,261,235,165,0.5875,0.6258992805755396,0.435,0.74,0.26,0.565,0.5132743362831859
0.721,400,"[[86, 52], [114, 148]]",86,114,52,114,200,200,138,262,234,166,0.585,0.6231884057971014,0.43,0.74,0.26,0.57,0.5088757396449703
0.722,400,"[[86, 51], [114, 149]]",86,114,51,114,200,200,137,263,235,165,0.5875,0.6277372262773723,0.43,0.745,0.255,0.57,0.5103857566765578
0.723,400,"[[86, 51], [114, 149]]",86,114,51,114,200,200,137,263,235,165,0.5875,0.6277372262773723,0.43,0.745,0.255,0.57,0.5103857566765578
0.724,400,"[[86, 51], [114, 149]]",86,114,51,114,200,200,137,263,235,165,0.5875,0.6277372262773723,0.43,0.745,0.255,0.57,0.5103857566765578
0.725,400,"[[86, 51], [114, 149]]",86,114,51,114,200,200,137,263,235,165,0.5875,0.6277372262773723,0.43,0.745,0.255,0.57,0.5103857566765578
0.726,400,"[[86, 51], [114, 149]]",86,114,51,114,200,200,137,263,235,165,0.5875,0.6277372262773723,0.43,0.745,0.255,0.57,0.5103857566765578
0.727,400,"[[86, 51], [114, 149]]",86,114,51,114,200,200,137,263,235,165,0.5875,0.6277372262773723,0.43,0.745,0.255,0.57,0.5103857566765578
0.728,400,"[[86, 51], [114, 149]]",86,114,51,114,200,200,137,263,235,165,0.5875,0.6277372262773723,0.43,0.745,0.255,0.57,0.5103857566765578
0.729,400,"[[86, 51], [114, 149]]",86,114,51,114,200,200,137,263,235,165,0.5875,0.6277372262773723,0.43,0.745,0.255,0.57,0.5103857566765578
0.73,400,"[[85, 51], [115, 149]]",85,115,51,115,200,200,136,264,234,166,0.585,0.625,0.425,0.745,0.255,0.575,0.5059523809523809
0.731,400,"[[85, 51], [115, 149]]",85,115,51,115,200,200,136,264,234,166,0.585,0.625,0.425,0.745,0.255,0.575,0.5059523809523809
0.732,400,"[[85, 51], [115, 149]]",85,115,51,115,200,200,136,264,234,166,0.585,0.625,0.425,0.745,0.255,0.575,0.5059523809523809
0.733,400,"[[85, 51], [115, 149]]",85,115,51,115,200,200,136,264,234,166,0.585,0.625,0.425,0.745,0.255,0.575,0.5059523809523809
0.734,400,"[[85, 51], [115, 149]]",85,115,51,115,200,200,136,264,234,166,0.585,0.625,0.425,0.745,0.255,0.575,0.5059523809523809
0.735,400,"[[85, 51], [115, 149]]",85,115,51,115,200,200,136,264,234,166,0.585,0.625,0.425,0.745,0.255,0.575,0.5059523809523809
0.736,400,"[[85, 50], [115, 150]]",85,115,50,115,200,200,135,265,235,165,0.5875,0.6296296296296297,0.425,0.75,0.25,0.575,0.5074626865671642
0.737,400,"[[85, 50], [115, 150]]",85,115,50,115,200,200,135,265,235,165,0.5875,0.6296296296296297,0.425,0.75,0.25,0.575,0.5074626865671642
0.738,400,"[[85, 50], [115, 150]]",85,115,50,115,200,200,135,265,235,165,0.5875,0.6296296296296297,0.425,0.75,0.25,0.575,0.5074626865671642
0.739,400,"[[85, 50], [115, 150]]",85,115,50,115,200,200,135,265,235,165,0.5875,0.6296296296296297,0.425,0.75,0.25,0.575,0.5074626865671642
0.74,400,"[[85, 50], [115, 150]]",85,115,50,115,200,200,135,265,235,165,0.5875,0.6296296296296297,0.425,0.75,0.25,0.575,0.5074626865671642
0.741,400,"[[85, 50], [115, 150]]",85,115,50,115,200,200,135,265,235,165,0.5875,0.6296296296296297,0.425,0.75,0.25,0.575,0.5074626865671642
0.742,400,"[[85, 50], [115, 150]]",85,115,50,115,200,200,135,265,235,165,0.5875,0.6296296296296297,0.425,0.75,0.25,0.575,0.5074626865671642
0.743,400,"[[85, 50], [115, 150]]",85,115,50,115,200,200,135,265,235,165,0.5875,0.6296296296296297,0.425,0.75,0.25,0.575,0.5074626865671642
0.744,400,"[[85, 50], [115, 150]]",85,115,50,115,200,200,135,265,235,165,0.5875,0.6296296296296297,0.425,0.75,0.25,0.575,0.5074626865671642
0.745,400,"[[85, 50], [115, 150]]",85,115,50,115,200,200,135,265,235,165,0.5875,0.6296296296296297,0.425,0.75,0.25,0.575,0.5074626865671642
0.746,400,"[[85, 50], [115, 150]]",85,115,50,115,200,200,135,265,235,165,0.5875,0.6296296296296297,0.425,0.75,0.25,0.575,0.5074626865671642
0.747,400,"[[85, 50], [115, 150]]",85,115,50,115,200,200,135,265,235,165,0.5875,0.6296296296296297,0.425,0.75,0.25,0.575,0.5074626865671642
0.748,400,"[[85, 50], [115, 150]]",85,115,50,115,200,200,135,265,235,165,0.5875,0.6296296296296297,0.425,0.75,0.25,0.575,0.5074626865671642
0.749,400,"[[85, 50], [115, 150]]",85,115,50,115,200,200,135,265,235,165,0.5875,0.6296296296296297,0.425,0.75,0.25,0.575,0.5074626865671642
0.75,400,"[[85, 50], [115, 150]]",85,115,50,115,200,200,135,265,235,165,0.5875,0.6296296296296297,0.425,0.75,0.25,0.575,0.5074626865671642
0.751,400,"[[85, 50], [115, 150]]",85,115,50,115,200,200,135,265,235,165,0.5875,0.6296296296296297,0.425,0.75,0.25,0.575,0.5074626865671642
0.752,400,"[[85, 50], [115, 150]]",85,115,50,115,200,200,135,265,235,165,0.5875,0.6296296296296297,0.425,0.75,0.25,0.575,0.5074626865671642
0.753,400,"[[82, 50], [118, 150]]",82,118,50,118,200,200,132,268,232,168,0.58,0.6212121212121212,0.41,0.75,0.25,0.59,0.4939759036144578
0.754,400,"[[77, 50], [123, 150]]",77,123,50,123,200,200,127,273,227,173,0.5675,0.6062992125984252,0.385,0.75,0.25,0.615,0.47094801223241595
0.755,400,"[[77, 50], [123, 150]]",77,123,50,123,200,200,127,273,227,173,0.5675,0.6062992125984252,0.385,0.75,0.25,0.615,0.47094801223241595
0.756,400,"[[77, 50], [123, 150]]",77,123,50,123,200,200,127,273,227,173,0.5675,0.6062992125984252,0.385,0.75,0.25,0.615,0.47094801223241595
0.757,400,"[[77, 50], [123, 150]]",77,123,50,123,200,200,127,273,227,173,0.5675,0.6062992125984252,0.385,0.75,0.25,0.615,0.47094801223241595
0.758,400,"[[76, 50], [124, 150]]",76,124,50,124,200,200,126,274,226,174,0.565,0.6031746031746031,0.38,0.75,0.25,0.62,0.4662576687116564
0.759,400,"[[76, 50], [124, 150]]",76,124,50,124,200,200,126,274,226,174,0.565,0.6031746031746031,0.38,0.75,0.25,0.62,0.4662576687116564
0.76,400,"[[76, 49], [124, 151]]",76,124,49,124,200,200,125,275,227,173,0.5675,0.608,0.38,0.755,0.245,0.62,0.4676923076923077
0.761,400,"[[76, 49], [124, 151]]",76,124,49,124,200,200,125,275,227,173,0.5675,0.608,0.38,0.755,0.245,0.62,0.4676923076923077
0.762,400,"[[75, 49], [125, 151]]",75,125,49,125,200,200,124,276,226,174,0.565,0.6048387096774194,0.375,0.755,0.245,0.625,0.46296296296296297
0.763,400,"[[75, 49], [125, 151]]",75,125,49,125,200,200,124,276,226,174,0.565,0.6048387096774194,0.375,0.755,0.245,0.625,0.46296296296296297
0.764,400,"[[75, 49], [125, 151]]",75,125,49,125,200,200,124,276,226,174,0.565,0.6048387096774194,0.375,0.755,0.245,0.625,0.46296296296296297
0.765,400,"[[75, 49], [125, 151]]",75,125,49,125,200,200,124,276,226,174,0.565,0.6048387096774194,0.375,0.755,0.245,0.625,0.46296296296296297
0.766,400,"[[75, 49], [125, 151]]",75,125,49,125,200,200,124,276,226,174,0.565,0.6048387096774194,0.375,0.755,0.245,0.625,0.46296296296296297
0.767,400,"[[75, 49], [125, 151]]",75,125,49,125,200,200,124,276,226,174,0.565,0.6048387096774194,0.375,0.755,0.245,0.625,0.46296296296296297
0.768,400,"[[73, 49], [127, 151]]",73,127,49,127,200,200,122,278,224,176,0.56,0.5983606557377049,0.365,0.755,0.245,0.635,0.453416149068323
0.769,400,"[[72, 49], [128, 151]]",72,128,49,128,200,200,121,279,223,177,0.5575,0.5950413223140496,0.36,0.755,0.245,0.64,0.4485981308411215
0.77,400,"[[72, 49], [128, 151]]",72,128,49,128,200,200,121,279,223,177,0.5575,0.5950413223140496,0.36,0.755,0.245,0.64,0.4485981308411215
0.771,400,"[[72, 49], [128, 151]]",72,128,49,128,200,200,121,279,223,177,0.5575,0.5950413223140496,0.36,0.755,0.245,0.64,0.4485981308411215
0.772,400,"[[72, 49], [128, 151]]",72,128,49,128,200,200,121,279,223,177,0.5575,0.5950413223140496,0.36,0.755,0.245,0.64,0.4485981308411215
0.773,400,"[[72, 49], [128, 151]]",72,128,49,128,200,200,121,279,223,177,0.5575,0.5950413223140496,0.36,0.755,0.245,0.64,0.4485981308411215
0.774,400,"[[72, 49], [128, 151]]",72,128,49,128,200,200,121,279,223,177,0.5575,0.5950413223140496,0.36,0.755,0.245,0.64,0.4485981308411215
0.775,400,"[[72, 48], [128, 152]]",72,128,48,128,200,200,120,280,224,176,0.56,0.6,0.36,0.76,0.24,0.64,0.45
0.776,400,"[[72, 48], [128, 152]]",72,128,48,128,200,200,120,280,224,176,0.56,0.6,0.36,0.76,0.24,0.64,0.45
0.777,400,"[[72, 47], [128, 153]]",72,128,47,128,200,200,119,281,225,175,0.5625,0.6050420168067226,0.36,0.765,0.235,0.64,0.45141065830721
0.778,400,"[[71, 47], [129, 153]]",71,129,47,129,200,200,118,282,224,176,0.56,0.6016949152542372,0.355,0.765,0.235,0.645,0.4465408805031446
0.779,400,"[[71, 46], [129, 154]]",71,129,46,129,200,200,117,283,225,175,0.5625,0.6068376068376068,0.355,0.77,0.23,0.645,0.44794952681388006
0.78,400,"[[70, 46], [130, 154]]",70,130,46,130,200,200,116,284,224,176,0.56,0.603448275862069,0.35,0.77,0.23,0.65,0.4430379746835443
0.781,400,"[[70, 46], [130, 154]]",70,130,46,130,200,200,116,284,224,176,0.56,0.603448275862069,0.35,0.77,0.23,0.65,0.4430379746835443
0.782,400,"[[66, 46], [134, 154]]",66,134,46,134,200,200,112,288,220,180,0.55,0.5892857142857143,0.33,0.77,0.23,0.67,0.42307692307692313
0.783,400,"[[65, 46], [135, 154]]",65,135,46,135,200,200,111,289,219,181,0.5475,0.5855855855855856,0.325,0.77,0.23,0.675,0.4180064308681672
0.784,400,"[[63, 45], [137, 155]]",63,137,45,137,200,200,108,292,218,182,0.545,0.5833333333333334,0.315,0.775,0.225,0.685,0.4090909090909091
0.785,400,"[[63, 45], [137, 155]]",63,137,45,137,200,200,108,292,218,182,0.545,0.5833333333333334,0.315,0.775,0.225,0.685,0.4090909090909091
0.786,400,"[[63, 45], [137, 155]]",63,137,45,137,200,200,108,292,218,182,0.545,0.5833333333333334,0.315,0.775,0.225,0.685,0.4090909090909091
0.787,400,"[[63, 45], [137, 155]]",63,137,45,137,200,200,108,292,218,182,0.545,0.5833333333333334,0.315,0.775,0.225,0.685,0.4090909090909091
0.788,400,"[[63, 45], [137, 155]]",63,137,45,137,200,200,108,292,218,182,0.545,0.5833333333333334,0.315,0.775,0.225,0.685,0.4090909090909091
0.789,400,"[[63, 43], [137, 157]]",63,137,43,137,200,200,106,294,220,180,0.55,0.5943396226415094,0.315,0.785,0.215,0.685,0.411764705882353
0.79,400,"[[63, 43], [137, 157]]",63,137,43,137,200,200,106,294,220,180,0.55,0.5943396226415094,0.315,0.785,0.215,0.685,0.411764705882353
0.791,400,"[[63, 43], [137, 157]]",63,137,43,137,200,200,106,294,220,180,0.55,0.5943396226415094,0.315,0.785,0.215,0.685,0.411764705882353
0.792,400,"[[63, 42], [137, 158]]",63,137,42,137,200,200,105,295,221,179,0.5525,0.6,0.315,0.79,0.21,0.685,0.4131147540983606
0.793,400,"[[62, 42], [138, 158]]",62,138,42,138,200,200,104,296,220,180,0.55,0.5961538461538461,0.31,0.79,0.21,0.69,0.4078947368421053
0.794,400,"[[62, 42], [138, 158]]",62,138,42,138,200,200,104,296,220,180,0.55,0.5961538461538461,0.31,0.79,0.21,0.69,0.4078947368421053
0.795,400,"[[62, 41], [138, 159]]",62,138,41,138,200,200,103,297,221,179,0.5525,0.6019417475728155,0.31,0.795,0.205,0.69,0.4092409240924092
0.796,400,"[[61, 41], [139, 159]]",61,139,41,139,200,200,102,298,220,180,0.55,0.5980392156862745,0.305,0.795,0.205,0.695,0.40397350993377484
0.797,400,"[[60, 41], [140, 159]]",60,140,41,140,200,200,101,299,219,181,0.5475,0.594059405940594,0.3,0.795,0.205,0.7,0.39867109634551495
0.798,400,"[[60, 41], [140, 159]]",60,140,41,140,200,200,101,299,219,181,0.5475,0.594059405940594,0.3,0.795,0.205,0.7,0.39867109634551495
0.799,400,"[[60, 41], [140, 159]]",60,140,41,140,200,200,101,299,219,181,0.5475,0.594059405940594,0.3,0.795,0.205,0.7,0.39867109634551495
0.8,400,"[[60, 40], [140, 160]]",60,140,40,140,200,200,100,300,220,180,0.55,0.6,0.3,0.8,0.2,0.7,0.4
0.801,400,"[[60, 40], [140, 160]]",60,140,40,140,200,200,100,300,220,180,0.55,0.6,0.3,0.8,0.2,0.7,0.4
0.802,400,"[[59, 40], [141, 160]]",59,141,40,141,200,200,99,301,219,181,0.5475,0.5959595959595959,0.295,0.8,0.2,0.705,0.39464882943143803
0.803,400,"[[58, 39], [142, 161]]",58,142,39,142,200,200,97,303,219,181,0.5475,0.5979381443298969,0.29,0.805,0.195,0.71,0.39057239057239057
0.804,400,"[[58, 39], [142, 161]]",58,142,39,142,200,200,97,303,219,181,0.5475,0.5979381443298969,0.29,0.805,0.195,0.71,0.39057239057239057
0.805,400,"[[58, 39], [142, 161]]",58,142,39,142,200,200,97,303,219,181,0.5475,0.5979381443298969,0.29,0.805,0.195,0.71,0.39057239057239057
0.806,400,"[[58, 38], [142, 162]]",58,142,38,142,200,200,96,304,220,180,0.55,0.6041666666666666,0.29,0.81,0.19,0.71,0.3918918918918919
0.807,400,"[[58, 38], [142, 162]]",58,142,38,142,200,200,96,304,220,180,0.55,0.6041666666666666,0.29,0.81,0.19,0.71,0.3918918918918919
0.808,400,"[[58, 38], [142, 162]]",58,142,38,142,200,200,96,304,220,180,0.55,0.6041666666666666,0.29,0.81,0.19,0.71,0.3918918918918919
0.809,400,"[[58, 38], [142, 162]]",58,142,38,142,200,200,96,304,220,180,0.55,0.6041666666666666,0.29,0.81,0.19,0.71,0.3918918918918919
0.81,400,"[[58, 38], [142, 162]]",58,142,38,142,200,200,96,304,220,180,0.55,0.6041666666666666,0.29,0.81,0.19,0.71,0.3918918918918919
0.811,400,"[[57, 38], [143, 162]]",57,143,38,143,200,200,95,305,219,181,0.5475,0.6,0.285,0.81,0.19,0.715,0.38644067796610165
0.812,400,"[[57, 38], [143, 162]]",57,143,38,143,200,200,95,305,219,181,0.5475,0.6,0.285,0.81,0.19,0.715,0.38644067796610165
0.813,400,"[[57, 38], [143, 162]]",57,143,38,143,200,200,95,305,219,181,0.5475,0.6,0.285,0.81,0.19,0.715,0.38644067796610165
0.814,400,"[[57, 38], [143, 162]]",57,143,38,143,200,200,95,305,219,181,0.5475,0.6,0.285,0.81,0.19,0.715,0.38644067796610165
0.815,400,"[[56, 38], [144, 162]]",56,144,38,144,200,200,94,306,218,182,0.545,0.5957446808510638,0.28,0.81,0.19,0.72,0.380952380952381
0.816,400,"[[56, 38], [144, 162]]",56,144,38,144,200,200,94,306,218,182,0.545,0.5957446808510638,0.28,0.81,0.19,0.72,0.380952380952381
0.817,400,"[[56, 38], [144, 162]]",56,144,38,144,200,200,94,306,218,182,0.545,0.5957446808510638,0.28,0.81,0.19,0.72,0.380952380952381
0.818,400,"[[56, 38], [144, 162]]",56,144,38,144,200,200,94,306,218,182,0.545,0.5957446808510638,0.28,0.81,0.19,0.72,0.380952380952381
0.819,400,"[[56, 38], [144, 162]]",56,144,38,144,200,200,94,306,218,182,0.545,0.5957446808510638,0.28,0.81,0.19,0.72,0.380952380952381
0.82,400,"[[56, 37], [144, 163]]",56,144,37,144,200,200,93,307,219,181,0.5475,0.6021505376344086,0.28,0.815,0.185,0.72,0.38225255972696254
0.821,400,"[[56, 37], [144, 163]]",56,144,37,144,200,200,93,307,219,181,0.5475,0.6021505376344086,0.28,0.815,0.185,0.72,0.38225255972696254
0.822,400,"[[54, 37], [146, 163]]",54,146,37,146,200,200,91,309,217,183,0.5425,0.5934065934065934,0.27,0.815,0.185,0.73,0.3711340206185567
0.823,400,"[[54, 37], [146, 163]]",54,146,37,146,200,200,91,309,217,183,0.5425,0.5934065934065934,0.27,0.815,0.185,0.73,0.3711340206185567
0.824,400,"[[54, 35], [146, 165]]",54,146,35,146,200,200,89,311,219,181,0.5475,0.6067415730337079,0.27,0.825,0.175,0.73,0.3737024221453288
0.825,400,"[[54, 35], [146, 165]]",54,146,35,146,200,200,89,311,219,181,0.5475,0.6067415730337079,0.27,0.825,0.175,0.73,0.3737024221453288
0.826,400,"[[54, 35], [146, 165]]",54,146,35,146,200,200,89,311,219,181,0.5475,0.6067415730337079,0.27,0.825,0.175,0.73,0.3737024221453288
0.827,400,"[[54, 35], [146, 165]]",54,146,35,146,200,200,89,311,219,181,0.5475,0.6067415730337079,0.27,0.825,0.175,0.73,0.3737024221453288
0.828,400,"[[54, 35], [146, 165]]",54,146,35,146,200,200,89,311,219,181,0.5475,0.6067415730337079,0.27,0.825,0.175,0.73,0.3737024221453288
0.829,400,"[[54, 35], [146, 165]]",54,146,35,146,200,200,89,311,219,181,0.5475,0.6067415730337079,0.27,0.825,0.175,0.73,0.3737024221453288
0.83,400,"[[53, 35], [147, 165]]",53,147,35,147,200,200,88,312,218,182,0.545,0.6022727272727273,0.265,0.825,0.175,0.735,0.3680555555555555
0.831,400,"[[53, 35], [147, 165]]",53,147,35,147,200,200,88,312,218,182,0.545,0.6022727272727273,0.265,0.825,0.175,0.735,0.3680555555555555
0.832,400,"[[53, 35], [147, 165]]",53,147,35,147,200,200,88,312,218,182,0.545,0.6022727272727273,0.265,0.825,0.175,0.735,0.3680555555555555
0.833,400,"[[53, 35], [147, 165]]",53,147,35,147,200,200,88,312,218,182,0.545,0.6022727272727273,0.265,0.825,0.175,0.735,0.3680555555555555
0.834,400,"[[53, 35], [147, 165]]",53,147,35,147,200,200,88,312,218,182,0.545,0.6022727272727273,0.265,0.825,0.175,0.735,0.3680555555555555
0.835,400,"[[53, 35], [147, 165]]",53,147,35,147,200,200,88,312,218,182,0.545,0.6022727272727273,0.265,0.825,0.175,0.735,0.3680555555555555
0.836,400,"[[49, 34], [151, 166]]",49,151,34,151,200,200,83,317,215,185,0.5375,0.5903614457831325,0.245,0.83,0.17,0.755,0.3462897526501767
0.837,400,"[[49, 34], [151, 166]]",49,151,34,151,200,200,83,317,215,185,0.5375,0.5903614457831325,0.245,0.83,0.17,0.755,0.3462897526501767
0.838,400,"[[49, 32], [151, 168]]",49,151,32,151,200,200,81,319,217,183,0.5425,0.6049382716049383,0.245,0.84,0.16,0.755,0.3487544483985765
0.839,400,"[[49, 32], [151, 168]]",49,151,32,151,200,200,81,319,217,183,0.5425,0.6049382716049383,0.245,0.84,0.16,0.755,0.3487544483985765
0.84,400,"[[49, 32], [151, 168]]",49,151,32,151,200,200,81,319,217,183,0.5425,0.6049382716049383,0.245,0.84,0.16,0.755,0.3487544483985765
0.841,400,"[[49, 32], [151, 168]]",49,151,32,151,200,200,81,319,217,183,0.5425,0.6049382716049383,0.245,0.84,0.16,0.755,0.3487544483985765
0.842,400,"[[49, 32], [151, 168]]",49,151,32,151,200,200,81,319,217,183,0.5425,0.6049382716049383,0.245,0.84,0.16,0.755,0.3487544483985765
0.843,400,"[[49, 32], [151, 168]]",49,151,32,151,200,200,81,319,217,183,0.5425,0.6049382716049383,0.245,0.84,0.16,0.755,0.3487544483985765
0.844,400,"[[48, 32], [152, 168]]",48,152,32,152,200,200,80,320,216,184,0.54,0.6,0.24,0.84,0.16,0.76,0.34285714285714286
0.845,400,"[[48, 32], [152, 168]]",48,152,32,152,200,200,80,320,216,184,0.54,0.6,0.24,0.84,0.16,0.76,0.34285714285714286
0.846,400,"[[48, 32], [152, 168]]",48,152,32,152,200,200,80,320,216,184,0.54,0.6,0.24,0.84,0.16,0.76,0.34285714285714286
0.847,400,"[[47, 32], [153, 168]]",47,153,32,153,200,200,79,321,215,185,0.5375,0.5949367088607594,0.235,0.84,0.16,0.765,0.3369175627240143
0.848,400,"[[47, 32], [153, 168]]",47,153,32,153,200,200,79,321,215,185,0.5375,0.5949367088607594,0.235,0.84,0.16,0.765,0.3369175627240143
0.849,400,"[[47, 32], [153, 168]]",47,153,32,153,200,200,79,321,215,185,0.5375,0.5949367088607594,0.235,0.84,0.16,0.765,0.3369175627240143
0.85,400,"[[46, 32], [154, 168]]",46,154,32,154,200,200,78,322,214,186,0.535,0.5897435897435898,0.23,0.84,0.16,0.77,0.33093525179856115
0.851,400,"[[46, 32], [154, 168]]",46,154,32,154,200,200,78,322,214,186,0.535,0.5897435897435898,0.23,0.84,0.16,0.77,0.33093525179856115
0.852,400,"[[46, 32], [154, 168]]",46,154,32,154,200,200,78,322,214,186,0.535,0.5897435897435898,0.23,0.84,0.16,0.77,0.33093525179856115
0.853,400,"[[46, 31], [154, 169]]",46,154,31,154,200,200,77,323,215,185,0.5375,0.5974025974025974,0.23,0.845,0.155,0.77,0.332129963898917
0.854,400,"[[46, 30], [154, 170]]",46,154,30,154,200,200,76,324,216,184,0.54,0.6052631578947368,0.23,0.85,0.15,0.77,0.33333333333333337
0.855,400,"[[46, 30], [154, 170]]",46,154,30,154,200,200,76,324,216,184,0.54,0.6052631578947368,0.23,0.85,0.15,0.77,0.33333333333333337
0.856,400,"[[46, 30], [154, 170]]",46,154,30,154,200,200,76,324,216,184,0.54,0.6052631578947368,0.23,0.85,0.15,0.77,0.33333333333333337
0.857,400,"[[46, 30], [154, 170]]",46,154,30,154,200,200,76,324,216,184,0.54,0.6052631578947368,0.23,0.85,0.15,0.77,0.33333333333333337
0.858,400,"[[46, 30], [154, 170]]",46,154,30,154,200,200,76,324,216,184,0.54,0.6052631578947368,0.23,0.85,0.15,0.77,0.33333333333333337
0.859,400,"[[46, 29], [154, 171]]",46,154,29,154,200,200,75,325,217,183,0.5425,0.6133333333333333,0.23,0.855,0.145,0.77,0.3345454545454546
0.86,400,"[[46, 28], [154, 172]]",46,154,28,154,200,200,74,326,218,182,0.545,0.6216216216216216,0.23,0.86,0.14,0.77,0.33576642335766427
0.861,400,"[[46, 27], [154, 173]]",46,154,27,154,200,200,73,327,219,181,0.5475,0.6301369863013698,0.23,0.865,0.135,0.77,0.336996336996337
0.862,400,"[[46, 26], [154, 174]]",46,154,26,154,200,200,72,328,220,180,0.55,0.6388888888888888,0.23,0.87,0.13,0.77,0.3382352941176471
0.863,400,"[[45, 26], [155, 174]]",45,155,26,155,200,200,71,329,219,181,0.5475,0.6338028169014085,0.225,0.87,0.13,0.775,0.33210332103321033
0.864,400,"[[45, 26], [155, 174]]",45,155,26,155,200,200,71,329,219,181,0.5475,0.6338028169014085,0.225,0.87,0.13,0.775,0.33210332103321033
0.865,400,"[[45, 24], [155, 176]]",45,155,24,155,200,200,69,331,221,179,0.5525,0.6521739130434783,0.225,0.88,0.12,0.775,0.3345724907063197
0.866,400,"[[45, 24], [155, 176]]",45,155,24,155,200,200,69,331,221,179,0.5525,0.6521739130434783,0.225,0.88,0.12,0.775,0.3345724907063197
0.867,400,"[[42, 24], [158, 176]]",42,158,24,158,200,200,66,334,218,182,0.545,0.6363636363636364,0.21,0.88,0.12,0.79,0.31578947368421056
0.868,400,"[[42, 24], [158, 176]]",42,158,24,158,200,200,66,334,218,182,0.545,0.6363636363636364,0.21,0.88,0.12,0.79,0.31578947368421056
0.869,400,"[[41, 24], [159, 176]]",41,159,24,159,200,200,65,335,217,183,0.5425,0.6307692307692307,0.205,0.88,0.12,0.795,0.30943396226415093
0.87,400,"[[41, 23], [159, 177]]",41,159,23,159,200,200,64,336,218,182,0.545,0.640625,0.205,0.885,0.115,0.795,0.3106060606060606
0.871,400,"[[40, 23], [160, 177]]",40,160,23,160,200,200,63,337,217,183,0.5425,0.6349206349206349,0.2,0.885,0.115,0.8,0.3041825095057034
0.872,400,"[[40, 23], [160, 177]]",40,160,23,160,200,200,63,337,217,183,0.5425,0.6349206349206349,0.2,0.885,0.115,0.8,0.3041825095057034
0.873,400,"[[40, 23], [160, 177]]",40,160,23,160,200,200,63,337,217,183,0.5425,0.6349206349206349,0.2,0.885,0.115,0.8,0.3041825095057034
0.874,400,"[[40, 23], [160, 177]]",40,160,23,160,200,200,63,337,217,183,0.5425,0.6349206349206349,0.2,0.885,0.115,0.8,0.3041825095057034
0.875,400,"[[40, 23], [160, 177]]",40,160,23,160,200,200,63,337,217,183,0.5425,0.6349206349206349,0.2,0.885,0.115,0.8,0.3041825095057034
0.876,400,"[[40, 23], [160, 177]]",40,160,23,160,200,200,63,337,217,183,0.5425,0.6349206349206349,0.2,0.885,0.115,0.8,0.3041825095057034
0.877,400,"[[40, 23], [160, 177]]",40,160,23,160,200,200,63,337,217,183,0.5425,0.6349206349206349,0.2,0.885,0.115,0.8,0.3041825095057034
0.878,400,"[[40, 22], [160, 178]]",40,160,22,160,200,200,62,338,218,182,0.545,0.6451612903225806,0.2,0.89,0.11,0.8,0.30534351145038163
0.879,400,"[[40, 22], [160, 178]]",40,160,22,160,200,200,62,338,218,182,0.545,0.6451612903225806,0.2,0.89,0.11,0.8,0.30534351145038163
0.88,400,"[[40, 22], [160, 178]]",40,160,22,160,200,200,62,338,218,182,0.545,0.6451612903225806,0.2,0.89,0.11,0.8,0.30534351145038163
0.881,400,"[[39, 22], [161, 178]]",39,161,22,161,200,200,61,339,217,183,0.5425,0.639344262295082,0.195,0.89,0.11,0.805,0.2988505747126437
0.882,400,"[[39, 22], [161, 178]]",39,161,22,161,200,200,61,339,217,183,0.5425,0.639344262295082,0.195,0.89,0.11,0.805,0.2988505747126437
0.883,400,"[[39, 22], [161, 178]]",39,161,22,161,200,200,61,339,217,183,0.5425,0.639344262295082,0.195,0.89,0.11,0.805,0.2988505747126437
0.884,400,"[[39, 22], [161, 178]]",39,161,22,161,200,200,61,339,217,183,0.5425,0.639344262295082,0.195,0.89,0.11,0.805,0.2988505747126437
0.885,400,"[[39, 21], [161, 179]]",39,161,21,161,200,200,60,340,218,182,0.545,0.65,0.195,0.895,0.105,0.805,0.3
0.886,400,"[[39, 21], [161, 179]]",39,161,21,161,200,200,60,340,218,182,0.545,0.65,0.195,0.895,0.105,0.805,0.3
0.887,400,"[[39, 21], [161, 179]]",39,161,21,161,200,200,60,340,218,182,0.545,0.65,0.195,0.895,0.105,0.805,0.3
0.888,400,"[[39, 21], [161, 179]]",39,161,21,161,200,200,60,340,218,182,0.545,0.65,0.195,0.895,0.105,0.805,0.3
0.889,400,"[[39, 21], [161, 179]]",39,161,21,161,200,200,60,340,218,182,0.545,0.65,0.195,0.895,0.105,0.805,0.3
0.89,400,"[[38, 21], [162, 179]]",38,162,21,162,200,200,59,341,217,183,0.5425,0.6440677966101694,0.19,0.895,0.105,0.81,0.2934362934362934
0.891,400,"[[38, 20], [162, 180]]",38,162,20,162,200,200,58,342,218,182,0.545,0.6551724137931034,0.19,0.9,0.1,0.81,0.29457364341085274
0.892,400,"[[37, 20], [163, 180]]",37,163,20,163,200,200,57,343,217,183,0.5425,0.6491228070175439,0.185,0.9,0.1,0.815,0.28793774319066145
0.893,400,"[[37, 20], [163, 180]]",37,163,20,163,200,200,57,343,217,183,0.5425,0.6491228070175439,0.185,0.9,0.1,0.815,0.28793774319066145
0.894,400,"[[37, 20], [163, 180]]",37,163,20,163,200,200,57,343,217,183,0.5425,0.6491228070175439,0.185,0.9,0.1,0.815,0.28793774319066145
0.895,400,"[[37, 20], [163, 180]]",37,163,20,163,200,200,57,343,217,183,0.5425,0.6491228070175439,0.185,0.9,0.1,0.815,0.28793774319066145
0.896,400,"[[37, 20], [163, 180]]",37,163,20,163,200,200,57,343,217,183,0.5425,0.6491228070175439,0.185,0.9,0.1,0.815,0.28793774319066145
0.897,400,"[[37, 20], [163, 180]]",37,163,20,163,200,200,57,343,217,183,0.5425,0.6491228070175439,0.185,0.9,0.1,0.815,0.28793774319066145
0.898,400,"[[37, 20], [163, 180]]",37,163,20,163,200,200,57,343,217,183,0.5425,0.6491228070175439,0.185,0.9,0.1,0.815,0.28793774319066145
0.899,400,"[[37, 19], [163, 181]]",37,163,19,163,200,200,56,344,218,182,0.545,0.6607142857142857,0.185,0.905,0.095,0.815,0.28906250000000006
0.9,400,"[[34, 18], [166, 182]]",34,166,18,166,200,200,52,348,216,184,0.54,0.6538461538461539,0.17,0.91,0.09,0.83,0.2698412698412698
0.901,400,"[[34, 18], [166, 182]]",34,166,18,166,200,200,52,348,216,184,0.54,0.6538461538461539,0.17,0.91,0.09,0.83,0.2698412698412698
0.902,400,"[[34, 17], [166, 183]]",34,166,17,166,200,200,51,349,217,183,0.5425,0.6666666666666666,0.17,0.915,0.085,0.83,0.2709163346613546
0.903,400,"[[34, 17], [166, 183]]",34,166,17,166,200,200,51,349,217,183,0.5425,0.6666666666666666,0.17,0.915,0.085,0.83,0.2709163346613546
0.904,400,"[[33, 16], [167, 184]]",33,167,16,167,200,200,49,351,217,183,0.5425,0.673469387755102,0.165,0.92,0.08,0.835,0.26506024096385544
0.905,400,"[[33, 16], [167, 184]]",33,167,16,167,200,200,49,351,217,183,0.5425,0.673469387755102,0.165,0.92,0.08,0.835,0.26506024096385544
0.906,400,"[[33, 16], [167, 184]]",33,167,16,167,200,200,49,351,217,183,0.5425,0.673469387755102,0.165,0.92,0.08,0.835,0.26506024096385544
0.907,400,"[[33, 16], [167, 184]]",33,167,16,167,200,200,49,351,217,183,0.5425,0.673469387755102,0.165,0.92,0.08,0.835,0.26506024096385544
0.908,400,"[[33, 16], [167, 184]]",33,167,16,167,200,200,49,351,217,183,0.5425,0.673469387755102,0.165,0.92,0.08,0.835,0.26506024096385544
0.909,400,"[[33, 16], [167, 184]]",33,167,16,167,200,200,49,351,217,183,0.5425,0.673469387755102,0.165,0.92,0.08,0.835,0.26506024096385544
0.91,400,"[[30, 16], [170, 184]]",30,170,16,170,200,200,46,354,214,186,0.535,0.6521739130434783,0.15,0.92,0.08,0.85,0.24390243902439024
0.911,400,"[[30, 16], [170, 184]]",30,170,16,170,200,200,46,354,214,186,0.535,0.6521739130434783,0.15,0.92,0.08,0.85,0.24390243902439024
0.912,400,"[[30, 16], [170, 184]]",30,170,16,170,200,200,46,354,214,186,0.535,0.6521739130434783,0.15,0.92,0.08,0.85,0.24390243902439024
0.913,400,"[[30, 16], [170, 184]]",30,170,16,170,200,200,46,354,214,186,0.535,0.6521739130434783,0.15,0.92,0.08,0.85,0.24390243902439024
0.914,400,"[[29, 16], [171, 184]]",29,171,16,171,200,200,45,355,213,187,0.5325,0.6444444444444445,0.145,0.92,0.08,0.855,0.236734693877551
0.915,400,"[[29, 15], [171, 185]]",29,171,15,171,200,200,44,356,214,186,0.535,0.6590909090909091,0.145,0.925,0.075,0.855,0.23770491803278684
0.916,400,"[[29, 15], [171, 185]]",29,171,15,171,200,200,44,356,214,186,0.535,0.6590909090909091,0.145,0.925,0.075,0.855,0.23770491803278684
0.917,400,"[[29, 15], [171, 185]]",29,171,15,171,200,200,44,356,214,186,0.535,0.6590909090909091,0.145,0.925,0.075,0.855,0.23770491803278684
0.918,400,"[[29, 15], [171, 185]]",29,171,15,171,200,200,44,356,214,186,0.535,0.6590909090909091,0.145,0.925,0.075,0.855,0.23770491803278684
0.919,400,"[[28, 14], [172, 186]]",28,172,14,172,200,200,42,358,214,186,0.535,0.6666666666666666,0.14,0.93,0.07,0.86,0.23140495867768596
0.92,400,"[[28, 14], [172, 186]]",28,172,14,172,200,200,42,358,214,186,0.535,0.6666666666666666,0.14,0.93,0.07,0.86,0.23140495867768596
0.921,400,"[[28, 14], [172, 186]]",28,172,14,172,200,200,42,358,214,186,0.535,0.6666666666666666,0.14,0.93,0.07,0.86,0.23140495867768596
0.922,400,"[[27, 14], [173, 186]]",27,173,14,173,200,200,41,359,213,187,0.5325,0.6585365853658537,0.135,0.93,0.07,0.865,0.22406639004149378
0.923,400,"[[27, 14], [173, 186]]",27,173,14,173,200,200,41,359,213,187,0.5325,0.6585365853658537,0.135,0.93,0.07,0.865,0.22406639004149378
0.924,400,"[[27, 14], [173, 186]]",27,173,14,173,200,200,41,359,213,187,0.5325,0.6585365853658537,0.135,0.93,0.07,0.865,0.22406639004149378
0.925,400,"[[27, 14], [173, 186]]",27,173,14,173,200,200,41,359,213,187,0.5325,0.6585365853658537,0.135,0.93,0.07,0.865,0.22406639004149378
0.926,400,"[[27, 14], [173, 186]]",27,173,14,173,200,200,41,359,213,187,0.5325,0.6585365853658537,0.135,0.93,0.07,0.865,0.22406639004149378
0.927,400,"[[27, 14], [173, 186]]",27,173,14,173,200,200,41,359,213,187,0.5325,0.6585365853658537,0.135,0.93,0.07,0.865,0.22406639004149378
0.928,400,"[[27, 14], [173, 186]]",27,173,14,173,200,200,41,359,213,187,0.5325,0.6585365853658537,0.135,0.93,0.07,0.865,0.22406639004149378
0.929,400,"[[27, 13], [173, 187]]",27,173,13,173,200,200,40,360,214,186,0.535,0.675,0.135,0.935,0.065,0.865,0.225
0.93,400,"[[27, 13], [173, 187]]",27,173,13,173,200,200,40,360,214,186,0.535,0.675,0.135,0.935,0.065,0.865,0.225
0.931,400,"[[26, 13], [174, 187]]",26,174,13,174,200,200,39,361,213,187,0.5325,0.6666666666666666,0.13,0.935,0.065,0.87,0.2175732217573222
0.932,400,"[[26, 13], [174, 187]]",26,174,13,174,200,200,39,361,213,187,0.5325,0.6666666666666666,0.13,0.935,0.065,0.87,0.2175732217573222
0.933,400,"[[24, 12], [176, 188]]",24,176,12,176,200,200,36,364,212,188,0.53,0.6666666666666666,0.12,0.94,0.06,0.88,0.20338983050847456
0.934,400,"[[24, 12], [176, 188]]",24,176,12,176,200,200,36,364,212,188,0.53,0.6666666666666666,0.12,0.94,0.06,0.88,0.20338983050847456
0.935,400,"[[24, 12], [176, 188]]",24,176,12,176,200,200,36,364,212,188,0.53,0.6666666666666666,0.12,0.94,0.06,0.88,0.20338983050847456
0.936,400,"[[24, 12], [176, 188]]",24,176,12,176,200,200,36,364,212,188,0.53,0.6666666666666666,0.12,0.94,0.06,0.88,0.20338983050847456
0.937,400,"[[24, 12], [176, 188]]",24,176,12,176,200,200,36,364,212,188,0.53,0.6666666666666666,0.12,0.94,0.06,0.88,0.20338983050847456
0.938,400,"[[24, 12], [176, 188]]",24,176,12,176,200,200,36,364,212,188,0.53,0.6666666666666666,0.12,0.94,0.06,0.88,0.20338983050847456
0.939,400,"[[24, 12], [176, 188]]",24,176,12,176,200,200,36,364,212,188,0.53,0.6666666666666666,0.12,0.94,0.06,0.88,0.20338983050847456
0.94,400,"[[24, 12], [176, 188]]",24,176,12,176,200,200,36,364,212,188,0.53,0.6666666666666666,0.12,0.94,0.06,0.88,0.20338983050847456
0.941,400,"[[24, 12], [176, 188]]",24,176,12,176,200,200,36,364,212,188,0.53,0.6666666666666666,0.12,0.94,0.06,0.88,0.20338983050847456
0.942,400,"[[23, 12], [177, 188]]",23,177,12,177,200,200,35,365,211,189,0.5275,0.6571428571428571,0.115,0.94,0.06,0.885,0.19574468085106386
0.943,400,"[[21, 12], [179, 188]]",21,179,12,179,200,200,33,367,209,191,0.5225,0.6363636363636364,0.105,0.94,0.06,0.895,0.18025751072961374
0.944,400,"[[21, 12], [179, 188]]",21,179,12,179,200,200,33,367,209,191,0.5225,0.6363636363636364,0.105,0.94,0.06,0.895,0.18025751072961374
0.945,400,"[[21, 12], [179, 188]]",21,179,12,179,200,200,33,367,209,191,0.5225,0.6363636363636364,0.105,0.94,0.06,0.895,0.18025751072961374
0.946,400,"[[21, 12], [179, 188]]",21,179,12,179,200,200,33,367,209,191,0.5225,0.6363636363636364,0.105,0.94,0.06,0.895,0.18025751072961374
0.947,400,"[[20, 12], [180, 188]]",20,180,12,180,200,200,32,368,208,192,0.52,0.625,0.1,0.94,0.06,0.9,0.1724137931034483
0.948,400,"[[20, 11], [180, 189]]",20,180,11,180,200,200,31,369,209,191,0.5225,0.6451612903225806,0.1,0.945,0.055,0.9,0.17316017316017315
0.949,400,"[[20, 11], [180, 189]]",20,180,11,180,200,200,31,369,209,191,0.5225,0.6451612903225806,0.1,0.945,0.055,0.9,0.17316017316017315
0.95,400,"[[19, 11], [181, 189]]",19,181,11,181,200,200,30,370,208,192,0.52,0.6333333333333333,0.095,0.945,0.055,0.905,0.16521739130434784
0.951,400,"[[19, 11], [181, 189]]",19,181,11,181,200,200,30,370,208,192,0.52,0.6333333333333333,0.095,0.945,0.055,0.905,0.16521739130434784
0.952,400,"[[19, 11], [181, 189]]",19,181,11,181,200,200,30,370,208,192,0.52,0.6333333333333333,0.095,0.945,0.055,0.905,0.16521739130434784
0.953,400,"[[19, 10], [181, 190]]",19,181,10,181,200,200,29,371,209,191,0.5225,0.6551724137931034,0.095,0.95,0.05,0.905,0.16593886462882096
0.954,400,"[[19, 10], [181, 190]]",19,181,10,181,200,200,29,371,209,191,0.5225,0.6551724137931034,0.095,0.95,0.05,0.905,0.16593886462882096
0.955,400,"[[19, 10], [181, 190]]",19,181,10,181,200,200,29,371,209,191,0.5225,0.6551724137931034,0.095,0.95,0.05,0.905,0.16593886462882096
0.956,400,"[[19, 9], [181, 191]]",19,181,9,181,200,200,28,372,210,190,0.525,0.6785714285714286,0.095,0.955,0.045,0.905,0.16666666666666669
0.957,400,"[[18, 9], [182, 191]]",18,182,9,182,200,200,27,373,209,191,0.5225,0.6666666666666666,0.09,0.955,0.045,0.91,0.15859030837004406
0.958,400,"[[18, 9], [182, 191]]",18,182,9,182,200,200,27,373,209,191,0.5225,0.6666666666666666,0.09,0.955,0.045,0.91,0.15859030837004406
0.959,400,"[[18, 9], [182, 191]]",18,182,9,182,200,200,27,373,209,191,0.5225,0.6666666666666666,0.09,0.955,0.045,0.91,0.15859030837004406
0.96,400,"[[18, 8], [182, 192]]",18,182,8,182,200,200,26,374,210,190,0.525,0.6923076923076923,0.09,0.96,0.04,0.91,0.1592920353982301
0.961,400,"[[18, 8], [182, 192]]",18,182,8,182,200,200,26,374,210,190,0.525,0.6923076923076923,0.09,0.96,0.04,0.91,0.1592920353982301
0.962,400,"[[18, 8], [182, 192]]",18,182,8,182,200,200,26,374,210,190,0.525,0.6923076923076923,0.09,0.96,0.04,0.91,0.1592920353982301
0.963,400,"[[18, 8], [182, 192]]",18,182,8,182,200,200,26,374,210,190,0.525,0.6923076923076923,0.09,0.96,0.04,0.91,0.1592920353982301
0.964,400,"[[18, 8], [182, 192]]",18,182,8,182,200,200,26,374,210,190,0.525,0.6923076923076923,0.09,0.96,0.04,0.91,0.1592920353982301
0.965,400,"[[18, 8], [182, 192]]",18,182,8,182,200,200,26,374,210,190,0.525,0.6923076923076923,0.09,0.96,0.04,0.91,0.1592920353982301
0.966,400,"[[18, 8], [182, 192]]",18,182,8,182,200,200,26,374,210,190,0.525,0.6923076923076923,0.09,0.96,0.04,0.91,0.1592920353982301
0.967,400,"[[16, 8], [184, 192]]",16,184,8,184,200,200,24,376,208,192,0.52,0.6666666666666666,0.08,0.96,0.04,0.92,0.14285714285714285
0.968,400,"[[16, 8], [184, 192]]",16,184,8,184,200,200,24,376,208,192,0.52,0.6666666666666666,0.08,0.96,0.04,0.92,0.14285714285714285
0.969,400,"[[16, 8], [184, 192]]",16,184,8,184,200,200,24,376,208,192,0.52,0.6666666666666666,0.08,0.96,0.04,0.92,0.14285714285714285
0.97,400,"[[16, 8], [184, 192]]",16,184,8,184,200,200,24,376,208,192,0.52,0.6666666666666666,0.08,0.96,0.04,0.92,0.14285714285714285
0.971,400,"[[15, 8], [185, 192]]",15,185,8,185,200,200,23,377,207,193,0.5175,0.6521739130434783,0.075,0.96,0.04,0.925,0.13452914798206278
0.972,400,"[[15, 7], [185, 193]]",15,185,7,185,200,200,22,378,208,192,0.52,0.6818181818181818,0.075,0.965,0.035,0.925,0.13513513513513514
0.973,400,"[[15, 7], [185, 193]]",15,185,7,185,200,200,22,378,208,192,0.52,0.6818181818181818,0.075,0.965,0.035,0.925,0.13513513513513514
0.974,400,"[[15, 5], [185, 195]]",15,185,5,185,200,200,20,380,210,190,0.525,0.75,0.075,0.975,0.025,0.925,0.13636363636363635
0.975,400,"[[14, 5], [186, 195]]",14,186,5,186,200,200,19,381,209,191,0.5225,0.7368421052631579,0.07,0.975,0.025,0.93,0.12785388127853883
0.976,400,"[[14, 5], [186, 195]]",14,186,5,186,200,200,19,381,209,191,0.5225,0.7368421052631579,0.07,0.975,0.025,0.93,0.12785388127853883
0.977,400,"[[14, 5], [186, 195]]",14,186,5,186,200,200,19,381,209,191,0.5225,0.7368421052631579,0.07,0.975,0.025,0.93,0.12785388127853883
0.978,400,"[[8, 4], [192, 196]]",8,192,4,192,200,200,12,388,204,196,0.51,0.6666666666666666,0.04,0.98,0.02,0.96,0.07547169811320754
0.979,400,"[[7, 4], [193, 196]]",7,193,4,193,200,200,11,389,203,197,0.5075,0.6363636363636364,0.035,0.98,0.02,0.965,0.06635071090047394
0.98,400,"[[5, 4], [195, 196]]",5,195,4,195,200,200,9,391,201,199,0.5025,0.5555555555555556,0.025,0.98,0.02,0.975,0.04784688995215311
0.981,400,"[[4, 4], [196, 196]]",4,196,4,196,200,200,8,392,200,200,0.5,0.5,0.02,0.98,0.02,0.98,0.038461538461538464
0.982,400,"[[4, 4], [196, 196]]",4,196,4,196,200,200,8,392,200,200,0.5,0.5,0.02,0.98,0.02,0.98,0.038461538461538464
0.983,400,"[[4, 4], [196, 196]]",4,196,4,196,200,200,8,392,200,200,0.5,0.5,0.02,0.98,0.02,0.98,0.038461538461538464
0.984,400,"[[3, 3], [197, 197]]",3,197,3,197,200,200,6,394,200,200,0.5,0.5,0.015,0.985,0.015,0.985,0.029126213592233007
0.985,400,"[[3, 3], [197, 197]]",3,197,3,197,200,200,6,394,200,200,0.5,0.5,0.015,0.985,0.015,0.985,0.029126213592233007
0.986,400,"[[2, 3], [198, 197]]",2,198,3,198,200,200,5,395,199,201,0.4975,0.4,0.01,0.985,0.015,0.99,0.01951219512195122
0.987,400,"[[1, 3], [199, 197]]",1,199,3,199,200,200,4,396,198,202,0.495,0.25,0.005,0.985,0.015,0.995,0.00980392156862745
0.988,400,"[[1, 3], [199, 197]]",1,199,3,199,200,200,4,396,198,202,0.495,0.25,0.005,0.985,0.015,0.995,0.00980392156862745
0.989,400,"[[1, 3], [199, 197]]",1,199,3,199,200,200,4,396,198,202,0.495,0.25,0.005,0.985,0.015,0.995,0.00980392156862745
0.99,400,"[[1, 3], [199, 197]]",1,199,3,199,200,200,4,396,198,202,0.495,0.25,0.005,0.985,0.015,0.995,0.00980392156862745
0.991,400,"[[0, 2], [200, 198]]",0,200,2,200,200,200,2,398,198,202,0.495,0.0,0.0,0.99,0.01,1.0,
0.992,400,"[[0, 0], [200, 200]]",0,200,0,200,200,200,0,400,200,200,0.5,,0.0,1.0,0.0,1.0,
0.993,400,"[[0, 0], [200, 200]]",0,200,0,200,200,200,0,400,200,200,0.5,,0.0,1.0,0.0,1.0,
0.994,400,"[[0, 0], [200, 200]]",0,200,0,200,200,200,0,400,200,200,0.5,,0.0,1.0,0.0,1.0,
0.995,400,"[[0, 0], [200, 200]]",0,200,0,200,200,200,0,400,200,200,0.5,,0.0,1.0,0.0,1.0,
0.996,400,"[[0, 0], [200, 200]]",0,200,0,200,200,200,0,400,200,200,0.5,,0.0,1.0,0.0,1.0,
0.997,400,"[[0, 0], [200, 200]]",0,200,0,200,200,200,0,400,200,200,0.5,,0.0,1.0,0.0,1.0,
0.998,400,"[[0, 0], [200, 200]]",0,200,0,200,200,200,0,400,200,200,0.5,,0.0,1.0,0.0,1.0,
0.999,400,"[[0, 0], [200, 200]]",0,200,0,200,200,200,0,400,200,200,0.5,,0.0,1.0,0.0,1.0,
1.0,400,"[[0, 0], [200, 200]]",0,200,0,200,200,200,0,400,200,200,0.5,,0.0,1.0,0.0,1.0,
1.001,400,"[[0, 0], [200, 200]]",0,200,0,200,200,200,0,400,200,200,0.5,,0.0,1.0,0.0,1.0,
