Score Threshold,Measurements (M),Confusion Matrix (cm),True Pos.s (TP),True Neg.s (TN),False Pos.s (FP),*False Neg.s* (FN),Positives (P),Negatives (N),Meas.Pos.s (MP),Meas.Neg.s (MN),Correct Meas.s (CM),Incorrect Meas.s (IM),Accuracy (ACC),Precision (PPV),Recall/Sensitivity (TPR),Specificity/Selectivity (TNR),Fallout (FPR),Miss Rate (FNR),F1 Score (F1)
0.0,2910,"[[887, 2023], [0, 0]]",887,0,2023,0,887,2023,2910,0,887,2023,0.3048109965635739,0.3048109965635739,1.0,0.0,1.0,0.0,0.4672109560179089
0.001,2910,"[[883, 1703], [4, 320]]",883,4,1703,4,887,2023,2586,324,1203,1707,0.4134020618556701,0.3414539829853055,0.9954904171364148,0.15818091942659418,0.8418190805734058,0.004509582863585118,0.5084940973221999
0.002,2910,"[[880, 1668], [7, 355]]",880,7,1668,7,887,2023,2548,362,1235,1675,0.42439862542955326,0.3453689167974882,0.992108229988726,0.1754819574888779,0.8245180425111222,0.007891770011273957,0.512372634643377
0.003,2910,"[[879, 1637], [8, 386]]",879,8,1637,8,887,2023,2516,394,1265,1645,0.43470790378006874,0.34936406995230523,0.9909808342728298,0.1908057340583292,0.8091942659416708,0.009019165727170236,0.5166029973552748
0.004,2910,"[[878, 1617], [9, 406]]",878,9,1617,9,887,2023,2495,415,1284,1626,0.44123711340206184,0.35190380761523044,0.9898534385569335,0.20069204152249134,0.7993079584775087,0.010146561443066516,0.5192193968066233
0.005,2910,"[[878, 1603], [9, 420]]",878,9,1603,9,887,2023,2481,429,1298,1612,0.44604810996563576,0.3538895606610238,0.9898534385569335,0.20761245674740483,0.7923875432525952,0.010146561443066516,0.5213776722090262
0.006,2910,"[[878, 1590], [9, 433]]",878,9,1590,9,887,2023,2468,442,1311,1599,0.4505154639175258,0.3557536466774716,0.9898534385569335,0.21403855659911022,0.7859614434008898,0.010146561443066516,0.523397913561848
0.007,2910,"[[878, 1583], [9, 440]]",878,9,1583,9,887,2023,2461,449,1318,1592,0.4529209621993127,0.35676554246241365,0.9898534385569335,0.21749876421156697,0.782501235788433,0.010146561443066516,0.5244922341696535
0.008,2910,"[[878, 1567], [9, 456]]",878,9,1567,9,887,2023,2445,465,1334,1576,0.4584192439862543,0.3591002044989775,0.9898534385569335,0.22540781018289668,0.7745921898171033,0.010146561443066516,0.5270108043217288
0.009,2910,"[[878, 1562], [9, 461]]",878,9,1562,9,887,2023,2440,470,1339,1571,0.4601374570446735,0.3598360655737705,0.9898534385569335,0.22787938704893723,0.7721206129510628,0.010146561443066516,0.5278028253681997
0.01,2910,"[[878, 1559], [9, 464]]",878,9,1559,9,887,2023,2437,473,1342,1568,0.4611683848797251,0.3602790315962249,0.9898534385569335,0.22936233316856156,0.7706376668314384,0.010146561443066516,0.5282791817087846
0.011,2910,"[[878, 1552], [9, 471]]",878,9,1552,9,887,2023,2430,480,1349,1561,0.46357388316151205,0.36131687242798355,0.9898534385569335,0.2328225407810183,0.7671774592189817,0.010146561443066516,0.5293940307506783
0.012,2910,"[[877, 1544], [10, 479]]",877,10,1544,10,887,2023,2421,489,1356,1554,0.465979381443299,0.36224700536968196,0.9887260428410372,0.23677706376668314,0.7632229362333168,0.011273957158962795,0.530229746070133
0.013,2910,"[[877, 1538], [10, 485]]",877,10,1538,10,887,2023,2415,495,1362,1548,0.46804123711340206,0.36314699792960664,0.9887260428410372,0.2397429560059318,0.7602570439940682,0.011273957158962795,0.5311932162325863
0.014,2910,"[[877, 1532], [10, 491]]",877,10,1532,10,887,2023,2409,501,1368,1542,0.47010309278350515,0.3640514736405147,0.9887260428410372,0.24270884824518044,0.7572911517548195,0.011273957158962795,0.5321601941747572
0.015,2910,"[[877, 1529], [10, 494]]",877,10,1529,10,887,2023,2406,504,1371,1539,0.4711340206185567,0.3645054031587697,0.9887260428410372,0.24419179436480473,0.7558082056351952,0.011273957158962795,0.5326450045551169
0.016,2910,"[[877, 1527], [10, 496]]",877,10,1527,10,887,2023,2404,506,1373,1537,0.4718213058419244,0.36480865224625625,0.9887260428410372,0.24518042511122096,0.754819574888779,0.011273957158962795,0.5329687025220298
0.017,2910,"[[877, 1522], [10, 501]]",877,10,1522,10,887,2023,2399,511,1378,1532,0.4735395189003436,0.36556898707794916,0.9887260428410372,0.2476520019772615,0.7523479980227386,0.011273957158962795,0.5337796713329275
0.018,2910,"[[877, 1516], [10, 507]]",877,10,1516,10,887,2023,2393,517,1384,1526,0.4756013745704467,0.3664855829502716,0.9887260428410372,0.25061789421651015,0.7493821057834898,0.011273957158962795,0.5347560975609756
0.019,2910,"[[877, 1511], [10, 512]]",877,10,1511,10,887,2023,2388,522,1389,1521,0.477319587628866,0.36725293132328307,0.9887260428410372,0.25308947108255064,0.7469105289174494,0.011273957158962795,0.5355725190839695
0.02,2910,"[[875, 1505], [12, 518]]",875,12,1505,12,887,2023,2380,530,1393,1517,0.4786941580756014,0.36764705882352944,0.9864712514092446,0.2560553633217993,0.7439446366782007,0.013528748590755355,0.5356596265687175
0.021,2910,"[[874, 1499], [13, 524]]",874,13,1499,13,887,2023,2373,537,1398,1512,0.48041237113402063,0.3683101559207754,0.9853438556933484,0.25902125556104794,0.7409787444389521,0.014656144306651634,0.5361963190184048
0.022,2910,"[[873, 1493], [14, 530]]",873,14,1493,14,887,2023,2366,544,1403,1507,0.48213058419243987,0.3689771766694844,0.9842164599774521,0.2619871478002966,0.7380128521997034,0.015783540022547914,0.5367353212419305
0.023,2910,"[[872, 1485], [15, 538]]",872,15,1485,15,887,2023,2357,553,1410,1500,0.4845360824742268,0.36996181586762833,0.9830890642615558,0.2659416707859614,0.7340583292140386,0.016910935738444193,0.5376078914919851
0.024,2910,"[[872, 1482], [15, 541]]",872,15,1482,15,887,2023,2354,556,1413,1497,0.48556701030927835,0.37043330501274424,0.9830890642615558,0.2674246169055858,0.7325753830944143,0.016910935738444193,0.5381055229867324
0.025,2910,"[[872, 1479], [15, 544]]",872,15,1479,15,887,2023,2351,559,1416,1494,0.4865979381443299,0.3709059974478945,0.9830890642615558,0.2689075630252101,0.7310924369747899,0.016910935738444193,0.5386040765904879
0.026,2910,"[[872, 1472], [15, 551]]",872,15,1472,15,887,2023,2344,566,1423,1487,0.4890034364261168,0.3720136518771331,0.9830890642615558,0.2723677706376668,0.7276322293623332,0.016910935738444193,0.5397709687403281
0.027,2910,"[[871, 1469], [16, 554]]",871,16,1469,16,887,2023,2340,570,1425,1485,0.4896907216494845,0.37222222222222223,0.9819616685456595,0.27385071675729117,0.7261492832427089,0.018038331454340473,0.5398202665013945
0.028,2910,"[[871, 1466], [16, 557]]",871,16,1466,16,887,2023,2337,573,1428,1482,0.49072164948453606,0.3727000427899016,0.9819616685456595,0.27533366287691546,0.7246663371230845,0.018038331454340473,0.5403225806451614
0.029,2910,"[[871, 1463], [16, 560]]",871,16,1463,16,887,2023,2334,576,1431,1479,0.4917525773195876,0.3731790916880891,0.9819616685456595,0.2768166089965398,0.7231833910034602,0.018038331454340473,0.5408258304874262
0.03,2910,"[[871, 1460], [16, 563]]",871,16,1460,16,887,2023,2331,579,1434,1476,0.4927835051546392,0.3736593736593737,0.9819616685456595,0.2782995551161641,0.7217004448838359,0.018038331454340473,0.5413300186451212
0.031,2910,"[[869, 1457], [18, 566]]",869,18,1457,18,887,2023,2326,584,1435,1475,0.49312714776632305,0.37360275150472916,0.979706877113867,0.2797825012357884,0.7202174987642116,0.020293122886133032,0.5409274821039527
0.032,2910,"[[869, 1455], [18, 568]]",869,18,1455,18,887,2023,2324,586,1437,1473,0.49381443298969074,0.37392426850258176,0.979706877113867,0.28077113198220466,0.7192288680177954,0.020293122886133032,0.5412644036125818
0.033,2910,"[[869, 1451], [18, 572]]",869,18,1451,18,887,2023,2320,590,1441,1469,0.49518900343642613,0.3745689655172414,0.979706877113867,0.28274839347503705,0.7172516065249629,0.020293122886133032,0.5419395073277206
0.034,2910,"[[869, 1449], [18, 574]]",869,18,1449,18,887,2023,2318,592,1443,1467,0.49587628865979383,0.37489214840379637,0.979706877113867,0.2837370242214533,0.7162629757785467,0.020293122886133032,0.5422776911076442
0.035,2910,"[[867, 1447], [20, 576]]",867,20,1447,20,887,2023,2314,596,1443,1467,0.49587628865979383,0.374675885911841,0.9774520856820744,0.2847256549678695,0.7152743450321305,0.02254791431792559,0.5417057169634489
0.036,2910,"[[867, 1445], [20, 578]]",867,20,1445,20,887,2023,2312,598,1445,1465,0.4965635738831615,0.375,0.9774520856820744,0.2857142857142857,0.7142857142857143,0.02254791431792559,0.5420443888715224
0.037,2910,"[[865, 1444], [22, 579]]",865,22,1444,22,887,2023,2309,601,1444,1466,0.4962199312714777,0.37462104807275876,0.9751972942502819,0.2862086010874938,0.7137913989125062,0.02480270574971815,0.5413016270337923
0.038,2910,"[[865, 1443], [22, 580]]",865,22,1443,22,887,2023,2308,602,1445,1465,0.4965635738831615,0.3747833622183709,0.9751972942502819,0.28670291646070195,0.7132970835392981,0.02480270574971815,0.5414710485133021
0.039,2910,"[[865, 1439], [22, 584]]",865,22,1439,22,887,2023,2304,606,1449,1461,0.4979381443298969,0.3754340277777778,0.9751972942502819,0.28868017795353434,0.7113198220464656,0.02480270574971815,0.5421497963020997
0.04,2910,"[[864, 1435], [23, 588]]",864,23,1435,23,887,2023,2299,611,1452,1458,0.49896907216494846,0.3758155719878208,0.9740698985343855,0.2906574394463668,0.7093425605536332,0.02593010146561443,0.5423728813559322
0.041,2910,"[[864, 1434], [23, 589]]",864,23,1434,23,887,2023,2298,612,1453,1457,0.4993127147766323,0.37597911227154046,0.9740698985343855,0.2911517548195749,0.7088482451804251,0.02593010146561443,0.5425431711145996
0.042,2910,"[[864, 1433], [23, 590]]",864,23,1433,23,887,2023,2297,613,1454,1456,0.49965635738831615,0.3761427949499347,0.9740698985343855,0.291646070192783,0.708353929807217,0.02593010146561443,0.542713567839196
0.043,2910,"[[864, 1430], [23, 593]]",864,23,1430,23,887,2023,2294,616,1457,1453,0.5006872852233677,0.37663469921534437,0.9740698985343855,0.29312901631240734,0.7068709836875927,0.02593010146561443,0.543225400817353
0.044,2910,"[[864, 1424], [23, 599]]",864,23,1424,23,887,2023,2288,622,1463,1447,0.5027491408934708,0.3776223776223776,0.9740698985343855,0.29609490855165593,0.703905091448344,0.02593010146561443,0.544251968503937
0.045,2910,"[[863, 1421], [24, 602]]",863,24,1421,24,887,2023,2284,626,1465,1445,0.5034364261168385,0.37784588441330996,0.9729425028184893,0.2975778546712803,0.7024221453287197,0.02705749718151071,0.5443077893409018
0.046,2910,"[[862, 1421], [25, 602]]",862,25,1421,25,887,2023,2283,627,1464,1446,0.5030927835051546,0.37757336837494526,0.971815107102593,0.2975778546712803,0.7024221453287197,0.02818489289740699,0.5438485804416404
0.047,2910,"[[862, 1420], [25, 603]]",862,25,1420,25,887,2023,2282,628,1465,1445,0.5034364261168385,0.37773882559158634,0.971815107102593,0.2980721700444884,0.7019278299555116,0.02818489289740699,0.5440201956453139
0.048,2910,"[[862, 1418], [25, 605]]",862,25,1418,25,887,2023,2280,630,1467,1443,0.5041237113402062,0.3780701754385965,0.971815107102593,0.2990608007909046,0.7009391992090954,0.02818489289740699,0.5443637511840859
0.049,2910,"[[862, 1415], [25, 608]]",862,25,1415,25,887,2023,2277,633,1470,1440,0.5051546391752577,0.37856829161176986,0.971815107102593,0.30054374691052893,0.6994562530894711,0.02818489289740699,0.5448798988621998
0.05,2910,"[[862, 1412], [25, 611]]",862,25,1412,25,887,2023,2274,636,1473,1437,0.5061855670103093,0.37906772207563766,0.971815107102593,0.3020266930301532,0.6979733069698467,0.02818489289740699,0.5453970262575134
0.051,2910,"[[862, 1410], [25, 613]]",862,25,1410,25,887,2023,2272,638,1475,1435,0.506872852233677,0.37940140845070425,0.971815107102593,0.3030153237765695,0.6969846762234305,0.02818489289740699,0.5457423235201013
0.052,2910,"[[862, 1409], [25, 614]]",862,25,1409,25,887,2023,2271,639,1476,1434,0.5072164948453608,0.37956847203874944,0.971815107102593,0.3035096391497776,0.6964903608502224,0.02818489289740699,0.545915136162128
0.053,2910,"[[862, 1408], [25, 615]]",862,25,1408,25,887,2023,2270,640,1477,1433,0.5075601374570446,0.37973568281938325,0.971815107102593,0.3040039545229857,0.6959960454770143,0.02818489289740699,0.5460880582831802
0.054,2910,"[[862, 1406], [25, 617]]",862,25,1406,25,887,2023,2268,642,1479,1431,0.5082474226804123,0.3800705467372134,0.971815107102593,0.3049925852694019,0.6950074147305981,0.02818489289740699,0.5464342313787638
0.055,2910,"[[860, 1405], [27, 618]]",860,27,1405,27,887,2023,2265,645,1478,1432,0.5079037800687285,0.37969094922737306,0.9695603156708005,0.30548690064260997,0.69451309935739,0.030439684329199548,0.5456852791878173
0.056,2910,"[[860, 1404], [27, 619]]",860,27,1404,27,887,2023,2264,646,1479,1431,0.5082474226804123,0.37985865724381623,0.9695603156708005,0.30598121601581807,0.6940187839841819,0.030439684329199548,0.5458584576324976
0.057,2910,"[[860, 1401], [27, 622]]",860,27,1401,27,887,2023,2261,649,1482,1428,0.5092783505154639,0.3803626713843432,0.9695603156708005,0.3074641621354424,0.6925358378645576,0.030439684329199548,0.5463786531130876
0.058,2910,"[[860, 1400], [27, 623]]",860,27,1400,27,887,2023,2260,650,1483,1427,0.5096219931271477,0.3805309734513274,0.9695603156708005,0.3079584775086505,0.6920415224913494,0.030439684329199548,0.5465522720050842
0.059,2910,"[[860, 1398], [27, 625]]",860,27,1398,27,887,2023,2258,652,1485,1425,0.5103092783505154,0.3808680248007086,0.9695603156708005,0.3089471082550667,0.6910528917449332,0.030439684329199548,0.546899841017488
0.06,2910,"[[859, 1397], [28, 626]]",859,28,1397,28,887,2023,2256,654,1485,1425,0.5103092783505154,0.3807624113475177,0.9684329199549042,0.3094414236282748,0.6905585763717251,0.03156708004509583,0.5466115176582883
0.061,2910,"[[859, 1395], [28, 628]]",859,28,1395,28,887,2023,2254,656,1487,1423,0.5109965635738831,0.3811002661934339,0.9684329199549042,0.31043005437469107,0.6895699456253089,0.03156708004509583,0.5469595670168735
0.062,2910,"[[859, 1391], [28, 632]]",859,28,1391,28,887,2023,2250,660,1491,1419,0.5123711340206185,0.38177777777777777,0.9684329199549042,0.31240731586752346,0.6875926841324765,0.03156708004509583,0.5476569971310169
0.063,2910,"[[859, 1390], [28, 633]]",859,28,1390,28,887,2023,2249,661,1492,1418,0.5127147766323024,0.3819475322365496,0.9684329199549042,0.31290163124073156,0.6870983687592684,0.03156708004509583,0.5478316326530612
0.064,2910,"[[859, 1390], [28, 633]]",859,28,1390,28,887,2023,2249,661,1492,1418,0.5127147766323024,0.3819475322365496,0.9684329199549042,0.31290163124073156,0.6870983687592684,0.03156708004509583,0.5478316326530612
0.065,2910,"[[859, 1387], [28, 636]]",859,28,1387,28,887,2023,2246,664,1495,1415,0.5137457044673539,0.38245770258236866,0.9684329199549042,0.3143845773603559,0.6856154226396441,0.03156708004509583,0.5483562081072454
0.066,2910,"[[859, 1385], [28, 638]]",859,28,1385,28,887,2023,2244,666,1497,1413,0.5144329896907216,0.3827985739750446,0.9684329199549042,0.3153732081067721,0.6846267918932278,0.03156708004509583,0.548706483551581
0.067,2910,"[[858, 1381], [29, 642]]",858,29,1381,29,887,2023,2239,671,1500,1410,0.5154639175257731,0.38320678874497544,0.9673055242390078,0.31735046959960456,0.6826495304003954,0.03269447576099211,0.5489443378119001
0.068,2910,"[[858, 1380], [29, 643]]",858,29,1380,29,887,2023,2238,672,1501,1409,0.5158075601374571,0.38337801608579086,0.9673055242390078,0.31784478497281266,0.6821552150271873,0.03269447576099211,0.5491199999999999
0.069,2910,"[[858, 1380], [29, 643]]",858,29,1380,29,887,2023,2238,672,1501,1409,0.5158075601374571,0.38337801608579086,0.9673055242390078,0.31784478497281266,0.6821552150271873,0.03269447576099211,0.5491199999999999
0.07,2910,"[[858, 1378], [29, 645]]",858,29,1378,29,887,2023,2236,674,1503,1407,0.5164948453608248,0.38372093023255816,0.9673055242390078,0.31883341571922885,0.6811665842807711,0.03269447576099211,0.5494716618635926
0.071,2910,"[[858, 1377], [29, 646]]",858,29,1377,29,887,2023,2235,675,1504,1406,0.5168384879725086,0.3838926174496644,0.9673055242390078,0.31932773109243695,0.680672268907563,0.03269447576099211,0.549647661755285
0.072,2910,"[[858, 1374], [29, 649]]",858,29,1374,29,887,2023,2232,678,1507,1403,0.5178694158075602,0.3844086021505376,0.9673055242390078,0.3208106772120613,0.6791893227879388,0.03269447576099211,0.5501763385700545
0.073,2910,"[[858, 1373], [29, 650]]",858,29,1373,29,887,2023,2231,679,1508,1402,0.518213058419244,0.38458090542357687,0.9673055242390078,0.3213049925852694,0.6786950074147305,0.03269447576099211,0.5503527902501604
0.074,2910,"[[858, 1373], [29, 650]]",858,29,1373,29,887,2023,2231,679,1508,1402,0.518213058419244,0.38458090542357687,0.9673055242390078,0.3213049925852694,0.6786950074147305,0.03269447576099211,0.5503527902501604
0.075,2910,"[[858, 1373], [29, 650]]",858,29,1373,29,887,2023,2231,679,1508,1402,0.518213058419244,0.38458090542357687,0.9673055242390078,0.3213049925852694,0.6786950074147305,0.03269447576099211,0.5503527902501604
0.076,2910,"[[857, 1372], [30, 651]]",857,30,1372,30,887,2023,2229,681,1508,1402,0.518213058419244,0.3844773441004935,0.9661781285231116,0.3217993079584775,0.6782006920415224,0.033821871476888386,0.5500641848523748
0.077,2910,"[[856, 1371], [31, 652]]",856,31,1371,31,887,2023,2227,683,1508,1402,0.518213058419244,0.38437359676695104,0.9650507328072153,0.3222936233316856,0.6777063766683143,0.03494926719278467,0.5497752087347463
0.078,2910,"[[856, 1369], [31, 654]]",856,31,1369,31,887,2023,2225,685,1510,1400,0.5189003436426117,0.38471910112359553,0.9650507328072153,0.32328225407810185,0.6767177459218982,0.03494926719278467,0.5501285347043702
0.079,2910,"[[856, 1367], [31, 656]]",856,31,1367,31,887,2023,2223,687,1512,1398,0.5195876288659794,0.38506522717049035,0.9650507328072153,0.32427088482451805,0.675729115175482,0.03494926719278467,0.5504823151125402
0.08,2910,"[[855, 1367], [32, 656]]",855,32,1367,32,887,2023,2222,688,1511,1399,0.5192439862542956,0.3847884788478848,0.963923337091319,0.32427088482451805,0.675729115175482,0.036076662908680945,0.5500160823415889
0.081,2910,"[[855, 1365], [32, 658]]",855,32,1365,32,887,2023,2220,690,1513,1397,0.5199312714776633,0.38513513513513514,0.963923337091319,0.32525951557093424,0.6747404844290658,0.036076662908680945,0.5503701319600901
0.082,2910,"[[855, 1364], [32, 659]]",855,32,1364,32,887,2023,2219,691,1514,1396,0.5202749140893471,0.38530869761153674,0.963923337091319,0.32575383094414234,0.6742461690558577,0.036076662908680945,0.5505473277527366
0.083,2910,"[[855, 1359], [32, 664]]",855,32,1359,32,887,2023,2214,696,1519,1391,0.5219931271477664,0.3861788617886179,0.963923337091319,0.3282254078101829,0.671774592189817,0.036076662908680945,0.5514350209609803
0.084,2910,"[[855, 1358], [32, 665]]",855,32,1358,32,887,2023,2213,697,1520,1390,0.5223367697594502,0.38635336647085405,0.963923337091319,0.328719723183391,0.671280276816609,0.036076662908680945,0.5516129032258065
0.085,2910,"[[855, 1356], [32, 667]]",855,32,1356,32,887,2023,2211,699,1522,1388,0.5230240549828179,0.38670284938941657,0.963923337091319,0.32970835392980724,0.6702916460701928,0.036076662908680945,0.551969012265978
0.086,2910,"[[855, 1355], [32, 668]]",855,32,1355,32,887,2023,2210,700,1523,1387,0.5233676975945017,0.38687782805429866,0.963923337091319,0.33020266930301534,0.6697973306969847,0.036076662908680945,0.5521472392638036
0.087,2910,"[[855, 1353], [32, 670]]",855,32,1353,32,887,2023,2208,702,1525,1385,0.5240549828178694,0.38722826086956524,0.963923337091319,0.33119130004943154,0.6688086999505685,0.036076662908680945,0.5525040387722133
0.088,2910,"[[855, 1351], [32, 672]]",855,32,1351,32,887,2023,2206,704,1527,1383,0.5247422680412371,0.38757932910244786,0.963923337091319,0.33217993079584773,0.6678200692041523,0.036076662908680945,0.5528612997090203
0.089,2910,"[[855, 1351], [32, 672]]",855,32,1351,32,887,2023,2206,704,1527,1383,0.5247422680412371,0.38757932910244786,0.963923337091319,0.33217993079584773,0.6678200692041523,0.036076662908680945,0.5528612997090203
0.09,2910,"[[855, 1350], [32, 673]]",855,32,1350,32,887,2023,2205,705,1528,1382,0.525085910652921,0.3877551020408163,0.963923337091319,0.33267424616905583,0.6673257538309442,0.036076662908680945,0.5530401034928849
0.091,2910,"[[855, 1349], [32, 674]]",855,32,1349,32,887,2023,2204,706,1529,1381,0.5254295532646048,0.3879310344827586,0.963923337091319,0.333168561542264,0.6668314384577361,0.036076662908680945,0.5532190229699127
0.092,2910,"[[854, 1347], [33, 676]]",854,33,1347,33,887,2023,2201,709,1530,1380,0.5257731958762887,0.3880054520672422,0.9627959413754228,0.3341571922886802,0.6658428077113199,0.03720405862457723,0.5531088082901554
0.093,2910,"[[854, 1347], [33, 676]]",854,33,1347,33,887,2023,2201,709,1530,1380,0.5257731958762887,0.3880054520672422,0.9627959413754228,0.3341571922886802,0.6658428077113199,0.03720405862457723,0.5531088082901554
0.094,2910,"[[854, 1347], [33, 676]]",854,33,1347,33,887,2023,2201,709,1530,1380,0.5257731958762887,0.3880054520672422,0.9627959413754228,0.3341571922886802,0.6658428077113199,0.03720405862457723,0.5531088082901554
0.095,2910,"[[853, 1346], [34, 677]]",853,34,1346,34,887,2023,2199,711,1530,1380,0.5257731958762887,0.3879035925420646,0.9616685456595265,0.3346515076618883,0.6653484923381117,0.038331454340473504,0.5528191834089436
0.096,2910,"[[852, 1344], [35, 679]]",852,35,1344,35,887,2023,2196,714,1531,1379,0.5261168384879725,0.3879781420765027,0.9605411499436303,0.3356401384083045,0.6643598615916955,0.03945885005636979,0.5527084009082063
0.097,2910,"[[852, 1344], [35, 679]]",852,35,1344,35,887,2023,2196,714,1531,1379,0.5261168384879725,0.3879781420765027,0.9605411499436303,0.3356401384083045,0.6643598615916955,0.03945885005636979,0.5527084009082063
0.098,2910,"[[852, 1344], [35, 679]]",852,35,1344,35,887,2023,2196,714,1531,1379,0.5261168384879725,0.3879781420765027,0.9605411499436303,0.3356401384083045,0.6643598615916955,0.03945885005636979,0.5527084009082063
0.099,2910,"[[852, 1344], [35, 679]]",852,35,1344,35,887,2023,2196,714,1531,1379,0.5261168384879725,0.3879781420765027,0.9605411499436303,0.3356401384083045,0.6643598615916955,0.03945885005636979,0.5527084009082063
0.1,2910,"[[852, 1344], [35, 679]]",852,35,1344,35,887,2023,2196,714,1531,1379,0.5261168384879725,0.3879781420765027,0.9605411499436303,0.3356401384083045,0.6643598615916955,0.03945885005636979,0.5527084009082063
0.101,2910,"[[852, 1342], [35, 681]]",852,35,1342,35,887,2023,2194,716,1533,1377,0.5268041237113402,0.38833181403828626,0.9605411499436303,0.33662876915472073,0.6633712308452793,0.03945885005636979,0.5530671859785784
0.102,2910,"[[852, 1339], [35, 684]]",852,35,1339,35,887,2023,2191,719,1536,1374,0.5278350515463918,0.3888635326335007,0.9605411499436303,0.338111715274345,0.661888284725655,0.03945885005636979,0.5536062378167641
0.103,2910,"[[852, 1337], [35, 686]]",852,35,1337,35,887,2023,2189,721,1538,1372,0.5285223367697595,0.3892188213796254,0.9605411499436303,0.3391003460207612,0.6608996539792388,0.03945885005636979,0.5539661898569571
0.104,2910,"[[852, 1337], [35, 686]]",852,35,1337,35,887,2023,2189,721,1538,1372,0.5285223367697595,0.3892188213796254,0.9605411499436303,0.3391003460207612,0.6608996539792388,0.03945885005636979,0.5539661898569571
0.105,2910,"[[852, 1336], [35, 687]]",852,35,1336,35,887,2023,2188,722,1539,1371,0.5288659793814433,0.38939670932358317,0.9605411499436303,0.3395946613939694,0.6604053386060307,0.03945885005636979,0.5541463414634146
0.106,2910,"[[852, 1335], [35, 688]]",852,35,1335,35,887,2023,2187,723,1540,1370,0.5292096219931272,0.3895747599451303,0.9605411499436303,0.3400889767671775,0.6599110232328226,0.03945885005636979,0.5543266102797658
0.107,2910,"[[851, 1335], [36, 688]]",851,36,1335,36,887,2023,2186,724,1539,1371,0.5288659793814433,0.38929551692589204,0.9594137542277339,0.3400889767671775,0.6599110232328226,0.040586245772266064,0.5538561666124309
0.108,2910,"[[851, 1335], [36, 688]]",851,36,1335,36,887,2023,2186,724,1539,1371,0.5288659793814433,0.38929551692589204,0.9594137542277339,0.3400889767671775,0.6599110232328226,0.040586245772266064,0.5538561666124309
0.109,2910,"[[851, 1335], [36, 688]]",851,36,1335,36,887,2023,2186,724,1539,1371,0.5288659793814433,0.38929551692589204,0.9594137542277339,0.3400889767671775,0.6599110232328226,0.040586245772266064,0.5538561666124309
0.11,2910,"[[851, 1335], [36, 688]]",851,36,1335,36,887,2023,2186,724,1539,1371,0.5288659793814433,0.38929551692589204,0.9594137542277339,0.3400889767671775,0.6599110232328226,0.040586245772266064,0.5538561666124309
0.111,2910,"[[851, 1333], [36, 690]]",851,36,1333,36,887,2023,2184,726,1541,1369,0.529553264604811,0.38965201465201466,0.9594137542277339,0.3410776075135937,0.6589223924864063,0.040586245772266064,0.5542168674698795
0.112,2910,"[[851, 1333], [36, 690]]",851,36,1333,36,887,2023,2184,726,1541,1369,0.529553264604811,0.38965201465201466,0.9594137542277339,0.3410776075135937,0.6589223924864063,0.040586245772266064,0.5542168674698795
0.113,2910,"[[851, 1332], [36, 691]]",851,36,1332,36,887,2023,2183,727,1542,1368,0.5298969072164949,0.3898305084745763,0.9594137542277339,0.34157192288680177,0.6584280771131982,0.040586245772266064,0.5543973941368078
0.114,2910,"[[851, 1332], [36, 691]]",851,36,1332,36,887,2023,2183,727,1542,1368,0.5298969072164949,0.3898305084745763,0.9594137542277339,0.34157192288680177,0.6584280771131982,0.040586245772266064,0.5543973941368078
0.115,2910,"[[851, 1330], [36, 693]]",851,36,1330,36,887,2023,2181,729,1544,1366,0.5305841924398625,0.3901879871618524,0.9594137542277339,0.34256055363321797,0.657439446366782,0.040586245772266064,0.5547588005215124
0.116,2910,"[[851, 1330], [36, 693]]",851,36,1330,36,887,2023,2181,729,1544,1366,0.5305841924398625,0.3901879871618524,0.9594137542277339,0.34256055363321797,0.657439446366782,0.040586245772266064,0.5547588005215124
0.117,2910,"[[851, 1329], [36, 694]]",851,36,1329,36,887,2023,2180,730,1545,1365,0.5309278350515464,0.3903669724770642,0.9594137542277339,0.3430548690064261,0.6569451309935739,0.040586245772266064,0.5549396804695141
0.118,2910,"[[851, 1328], [36, 695]]",851,36,1328,36,887,2023,2179,731,1546,1364,0.5312714776632302,0.390546122074346,0.9594137542277339,0.3435491843796342,0.6564508156203658,0.040586245772266064,0.5551206784083497
0.119,2910,"[[851, 1328], [36, 695]]",851,36,1328,36,887,2023,2179,731,1546,1364,0.5312714776632302,0.390546122074346,0.9594137542277339,0.3435491843796342,0.6564508156203658,0.040586245772266064,0.5551206784083497
0.12,2910,"[[851, 1327], [36, 696]]",851,36,1327,36,887,2023,2178,732,1547,1363,0.5316151202749141,0.3907254361799816,0.9594137542277339,0.3440434997528423,0.6559565002471577,0.040586245772266064,0.5553017944535072
0.121,2910,"[[851, 1327], [36, 696]]",851,36,1327,36,887,2023,2178,732,1547,1363,0.5316151202749141,0.3907254361799816,0.9594137542277339,0.3440434997528423,0.6559565002471577,0.040586245772266064,0.5553017944535072
0.122,2910,"[[851, 1324], [36, 699]]",851,36,1324,36,887,2023,2175,735,1550,1360,0.5326460481099656,0.391264367816092,0.9594137542277339,0.3455264458724666,0.6544735541275334,0.040586245772266064,0.5558458523840627
0.123,2910,"[[850, 1324], [37, 699]]",850,37,1324,37,887,2023,2174,736,1549,1361,0.5323024054982818,0.39098436062557496,0.9582863585118376,0.3455264458724666,0.6544735541275334,0.04171364148816235,0.5553740607644561
0.124,2910,"[[850, 1321], [37, 702]]",850,37,1321,37,887,2023,2171,739,1552,1358,0.5333333333333333,0.391524643021649,0.9582863585118376,0.34700939199209097,0.6529906080079091,0.04171364148816235,0.5559189012426423
0.125,2910,"[[850, 1321], [37, 702]]",850,37,1321,37,887,2023,2171,739,1552,1358,0.5333333333333333,0.391524643021649,0.9582863585118376,0.34700939199209097,0.6529906080079091,0.04171364148816235,0.5559189012426423
0.126,2910,"[[850, 1321], [37, 702]]",850,37,1321,37,887,2023,2171,739,1552,1358,0.5333333333333333,0.391524643021649,0.9582863585118376,0.34700939199209097,0.6529906080079091,0.04171364148816235,0.5559189012426423
0.127,2910,"[[850, 1320], [37, 703]]",850,37,1320,37,887,2023,2170,740,1553,1357,0.5336769759450172,0.391705069124424,0.9582863585118376,0.34750370736529906,0.652496292634701,0.04171364148816235,0.5561007523716062
0.128,2910,"[[850, 1318], [37, 705]]",850,37,1318,37,887,2023,2168,742,1555,1355,0.5343642611683849,0.39206642066420666,0.9582863585118376,0.34849233811171526,0.6515076618882847,0.04171364148816235,0.5564648117839608
0.129,2910,"[[850, 1317], [37, 706]]",850,37,1317,37,887,2023,2167,743,1556,1354,0.5347079037800687,0.3922473465620674,0.9582863585118376,0.34898665348492336,0.6510133465150766,0.04171364148816235,0.5566470203012442
0.13,2910,"[[850, 1316], [37, 707]]",850,37,1316,37,887,2023,2166,744,1557,1353,0.5350515463917526,0.39242843951985223,0.9582863585118376,0.3494809688581315,0.6505190311418685,0.04171364148816235,0.5568293481821159
0.131,2910,"[[849, 1316], [38, 707]]",849,38,1316,38,887,2023,2165,745,1556,1354,0.5347079037800687,0.39214780600461896,0.9571589627959414,0.3494809688581315,0.6505190311418685,0.04284103720405862,0.556356487549148
0.132,2910,"[[849, 1315], [38, 708]]",849,38,1315,38,887,2023,2164,746,1557,1353,0.5350515463917526,0.3923290203327172,0.9571589627959414,0.3499752842313396,0.6500247157686604,0.04284103720405862,0.5565388397246804
0.133,2910,"[[849, 1313], [38, 710]]",849,38,1313,38,887,2023,2162,748,1559,1351,0.5357388316151203,0.3926919518963922,0.9571589627959414,0.3509639149777558,0.6490360850222442,0.04284103720405862,0.5569039029189898
0.134,2910,"[[849, 1312], [38, 711]]",849,38,1312,38,887,2023,2161,749,1560,1350,0.5360824742268041,0.3928736695974086,0.9571589627959414,0.3514582303509639,0.6485417696490361,0.04284103720405862,0.5570866141732282
0.135,2910,"[[849, 1310], [38, 713]]",849,38,1310,38,887,2023,2159,751,1562,1348,0.5367697594501718,0.39323761000463175,0.9571589627959414,0.3524468610973801,0.6475531389026199,0.04284103720405862,0.5574523965856861
0.136,2910,"[[849, 1309], [38, 714]]",849,38,1309,38,887,2023,2158,752,1563,1347,0.5371134020618556,0.3934198331788693,0.9571589627959414,0.35294117647058826,0.6470588235294118,0.04284103720405862,0.5576354679802956
0.137,2910,"[[849, 1309], [38, 714]]",849,38,1309,38,887,2023,2158,752,1563,1347,0.5371134020618556,0.3934198331788693,0.9571589627959414,0.35294117647058826,0.6470588235294118,0.04284103720405862,0.5576354679802956
0.138,2910,"[[849, 1309], [38, 714]]",849,38,1309,38,887,2023,2158,752,1563,1347,0.5371134020618556,0.3934198331788693,0.9571589627959414,0.35294117647058826,0.6470588235294118,0.04284103720405862,0.5576354679802956
0.139,2910,"[[849, 1309], [38, 714]]",849,38,1309,38,887,2023,2158,752,1563,1347,0.5371134020618556,0.3934198331788693,0.9571589627959414,0.35294117647058826,0.6470588235294118,0.04284103720405862,0.5576354679802956
0.14,2910,"[[849, 1308], [38, 715]]",849,38,1308,38,887,2023,2157,753,1564,1346,0.5374570446735395,0.39360222531293465,0.9571589627959414,0.35343549184379636,0.6465645081562037,0.04284103720405862,0.5578186596583443
0.141,2910,"[[849, 1308], [38, 715]]",849,38,1308,38,887,2023,2157,753,1564,1346,0.5374570446735395,0.39360222531293465,0.9571589627959414,0.35343549184379636,0.6465645081562037,0.04284103720405862,0.5578186596583443
0.142,2910,"[[849, 1307], [38, 716]]",849,38,1307,38,887,2023,2156,754,1565,1345,0.5378006872852233,0.3937847866419295,0.9571589627959414,0.35392980721700446,0.6460701927829956,0.04284103720405862,0.558001971738416
0.143,2910,"[[849, 1307], [38, 716]]",849,38,1307,38,887,2023,2156,754,1565,1345,0.5378006872852233,0.3937847866419295,0.9571589627959414,0.35392980721700446,0.6460701927829956,0.04284103720405862,0.558001971738416
0.144,2910,"[[849, 1306], [38, 717]]",849,38,1306,38,887,2023,2155,755,1566,1344,0.5381443298969072,0.39396751740139213,0.9571589627959414,0.35442412259021255,0.6455758774097874,0.04284103720405862,0.5581854043392505
0.145,2910,"[[849, 1306], [38, 717]]",849,38,1306,38,887,2023,2155,755,1566,1344,0.5381443298969072,0.39396751740139213,0.9571589627959414,0.35442412259021255,0.6455758774097874,0.04284103720405862,0.5581854043392505
0.146,2910,"[[849, 1305], [38, 718]]",849,38,1305,38,887,2023,2154,756,1567,1343,0.538487972508591,0.39415041782729804,0.9571589627959414,0.35491843796342065,0.6450815620365793,0.04284103720405862,0.5583689575797435
0.147,2910,"[[848, 1305], [39, 718]]",848,39,1305,39,887,2023,2153,757,1566,1344,0.5381443298969072,0.3938690199721319,0.9560315670800451,0.35491843796342065,0.6450815620365793,0.043968432919954906,0.5578947368421053
0.148,2910,"[[848, 1305], [39, 718]]",848,39,1305,39,887,2023,2153,757,1566,1344,0.5381443298969072,0.3938690199721319,0.9560315670800451,0.35491843796342065,0.6450815620365793,0.043968432919954906,0.5578947368421053
0.149,2910,"[[848, 1305], [39, 718]]",848,39,1305,39,887,2023,2153,757,1566,1344,0.5381443298969072,0.3938690199721319,0.9560315670800451,0.35491843796342065,0.6450815620365793,0.043968432919954906,0.5578947368421053
0.15,2910,"[[848, 1304], [39, 719]]",848,39,1304,39,887,2023,2152,758,1567,1343,0.538487972508591,0.3940520446096654,0.9560315670800451,0.35541275333662875,0.6445872466633712,0.043968432919954906,0.5580783152352747
0.151,2910,"[[848, 1304], [39, 719]]",848,39,1304,39,887,2023,2152,758,1567,1343,0.538487972508591,0.3940520446096654,0.9560315670800451,0.35541275333662875,0.6445872466633712,0.043968432919954906,0.5580783152352747
0.152,2910,"[[848, 1303], [39, 720]]",848,39,1303,39,887,2023,2151,759,1568,1342,0.5388316151202749,0.39423523942352395,0.9560315670800451,0.35590706870983685,0.6440929312901631,0.043968432919954906,0.5582620144832127
0.153,2910,"[[848, 1300], [39, 723]]",848,39,1300,39,887,2023,2148,762,1571,1339,0.5398625429553264,0.3947858472998138,0.9560315670800451,0.3573900148294612,0.6426099851705388,0.043968432919954906,0.5588138385502471
0.154,2910,"[[848, 1300], [39, 723]]",848,39,1300,39,887,2023,2148,762,1571,1339,0.5398625429553264,0.3947858472998138,0.9560315670800451,0.3573900148294612,0.6426099851705388,0.043968432919954906,0.5588138385502471
0.155,2910,"[[846, 1298], [41, 725]]",846,41,1298,41,887,2023,2144,766,1571,1339,0.5398625429553264,0.394589552238806,0.9537767756482526,0.3583786455758774,0.6416213544241226,0.046223224351747465,0.558231606730452
0.156,2910,"[[846, 1297], [41, 726]]",846,41,1297,41,887,2023,2143,767,1572,1338,0.5402061855670103,0.3947736817545497,0.9537767756482526,0.3588729609490855,0.6411270390509145,0.046223224351747465,0.5584158415841585
0.157,2910,"[[846, 1297], [41, 726]]",846,41,1297,41,887,2023,2143,767,1572,1338,0.5402061855670103,0.3947736817545497,0.9537767756482526,0.3588729609490855,0.6411270390509145,0.046223224351747465,0.5584158415841585
0.158,2910,"[[845, 1297], [42, 726]]",845,42,1297,42,887,2023,2142,768,1571,1339,0.5398625429553264,0.3944911297852474,0.9526493799323562,0.3588729609490855,0.6411270390509145,0.04735062006764374,0.5579399141630901
0.159,2910,"[[845, 1296], [42, 727]]",845,42,1296,42,887,2023,2141,769,1572,1338,0.5402061855670103,0.3946753853339561,0.9526493799323562,0.35936727632229365,0.6406327236777064,0.04735062006764374,0.558124174372523
0.16,2910,"[[845, 1296], [42, 727]]",845,42,1296,42,887,2023,2141,769,1572,1338,0.5402061855670103,0.3946753853339561,0.9526493799323562,0.35936727632229365,0.6406327236777064,0.04735062006764374,0.558124174372523
0.161,2910,"[[845, 1296], [42, 727]]",845,42,1296,42,887,2023,2141,769,1572,1338,0.5402061855670103,0.3946753853339561,0.9526493799323562,0.35936727632229365,0.6406327236777064,0.04735062006764374,0.558124174372523
0.162,2910,"[[845, 1295], [42, 728]]",845,42,1295,42,887,2023,2140,770,1573,1337,0.5405498281786941,0.39485981308411217,0.9526493799323562,0.35986159169550175,0.6401384083044983,0.04735062006764374,0.5583085563263958
0.163,2910,"[[845, 1295], [42, 728]]",845,42,1295,42,887,2023,2140,770,1573,1337,0.5405498281786941,0.39485981308411217,0.9526493799323562,0.35986159169550175,0.6401384083044983,0.04735062006764374,0.5583085563263958
0.164,2910,"[[845, 1293], [42, 730]]",845,42,1293,42,887,2023,2138,772,1575,1335,0.5412371134020618,0.3952291861552853,0.9526493799323562,0.36085022244191794,0.6391497775580821,0.04735062006764374,0.5586776859504132
0.165,2910,"[[845, 1293], [42, 730]]",845,42,1293,42,887,2023,2138,772,1575,1335,0.5412371134020618,0.3952291861552853,0.9526493799323562,0.36085022244191794,0.6391497775580821,0.04735062006764374,0.5586776859504132
0.166,2910,"[[845, 1290], [42, 733]]",845,42,1290,42,887,2023,2135,775,1578,1332,0.5422680412371134,0.3957845433255269,0.9526493799323562,0.36233316856154224,0.6376668314384577,0.04735062006764374,0.5592322964923891
0.167,2910,"[[845, 1290], [42, 733]]",845,42,1290,42,887,2023,2135,775,1578,1332,0.5422680412371134,0.3957845433255269,0.9526493799323562,0.36233316856154224,0.6376668314384577,0.04735062006764374,0.5592322964923891
0.168,2910,"[[845, 1290], [42, 733]]",845,42,1290,42,887,2023,2135,775,1578,1332,0.5422680412371134,0.3957845433255269,0.9526493799323562,0.36233316856154224,0.6376668314384577,0.04735062006764374,0.5592322964923891
0.169,2910,"[[844, 1290], [43, 733]]",844,43,1290,43,887,2023,2134,776,1577,1333,0.5419243986254295,0.39550140581068416,0.95152198421646,0.36233316856154224,0.6376668314384577,0.048478015783540024,0.5587553790135718
0.17,2910,"[[844, 1289], [43, 734]]",844,43,1289,43,887,2023,2133,777,1578,1332,0.5422680412371134,0.3956868260665729,0.95152198421646,0.3628274839347504,0.6371725160652496,0.048478015783540024,0.5589403973509933
0.171,2910,"[[844, 1289], [43, 734]]",844,43,1289,43,887,2023,2133,777,1578,1332,0.5422680412371134,0.3956868260665729,0.95152198421646,0.3628274839347504,0.6371725160652496,0.048478015783540024,0.5589403973509933
0.172,2910,"[[844, 1289], [43, 734]]",844,43,1289,43,887,2023,2133,777,1578,1332,0.5422680412371134,0.3956868260665729,0.95152198421646,0.3628274839347504,0.6371725160652496,0.048478015783540024,0.5589403973509933
0.173,2910,"[[844, 1288], [43, 735]]",844,43,1288,43,887,2023,2132,778,1579,1331,0.5426116838487972,0.39587242026266417,0.95152198421646,0.3633217993079585,0.6366782006920415,0.048478015783540024,0.5591255382577012
0.174,2910,"[[844, 1286], [43, 737]]",844,43,1286,43,887,2023,2130,780,1581,1329,0.5432989690721649,0.39624413145539905,0.95152198421646,0.3643104300543747,0.6356895699456253,0.048478015783540024,0.5594961882664898
0.175,2910,"[[844, 1284], [43, 739]]",844,43,1284,43,887,2023,2128,782,1583,1327,0.5439862542955326,0.3966165413533835,0.95152198421646,0.3652990608007909,0.6347009391992091,0.048478015783540024,0.5598673300165837
0.176,2910,"[[844, 1283], [43, 740]]",844,43,1283,43,887,2023,2127,783,1584,1326,0.5443298969072164,0.39680300893276915,0.95152198421646,0.365793376173999,0.634206623826001,0.048478015783540024,0.5600530856005308
0.177,2910,"[[844, 1283], [43, 740]]",844,43,1283,43,887,2023,2127,783,1584,1326,0.5443298969072164,0.39680300893276915,0.95152198421646,0.365793376173999,0.634206623826001,0.048478015783540024,0.5600530856005308
0.178,2910,"[[844, 1283], [43, 740]]",844,43,1283,43,887,2023,2127,783,1584,1326,0.5443298969072164,0.39680300893276915,0.95152198421646,0.365793376173999,0.634206623826001,0.048478015783540024,0.5600530856005308
0.179,2910,"[[844, 1281], [43, 742]]",844,43,1281,43,887,2023,2125,785,1586,1324,0.5450171821305841,0.3971764705882353,0.95152198421646,0.36678200692041524,0.6332179930795848,0.048478015783540024,0.5604249667994688
0.18,2910,"[[843, 1280], [44, 743]]",843,44,1280,44,887,2023,2123,787,1586,1324,0.5450171821305841,0.3970796043334903,0.9503945885005637,0.36727632229362334,0.6327236777063767,0.0496054114994363,0.5601328903654484
0.181,2910,"[[843, 1279], [44, 744]]",843,44,1279,44,887,2023,2122,788,1587,1323,0.545360824742268,0.39726672950047126,0.9503945885005637,0.36777063766683143,0.6322293623331685,0.0496054114994363,0.5603190428713859
0.182,2910,"[[843, 1279], [44, 744]]",843,44,1279,44,887,2023,2122,788,1587,1323,0.545360824742268,0.39726672950047126,0.9503945885005637,0.36777063766683143,0.6322293623331685,0.0496054114994363,0.5603190428713859
0.183,2910,"[[843, 1279], [44, 744]]",843,44,1279,44,887,2023,2122,788,1587,1323,0.545360824742268,0.39726672950047126,0.9503945885005637,0.36777063766683143,0.6322293623331685,0.0496054114994363,0.5603190428713859
0.184,2910,"[[843, 1278], [44, 745]]",843,44,1278,44,887,2023,2121,789,1588,1322,0.5457044673539518,0.39745403111739747,0.9503945885005637,0.36826495304003953,0.6317350469599604,0.0496054114994363,0.5605053191489362
0.185,2910,"[[843, 1277], [44, 746]]",843,44,1277,44,887,2023,2120,790,1589,1321,0.5460481099656357,0.39764150943396226,0.9503945885005637,0.36875926841324763,0.6312407315867523,0.0496054114994363,0.560691719321583
0.186,2910,"[[843, 1276], [44, 747]]",843,44,1276,44,887,2023,2119,791,1590,1320,0.5463917525773195,0.39782916470033036,0.9503945885005637,0.3692535837864558,0.6307464162135442,0.0496054114994363,0.5608782435129741
0.187,2910,"[[843, 1275], [44, 748]]",843,44,1275,44,887,2023,2118,792,1591,1319,0.5467353951890034,0.3980169971671388,0.9503945885005637,0.3697478991596639,0.6302521008403361,0.0496054114994363,0.5610648918469218
0.188,2910,"[[843, 1275], [44, 748]]",843,44,1275,44,887,2023,2118,792,1591,1319,0.5467353951890034,0.3980169971671388,0.9503945885005637,0.3697478991596639,0.6302521008403361,0.0496054114994363,0.5610648918469218
0.189,2910,"[[843, 1274], [44, 749]]",843,44,1274,44,887,2023,2117,793,1592,1318,0.5470790378006873,0.39820500708549833,0.9503945885005637,0.370242214532872,0.629757785467128,0.0496054114994363,0.5612516644474035
0.19,2910,"[[842, 1274], [45, 749]]",842,45,1274,45,887,2023,2116,794,1591,1319,0.5467353951890034,0.39792060491493386,0.9492671927846674,0.370242214532872,0.629757785467128,0.05073280721533258,0.5607725607725608
0.191,2910,"[[842, 1273], [45, 750]]",842,45,1273,45,887,2023,2115,795,1592,1318,0.5470790378006873,0.3981087470449173,0.9492671927846674,0.3707365299060801,0.6292634700939199,0.05073280721533258,0.5609593604263824
0.192,2910,"[[842, 1273], [45, 750]]",842,45,1273,45,887,2023,2115,795,1592,1318,0.5470790378006873,0.3981087470449173,0.9492671927846674,0.3707365299060801,0.6292634700939199,0.05073280721533258,0.5609593604263824
0.193,2910,"[[842, 1272], [45, 751]]",842,45,1272,45,887,2023,2114,796,1593,1317,0.5474226804123712,0.39829706717123936,0.9492671927846674,0.3712308452792882,0.6287691547207118,0.05073280721533258,0.5611462845718094
0.194,2910,"[[842, 1272], [45, 751]]",842,45,1272,45,887,2023,2114,796,1593,1317,0.5474226804123712,0.39829706717123936,0.9492671927846674,0.3712308452792882,0.6287691547207118,0.05073280721533258,0.5611462845718094
0.195,2910,"[[842, 1272], [45, 751]]",842,45,1272,45,887,2023,2114,796,1593,1317,0.5474226804123712,0.39829706717123936,0.9492671927846674,0.3712308452792882,0.6287691547207118,0.05073280721533258,0.5611462845718094
0.196,2910,"[[842, 1271], [45, 752]]",842,45,1271,45,887,2023,2113,797,1594,1316,0.547766323024055,0.3984855655466162,0.9492671927846674,0.3717251606524963,0.6282748393475037,0.05073280721533258,0.5613333333333334
0.197,2910,"[[841, 1271], [46, 752]]",841,46,1271,46,887,2023,2112,798,1593,1317,0.5474226804123712,0.39820075757575757,0.9481397970687712,0.3717251606524963,0.6282748393475037,0.05186020293122886,0.5608536178726242
0.198,2910,"[[840, 1269], [47, 754]]",840,47,1269,47,887,2023,2109,801,1594,1316,0.547766323024055,0.39829302987197723,0.9470124013528749,0.37271379139891253,0.6272862086010875,0.05298759864712514,0.5607476635514019
0.199,2910,"[[840, 1269], [47, 754]]",840,47,1269,47,887,2023,2109,801,1594,1316,0.547766323024055,0.39829302987197723,0.9470124013528749,0.37271379139891253,0.6272862086010875,0.05298759864712514,0.5607476635514019
0.2,2910,"[[840, 1268], [47, 755]]",840,47,1268,47,887,2023,2108,802,1595,1315,0.5481099656357389,0.3984819734345351,0.9470124013528749,0.37320810677212063,0.6267918932278794,0.05298759864712514,0.5609348914858098
0.201,2910,"[[840, 1267], [47, 756]]",840,47,1267,47,887,2023,2107,803,1596,1314,0.5484536082474227,0.39867109634551495,0.9470124013528749,0.3737024221453287,0.6262975778546713,0.05298759864712514,0.561122244488978
0.202,2910,"[[840, 1267], [47, 756]]",840,47,1267,47,887,2023,2107,803,1596,1314,0.5484536082474227,0.39867109634551495,0.9470124013528749,0.3737024221453287,0.6262975778546713,0.05298759864712514,0.561122244488978
0.203,2910,"[[840, 1266], [47, 757]]",840,47,1266,47,887,2023,2106,804,1597,1313,0.5487972508591066,0.39886039886039887,0.9470124013528749,0.3741967375185368,0.6258032624814631,0.05298759864712514,0.561309722686268
0.204,2910,"[[840, 1266], [47, 757]]",840,47,1266,47,887,2023,2106,804,1597,1313,0.5487972508591066,0.39886039886039887,0.9470124013528749,0.3741967375185368,0.6258032624814631,0.05298759864712514,0.561309722686268
0.205,2910,"[[840, 1264], [47, 759]]",840,47,1264,47,887,2023,2104,806,1599,1311,0.5494845360824743,0.39923954372623577,0.9470124013528749,0.375185368264953,0.6248146317350469,0.05298759864712514,0.5616850551654966
0.206,2910,"[[840, 1264], [47, 759]]",840,47,1264,47,887,2023,2104,806,1599,1311,0.5494845360824743,0.39923954372623577,0.9470124013528749,0.375185368264953,0.6248146317350469,0.05298759864712514,0.5616850551654966
0.207,2910,"[[840, 1264], [47, 759]]",840,47,1264,47,887,2023,2104,806,1599,1311,0.5494845360824743,0.39923954372623577,0.9470124013528749,0.375185368264953,0.6248146317350469,0.05298759864712514,0.5616850551654966
0.208,2910,"[[840, 1263], [47, 760]]",840,47,1263,47,887,2023,2103,807,1600,1310,0.5498281786941581,0.39942938659058486,0.9470124013528749,0.3756796836381611,0.6243203163618388,0.05298759864712514,0.5618729096989966
0.209,2910,"[[840, 1261], [47, 762]]",840,47,1261,47,887,2023,2101,809,1602,1308,0.5505154639175258,0.39980961446930036,0.9470124013528749,0.3766683143845774,0.6233316856154226,0.05298759864712514,0.5622489959839357
0.21,2910,"[[840, 1260], [47, 763]]",840,47,1260,47,887,2023,2100,810,1603,1307,0.5508591065292097,0.4,0.9470124013528749,0.3771626297577855,0.6228373702422145,0.05298759864712514,0.5624372279879478
0.211,2910,"[[840, 1260], [47, 763]]",840,47,1260,47,887,2023,2100,810,1603,1307,0.5508591065292097,0.4,0.9470124013528749,0.3771626297577855,0.6228373702422145,0.05298759864712514,0.5624372279879478
0.212,2910,"[[840, 1260], [47, 763]]",840,47,1260,47,887,2023,2100,810,1603,1307,0.5508591065292097,0.4,0.9470124013528749,0.3771626297577855,0.6228373702422145,0.05298759864712514,0.5624372279879478
0.213,2910,"[[840, 1260], [47, 763]]",840,47,1260,47,887,2023,2100,810,1603,1307,0.5508591065292097,0.4,0.9470124013528749,0.3771626297577855,0.6228373702422145,0.05298759864712514,0.5624372279879478
0.214,2910,"[[840, 1258], [47, 765]]",840,47,1258,47,887,2023,2098,812,1605,1305,0.5515463917525774,0.4003813155386082,0.9470124013528749,0.37815126050420167,0.6218487394957983,0.05298759864712514,0.5628140703517588
0.215,2910,"[[840, 1258], [47, 765]]",840,47,1258,47,887,2023,2098,812,1605,1305,0.5515463917525774,0.4003813155386082,0.9470124013528749,0.37815126050420167,0.6218487394957983,0.05298759864712514,0.5628140703517588
0.216,2910,"[[840, 1257], [47, 766]]",840,47,1257,47,887,2023,2097,813,1606,1304,0.5518900343642612,0.4005722460658083,0.9470124013528749,0.37864557587740977,0.6213544241225902,0.05298759864712514,0.5630026809651475
0.217,2910,"[[840, 1257], [47, 766]]",840,47,1257,47,887,2023,2097,813,1606,1304,0.5518900343642612,0.4005722460658083,0.9470124013528749,0.37864557587740977,0.6213544241225902,0.05298759864712514,0.5630026809651475
0.218,2910,"[[840, 1255], [47, 768]]",840,47,1255,47,887,2023,2095,815,1608,1302,0.5525773195876289,0.4009546539379475,0.9470124013528749,0.379634206623826,0.620365793376174,0.05298759864712514,0.5633802816901409
0.219,2910,"[[840, 1253], [47, 770]]",840,47,1253,47,887,2023,2093,817,1610,1300,0.5532646048109966,0.4013377926421405,0.9470124013528749,0.3806228373702422,0.6193771626297578,0.05298759864712514,0.563758389261745
0.22,2910,"[[840, 1252], [47, 771]]",840,47,1252,47,887,2023,2092,818,1611,1299,0.5536082474226804,0.40152963671128106,0.9470124013528749,0.3811171527434503,0.6188828472565496,0.05298759864712514,0.5639476334340383
0.221,2910,"[[840, 1251], [47, 772]]",840,47,1251,47,887,2023,2091,819,1612,1298,0.5539518900343643,0.4017216642754663,0.9470124013528749,0.3816114681166584,0.6183885318833415,0.05298759864712514,0.5641370047011417
0.222,2910,"[[840, 1250], [47, 773]]",840,47,1250,47,887,2023,2090,820,1613,1297,0.5542955326460481,0.4019138755980861,0.9470124013528749,0.3821057834898665,0.6178942165101334,0.05298759864712514,0.5643265031911321
0.223,2910,"[[838, 1247], [49, 776]]",838,49,1247,49,887,2023,2085,825,1614,1296,0.554639175257732,0.40191846522781777,0.9447576099210823,0.38358872960949086,0.6164112703905091,0.0552423900789177,0.5639300134589502
0.224,2910,"[[838, 1246], [49, 777]]",838,49,1246,49,887,2023,2084,826,1615,1295,0.5549828178694158,0.4021113243761996,0.9447576099210823,0.38408304498269896,0.615916955017301,0.0552423900789177,0.5641198249747559
0.225,2910,"[[837, 1246], [50, 777]]",837,50,1246,50,887,2023,2083,827,1614,1296,0.554639175257732,0.4018242918867019,0.943630214205186,0.38408304498269896,0.615916955017301,0.05636978579481398,0.5636363636363637
0.226,2910,"[[837, 1246], [50, 777]]",837,50,1246,50,887,2023,2083,827,1614,1296,0.554639175257732,0.4018242918867019,0.943630214205186,0.38408304498269896,0.615916955017301,0.05636978579481398,0.5636363636363637
0.227,2910,"[[837, 1246], [50, 777]]",837,50,1246,50,887,2023,2083,827,1614,1296,0.554639175257732,0.4018242918867019,0.943630214205186,0.38408304498269896,0.615916955017301,0.05636978579481398,0.5636363636363637
0.228,2910,"[[837, 1246], [50, 777]]",837,50,1246,50,887,2023,2083,827,1614,1296,0.554639175257732,0.4018242918867019,0.943630214205186,0.38408304498269896,0.615916955017301,0.05636978579481398,0.5636363636363637
0.229,2910,"[[837, 1246], [50, 777]]",837,50,1246,50,887,2023,2083,827,1614,1296,0.554639175257732,0.4018242918867019,0.943630214205186,0.38408304498269896,0.615916955017301,0.05636978579481398,0.5636363636363637
0.23,2910,"[[837, 1246], [50, 777]]",837,50,1246,50,887,2023,2083,827,1614,1296,0.554639175257732,0.4018242918867019,0.943630214205186,0.38408304498269896,0.615916955017301,0.05636978579481398,0.5636363636363637
0.231,2910,"[[837, 1246], [50, 777]]",837,50,1246,50,887,2023,2083,827,1614,1296,0.554639175257732,0.4018242918867019,0.943630214205186,0.38408304498269896,0.615916955017301,0.05636978579481398,0.5636363636363637
0.232,2910,"[[836, 1246], [51, 777]]",836,51,1246,51,887,2023,2082,828,1613,1297,0.5542955326460481,0.4015369836695485,0.9425028184892897,0.38408304498269896,0.615916955017301,0.05749718151071026,0.5631525766251263
0.233,2910,"[[835, 1244], [52, 779]]",835,52,1244,52,887,2023,2079,831,1614,1296,0.554639175257732,0.4016354016354016,0.9413754227733935,0.38507167572911516,0.6149283242708848,0.058624577226606536,0.5630478759271746
0.234,2910,"[[835, 1244], [52, 779]]",835,52,1244,52,887,2023,2079,831,1614,1296,0.554639175257732,0.4016354016354016,0.9413754227733935,0.38507167572911516,0.6149283242708848,0.058624577226606536,0.5630478759271746
0.235,2910,"[[835, 1244], [52, 779]]",835,52,1244,52,887,2023,2079,831,1614,1296,0.554639175257732,0.4016354016354016,0.9413754227733935,0.38507167572911516,0.6149283242708848,0.058624577226606536,0.5630478759271746
0.236,2910,"[[835, 1244], [52, 779]]",835,52,1244,52,887,2023,2079,831,1614,1296,0.554639175257732,0.4016354016354016,0.9413754227733935,0.38507167572911516,0.6149283242708848,0.058624577226606536,0.5630478759271746
0.237,2910,"[[834, 1244], [53, 779]]",834,53,1244,53,887,2023,2078,832,1613,1297,0.5542955326460481,0.4013474494706448,0.9402480270574972,0.38507167572911516,0.6149283242708848,0.05975197294250282,0.5625632377740303
0.238,2910,"[[834, 1244], [53, 779]]",834,53,1244,53,887,2023,2078,832,1613,1297,0.5542955326460481,0.4013474494706448,0.9402480270574972,0.38507167572911516,0.6149283242708848,0.05975197294250282,0.5625632377740303
0.239,2910,"[[833, 1243], [54, 780]]",833,54,1243,54,887,2023,2076,834,1613,1297,0.5542955326460481,0.401252408477842,0.939120631341601,0.38556599110232326,0.6144340088976767,0.060879368658399095,0.5622679716503545
0.24,2910,"[[833, 1242], [54, 781]]",833,54,1242,54,887,2023,2075,835,1614,1296,0.554639175257732,0.4014457831325301,0.939120631341601,0.3860603064755314,0.6139396935244686,0.060879368658399095,0.562457798784605
0.241,2910,"[[833, 1241], [54, 782]]",833,54,1241,54,887,2023,2074,836,1615,1295,0.5549828178694158,0.4016393442622951,0.939120631341601,0.3865546218487395,0.6134453781512605,0.060879368658399095,0.5626477541371158
0.242,2910,"[[833, 1240], [54, 783]]",833,54,1240,54,887,2023,2073,837,1616,1294,0.5553264604810997,0.4018330921369995,0.939120631341601,0.3870489372219476,0.6129510627780524,0.060879368658399095,0.5628378378378378
0.243,2910,"[[833, 1240], [54, 783]]",833,54,1240,54,887,2023,2073,837,1616,1294,0.5553264604810997,0.4018330921369995,0.939120631341601,0.3870489372219476,0.6129510627780524,0.060879368658399095,0.5628378378378378
0.244,2910,"[[833, 1240], [54, 783]]",833,54,1240,54,887,2023,2073,837,1616,1294,0.5553264604810997,0.4018330921369995,0.939120631341601,0.3870489372219476,0.6129510627780524,0.060879368658399095,0.5628378378378378
0.245,2910,"[[833, 1240], [54, 783]]",833,54,1240,54,887,2023,2073,837,1616,1294,0.5553264604810997,0.4018330921369995,0.939120631341601,0.3870489372219476,0.6129510627780524,0.060879368658399095,0.5628378378378378
0.246,2910,"[[833, 1240], [54, 783]]",833,54,1240,54,887,2023,2073,837,1616,1294,0.5553264604810997,0.4018330921369995,0.939120631341601,0.3870489372219476,0.6129510627780524,0.060879368658399095,0.5628378378378378
0.247,2910,"[[833, 1240], [54, 783]]",833,54,1240,54,887,2023,2073,837,1616,1294,0.5553264604810997,0.4018330921369995,0.939120631341601,0.3870489372219476,0.6129510627780524,0.060879368658399095,0.5628378378378378
0.248,2910,"[[833, 1239], [54, 784]]",833,54,1239,54,887,2023,2072,838,1617,1293,0.5556701030927835,0.40202702702702703,0.939120631341601,0.3875432525951557,0.6124567474048442,0.060879368658399095,0.5630280500168976
0.249,2910,"[[833, 1238], [54, 785]]",833,54,1238,54,887,2023,2071,839,1618,1292,0.5560137457044674,0.40222114920328345,0.939120631341601,0.3880375679683638,0.6119624320316361,0.060879368658399095,0.5632183908045978
0.25,2910,"[[833, 1237], [54, 786]]",833,54,1237,54,887,2023,2070,840,1619,1291,0.5563573883161512,0.40241545893719805,0.939120631341601,0.3885318833415719,0.611468116658428,0.060879368658399095,0.563408860331417
0.251,2910,"[[833, 1236], [54, 787]]",833,54,1236,54,887,2023,2069,841,1620,1290,0.5567010309278351,0.402609956500725,0.939120631341601,0.38902619871478,0.6109738012852199,0.060879368658399095,0.5635994587280109
0.252,2910,"[[833, 1235], [54, 788]]",833,54,1235,54,887,2023,2068,842,1621,1289,0.5570446735395189,0.4028046421663443,0.939120631341601,0.38952051408798816,0.6104794859120118,0.060879368658399095,0.5637901861252116
0.253,2910,"[[833, 1234], [54, 789]]",833,54,1234,54,887,2023,2067,843,1622,1288,0.5573883161512028,0.40299951620706337,0.939120631341601,0.39001482946119626,0.6099851705388037,0.060879368658399095,0.5639810426540284
0.254,2910,"[[833, 1234], [54, 789]]",833,54,1234,54,887,2023,2067,843,1622,1288,0.5573883161512028,0.40299951620706337,0.939120631341601,0.39001482946119626,0.6099851705388037,0.060879368658399095,0.5639810426540284
0.255,2910,"[[833, 1234], [54, 789]]",833,54,1234,54,887,2023,2067,843,1622,1288,0.5573883161512028,0.40299951620706337,0.939120631341601,0.39001482946119626,0.6099851705388037,0.060879368658399095,0.5639810426540284
0.256,2910,"[[833, 1233], [54, 790]]",833,54,1233,54,887,2023,2066,844,1623,1287,0.5577319587628866,0.4031945788964182,0.939120631341601,0.39050914483440435,0.6094908551655956,0.060879368658399095,0.5641720284456485
0.257,2910,"[[833, 1233], [54, 790]]",833,54,1233,54,887,2023,2066,844,1623,1287,0.5577319587628866,0.4031945788964182,0.939120631341601,0.39050914483440435,0.6094908551655956,0.060879368658399095,0.5641720284456485
0.258,2910,"[[833, 1231], [54, 792]]",833,54,1231,54,887,2023,2064,846,1625,1285,0.5584192439862543,0.40358527131782945,0.939120631341601,0.39149777558082055,0.6085022244191794,0.060879368658399095,0.5645543883429346
0.259,2910,"[[832, 1229], [55, 794]]",832,55,1229,55,887,2023,2061,849,1626,1284,0.5587628865979382,0.4036875303250849,0.9379932356257046,0.3924864063272368,0.6075135936727633,0.06200676437429538,0.5644504748982361
0.26,2910,"[[831, 1228], [56, 795]]",831,56,1228,56,887,2023,2059,851,1626,1284,0.5587628865979382,0.4035939776590578,0.9368658399098083,0.3929807217004449,0.6070192782995552,0.06313416009019165,0.5641547861507129
0.261,2910,"[[831, 1228], [56, 795]]",831,56,1228,56,887,2023,2059,851,1626,1284,0.5587628865979382,0.4035939776590578,0.9368658399098083,0.3929807217004449,0.6070192782995552,0.06313416009019165,0.5641547861507129
0.262,2910,"[[831, 1228], [56, 795]]",831,56,1228,56,887,2023,2059,851,1626,1284,0.5587628865979382,0.4035939776590578,0.9368658399098083,0.3929807217004449,0.6070192782995552,0.06313416009019165,0.5641547861507129
0.263,2910,"[[831, 1228], [56, 795]]",831,56,1228,56,887,2023,2059,851,1626,1284,0.5587628865979382,0.4035939776590578,0.9368658399098083,0.3929807217004449,0.6070192782995552,0.06313416009019165,0.5641547861507129
0.264,2910,"[[831, 1228], [56, 795]]",831,56,1228,56,887,2023,2059,851,1626,1284,0.5587628865979382,0.4035939776590578,0.9368658399098083,0.3929807217004449,0.6070192782995552,0.06313416009019165,0.5641547861507129
0.265,2910,"[[831, 1228], [56, 795]]",831,56,1228,56,887,2023,2059,851,1626,1284,0.5587628865979382,0.4035939776590578,0.9368658399098083,0.3929807217004449,0.6070192782995552,0.06313416009019165,0.5641547861507129
0.266,2910,"[[831, 1227], [56, 796]]",831,56,1227,56,887,2023,2058,852,1627,1283,0.559106529209622,0.4037900874635568,0.9368658399098083,0.393475037073653,0.606524962926347,0.06313416009019165,0.564346349745331
0.267,2910,"[[831, 1227], [56, 796]]",831,56,1227,56,887,2023,2058,852,1627,1283,0.559106529209622,0.4037900874635568,0.9368658399098083,0.393475037073653,0.606524962926347,0.06313416009019165,0.564346349745331
0.268,2910,"[[830, 1227], [57, 796]]",830,57,1227,57,887,2023,2057,853,1626,1284,0.5587628865979382,0.4035002430724356,0.9357384441939121,0.393475037073653,0.606524962926347,0.06426155580608793,0.5638586956521738
0.269,2910,"[[829, 1225], [58, 798]]",829,58,1225,58,887,2023,2054,856,1627,1283,0.559106529209622,0.4036027263875365,0.9346110484780158,0.3944636678200692,0.6055363321799307,0.06538895152198422,0.5637538252295139
0.27,2910,"[[829, 1225], [58, 798]]",829,58,1225,58,887,2023,2054,856,1627,1283,0.559106529209622,0.4036027263875365,0.9346110484780158,0.3944636678200692,0.6055363321799307,0.06538895152198422,0.5637538252295139
0.271,2910,"[[829, 1224], [58, 799]]",829,58,1224,58,887,2023,2053,857,1628,1282,0.5594501718213059,0.40379931807111547,0.9346110484780158,0.3949579831932773,0.6050420168067226,0.06538895152198422,0.5639455782312925
0.272,2910,"[[829, 1224], [58, 799]]",829,58,1224,58,887,2023,2053,857,1628,1282,0.5594501718213059,0.40379931807111547,0.9346110484780158,0.3949579831932773,0.6050420168067226,0.06538895152198422,0.5639455782312925
0.273,2910,"[[829, 1224], [58, 799]]",829,58,1224,58,887,2023,2053,857,1628,1282,0.5594501718213059,0.40379931807111547,0.9346110484780158,0.3949579831932773,0.6050420168067226,0.06538895152198422,0.5639455782312925
0.274,2910,"[[829, 1223], [58, 800]]",829,58,1223,58,887,2023,2052,858,1629,1281,0.5597938144329897,0.4039961013645224,0.9346110484780158,0.3954522985664854,0.6045477014335146,0.06538895152198422,0.564137461721674
0.275,2910,"[[829, 1223], [58, 800]]",829,58,1223,58,887,2023,2052,858,1629,1281,0.5597938144329897,0.4039961013645224,0.9346110484780158,0.3954522985664854,0.6045477014335146,0.06538895152198422,0.564137461721674
0.276,2910,"[[829, 1223], [58, 800]]",829,58,1223,58,887,2023,2052,858,1629,1281,0.5597938144329897,0.4039961013645224,0.9346110484780158,0.3954522985664854,0.6045477014335146,0.06538895152198422,0.564137461721674
0.277,2910,"[[829, 1222], [58, 801]]",829,58,1222,58,887,2023,2051,859,1630,1280,0.5601374570446735,0.40419307654802533,0.9346110484780158,0.39594661393969355,0.6040533860603065,0.06538895152198422,0.5643294758339006
0.278,2910,"[[829, 1222], [58, 801]]",829,58,1222,58,887,2023,2051,859,1630,1280,0.5601374570446735,0.40419307654802533,0.9346110484780158,0.39594661393969355,0.6040533860603065,0.06538895152198422,0.5643294758339006
0.279,2910,"[[829, 1222], [58, 801]]",829,58,1222,58,887,2023,2051,859,1630,1280,0.5601374570446735,0.40419307654802533,0.9346110484780158,0.39594661393969355,0.6040533860603065,0.06538895152198422,0.5643294758339006
0.28,2910,"[[829, 1221], [58, 802]]",829,58,1221,58,887,2023,2050,860,1631,1279,0.5604810996563574,0.40439024390243905,0.9346110484780158,0.39644092931290165,0.6035590706870984,0.06538895152198422,0.564521620701396
0.281,2910,"[[829, 1220], [58, 803]]",829,58,1220,58,887,2023,2049,861,1632,1278,0.5608247422680412,0.4045876037091264,0.9346110484780158,0.39693524468610974,0.6030647553138903,0.06538895152198422,0.5647138964577656
0.282,2910,"[[829, 1219], [58, 804]]",829,58,1219,58,887,2023,2048,862,1633,1277,0.5611683848797251,0.40478515625,0.9346110484780158,0.39742956005931784,0.6025704399406822,0.06538895152198422,0.5649063032367972
0.283,2910,"[[829, 1219], [58, 804]]",829,58,1219,58,887,2023,2048,862,1633,1277,0.5611683848797251,0.40478515625,0.9346110484780158,0.39742956005931784,0.6025704399406822,0.06538895152198422,0.5649063032367972
0.284,2910,"[[829, 1219], [58, 804]]",829,58,1219,58,887,2023,2048,862,1633,1277,0.5611683848797251,0.40478515625,0.9346110484780158,0.39742956005931784,0.6025704399406822,0.06538895152198422,0.5649063032367972
0.285,2910,"[[828, 1218], [59, 805]]",828,59,1218,59,887,2023,2046,864,1633,1277,0.5611683848797251,0.4046920821114369,0.9334836527621195,0.39792387543252594,0.6020761245674741,0.0665163472378805,0.5646096147289464
0.286,2910,"[[828, 1218], [59, 805]]",828,59,1218,59,887,2023,2046,864,1633,1277,0.5611683848797251,0.4046920821114369,0.9334836527621195,0.39792387543252594,0.6020761245674741,0.0665163472378805,0.5646096147289464
0.287,2910,"[[828, 1216], [59, 807]]",828,59,1216,59,887,2023,2044,866,1635,1275,0.5618556701030928,0.4050880626223092,0.9334836527621195,0.39891250617894214,0.6010874938210579,0.0665163472378805,0.5649948822927329
0.288,2910,"[[828, 1215], [59, 808]]",828,59,1215,59,887,2023,2043,867,1636,1274,0.5621993127147766,0.4052863436123348,0.9334836527621195,0.3994068215521503,0.6005931784478498,0.0665163472378805,0.5651877133105802
0.289,2910,"[[828, 1215], [59, 808]]",828,59,1215,59,887,2023,2043,867,1636,1274,0.5621993127147766,0.4052863436123348,0.9334836527621195,0.3994068215521503,0.6005931784478498,0.0665163472378805,0.5651877133105802
0.29,2910,"[[828, 1212], [59, 811]]",828,59,1212,59,887,2023,2040,870,1639,1271,0.5632302405498282,0.40588235294117647,0.9334836527621195,0.4008897676717746,0.5991102323282254,0.0665163472378805,0.5657669969251793
0.291,2910,"[[828, 1212], [59, 811]]",828,59,1212,59,887,2023,2040,870,1639,1271,0.5632302405498282,0.40588235294117647,0.9334836527621195,0.4008897676717746,0.5991102323282254,0.0665163472378805,0.5657669969251793
0.292,2910,"[[828, 1212], [59, 811]]",828,59,1212,59,887,2023,2040,870,1639,1271,0.5632302405498282,0.40588235294117647,0.9334836527621195,0.4008897676717746,0.5991102323282254,0.0665163472378805,0.5657669969251793
0.293,2910,"[[828, 1212], [59, 811]]",828,59,1212,59,887,2023,2040,870,1639,1271,0.5632302405498282,0.40588235294117647,0.9334836527621195,0.4008897676717746,0.5991102323282254,0.0665163472378805,0.5657669969251793
0.294,2910,"[[828, 1212], [59, 811]]",828,59,1212,59,887,2023,2040,870,1639,1271,0.5632302405498282,0.40588235294117647,0.9334836527621195,0.4008897676717746,0.5991102323282254,0.0665163472378805,0.5657669969251793
0.295,2910,"[[828, 1212], [59, 811]]",828,59,1212,59,887,2023,2040,870,1639,1271,0.5632302405498282,0.40588235294117647,0.9334836527621195,0.4008897676717746,0.5991102323282254,0.0665163472378805,0.5657669969251793
0.296,2910,"[[828, 1212], [59, 811]]",828,59,1212,59,887,2023,2040,870,1639,1271,0.5632302405498282,0.40588235294117647,0.9334836527621195,0.4008897676717746,0.5991102323282254,0.0665163472378805,0.5657669969251793
0.297,2910,"[[828, 1212], [59, 811]]",828,59,1212,59,887,2023,2040,870,1639,1271,0.5632302405498282,0.40588235294117647,0.9334836527621195,0.4008897676717746,0.5991102323282254,0.0665163472378805,0.5657669969251793
0.298,2910,"[[828, 1212], [59, 811]]",828,59,1212,59,887,2023,2040,870,1639,1271,0.5632302405498282,0.40588235294117647,0.9334836527621195,0.4008897676717746,0.5991102323282254,0.0665163472378805,0.5657669969251793
0.299,2910,"[[828, 1212], [59, 811]]",828,59,1212,59,887,2023,2040,870,1639,1271,0.5632302405498282,0.40588235294117647,0.9334836527621195,0.4008897676717746,0.5991102323282254,0.0665163472378805,0.5657669969251793
0.3,2910,"[[828, 1211], [59, 812]]",828,59,1211,59,887,2023,2039,871,1640,1270,0.563573883161512,0.4060814124570868,0.9334836527621195,0.4013840830449827,0.5986159169550173,0.0665163472378805,0.5659603554340396
0.301,2910,"[[828, 1211], [59, 812]]",828,59,1211,59,887,2023,2039,871,1640,1270,0.563573883161512,0.4060814124570868,0.9334836527621195,0.4013840830449827,0.5986159169550173,0.0665163472378805,0.5659603554340396
0.302,2910,"[[828, 1210], [59, 813]]",828,59,1210,59,887,2023,2038,872,1641,1269,0.5639175257731959,0.40628066732090284,0.9334836527621195,0.4018783984181908,0.5981216015818092,0.0665163472378805,0.5661538461538461
0.303,2910,"[[828, 1209], [59, 814]]",828,59,1209,59,887,2023,2037,873,1642,1268,0.5642611683848797,0.406480117820324,0.9334836527621195,0.40237271379139894,0.5976272862086011,0.0665163472378805,0.5663474692202463
0.304,2910,"[[828, 1209], [59, 814]]",828,59,1209,59,887,2023,2037,873,1642,1268,0.5642611683848797,0.406480117820324,0.9334836527621195,0.40237271379139894,0.5976272862086011,0.0665163472378805,0.5663474692202463
0.305,2910,"[[828, 1209], [59, 814]]",828,59,1209,59,887,2023,2037,873,1642,1268,0.5642611683848797,0.406480117820324,0.9334836527621195,0.40237271379139894,0.5976272862086011,0.0665163472378805,0.5663474692202463
0.306,2910,"[[827, 1208], [60, 815]]",827,60,1208,60,887,2023,2035,875,1642,1268,0.5642611683848797,0.4063882063882064,0.9323562570462233,0.40286702916460704,0.597132970835393,0.06764374295377677,0.5660506502395619
0.307,2910,"[[827, 1208], [60, 815]]",827,60,1208,60,887,2023,2035,875,1642,1268,0.5642611683848797,0.4063882063882064,0.9323562570462233,0.40286702916460704,0.597132970835393,0.06764374295377677,0.5660506502395619
0.308,2910,"[[827, 1207], [60, 816]]",827,60,1207,60,887,2023,2034,876,1643,1267,0.5646048109965636,0.40658800393313665,0.9323562570462233,0.40336134453781514,0.5966386554621849,0.06764374295377677,0.5662444368366997
0.309,2910,"[[827, 1207], [60, 816]]",827,60,1207,60,887,2023,2034,876,1643,1267,0.5646048109965636,0.40658800393313665,0.9323562570462233,0.40336134453781514,0.5966386554621849,0.06764374295377677,0.5662444368366997
0.31,2910,"[[827, 1207], [60, 816]]",827,60,1207,60,887,2023,2034,876,1643,1267,0.5646048109965636,0.40658800393313665,0.9323562570462233,0.40336134453781514,0.5966386554621849,0.06764374295377677,0.5662444368366997
0.311,2910,"[[827, 1207], [60, 816]]",827,60,1207,60,887,2023,2034,876,1643,1267,0.5646048109965636,0.40658800393313665,0.9323562570462233,0.40336134453781514,0.5966386554621849,0.06764374295377677,0.5662444368366997
0.312,2910,"[[827, 1206], [60, 817]]",827,60,1206,60,887,2023,2033,877,1644,1266,0.5649484536082474,0.40678799803246435,0.9323562570462233,0.40385565991102323,0.5961443400889768,0.06764374295377677,0.5664383561643835
0.313,2910,"[[827, 1206], [60, 817]]",827,60,1206,60,887,2023,2033,877,1644,1266,0.5649484536082474,0.40678799803246435,0.9323562570462233,0.40385565991102323,0.5961443400889768,0.06764374295377677,0.5664383561643835
0.314,2910,"[[827, 1205], [60, 818]]",827,60,1205,60,887,2023,2032,878,1645,1265,0.5652920962199313,0.40698818897637795,0.9323562570462233,0.40434997528423133,0.5956500247157687,0.06764374295377677,0.5666324083590271
0.315,2910,"[[826, 1204], [61, 819]]",826,61,1204,61,887,2023,2030,880,1645,1265,0.5652920962199313,0.4068965517241379,0.9312288613303269,0.40484429065743943,0.5951557093425606,0.06877113866967305,0.5663352759684607
0.316,2910,"[[826, 1203], [61, 820]]",826,61,1203,61,887,2023,2029,881,1646,1264,0.5656357388316151,0.4070970921636274,0.9312288613303269,0.40533860603064753,0.5946613939693525,0.06877113866967305,0.5665294924554184
0.317,2910,"[[826, 1202], [61, 821]]",826,61,1202,61,887,2023,2028,882,1647,1263,0.565979381443299,0.4072978303747535,0.9312288613303269,0.4058329214038557,0.5941670785961444,0.06877113866967305,0.5667238421955403
0.318,2910,"[[826, 1202], [61, 821]]",826,61,1202,61,887,2023,2028,882,1647,1263,0.565979381443299,0.4072978303747535,0.9312288613303269,0.4058329214038557,0.5941670785961444,0.06877113866967305,0.5667238421955403
0.319,2910,"[[826, 1200], [61, 823]]",826,61,1200,61,887,2023,2026,884,1649,1261,0.5666666666666667,0.4076999012833169,0.9312288613303269,0.4068215521502719,0.5931784478497282,0.06877113866967305,0.5671129419842087
0.32,2910,"[[826, 1200], [61, 823]]",826,61,1200,61,887,2023,2026,884,1649,1261,0.5666666666666667,0.4076999012833169,0.9312288613303269,0.4068215521502719,0.5931784478497282,0.06877113866967305,0.5671129419842087
0.321,2910,"[[826, 1200], [61, 823]]",826,61,1200,61,887,2023,2026,884,1649,1261,0.5666666666666667,0.4076999012833169,0.9312288613303269,0.4068215521502719,0.5931784478497282,0.06877113866967305,0.5671129419842087
0.322,2910,"[[826, 1200], [61, 823]]",826,61,1200,61,887,2023,2026,884,1649,1261,0.5666666666666667,0.4076999012833169,0.9312288613303269,0.4068215521502719,0.5931784478497282,0.06877113866967305,0.5671129419842087
0.323,2910,"[[826, 1200], [61, 823]]",826,61,1200,61,887,2023,2026,884,1649,1261,0.5666666666666667,0.4076999012833169,0.9312288613303269,0.4068215521502719,0.5931784478497282,0.06877113866967305,0.5671129419842087
0.324,2910,"[[826, 1200], [61, 823]]",826,61,1200,61,887,2023,2026,884,1649,1261,0.5666666666666667,0.4076999012833169,0.9312288613303269,0.4068215521502719,0.5931784478497282,0.06877113866967305,0.5671129419842087
0.325,2910,"[[826, 1199], [61, 824]]",826,61,1199,61,887,2023,2025,885,1650,1260,0.5670103092783505,0.4079012345679012,0.9312288613303269,0.40731586752348,0.59268413247652,0.06877113866967305,0.5673076923076923
0.326,2910,"[[826, 1199], [61, 824]]",826,61,1199,61,887,2023,2025,885,1650,1260,0.5670103092783505,0.4079012345679012,0.9312288613303269,0.40731586752348,0.59268413247652,0.06877113866967305,0.5673076923076923
0.327,2910,"[[826, 1199], [61, 824]]",826,61,1199,61,887,2023,2025,885,1650,1260,0.5670103092783505,0.4079012345679012,0.9312288613303269,0.40731586752348,0.59268413247652,0.06877113866967305,0.5673076923076923
0.328,2910,"[[826, 1199], [61, 824]]",826,61,1199,61,887,2023,2025,885,1650,1260,0.5670103092783505,0.4079012345679012,0.9312288613303269,0.40731586752348,0.59268413247652,0.06877113866967305,0.5673076923076923
0.329,2910,"[[826, 1199], [61, 824]]",826,61,1199,61,887,2023,2025,885,1650,1260,0.5670103092783505,0.4079012345679012,0.9312288613303269,0.40731586752348,0.59268413247652,0.06877113866967305,0.5673076923076923
0.33,2910,"[[825, 1199], [62, 824]]",825,62,1199,62,887,2023,2024,886,1649,1261,0.5666666666666667,0.4076086956521739,0.9301014656144306,0.40731586752348,0.59268413247652,0.06989853438556934,0.5668155273102027
0.331,2910,"[[825, 1199], [62, 824]]",825,62,1199,62,887,2023,2024,886,1649,1261,0.5666666666666667,0.4076086956521739,0.9301014656144306,0.40731586752348,0.59268413247652,0.06989853438556934,0.5668155273102027
0.332,2910,"[[824, 1199], [63, 824]]",824,63,1199,63,887,2023,2023,887,1648,1262,0.5663230240549828,0.40731586752348,0.9289740698985344,0.40731586752348,0.59268413247652,0.07102593010146561,0.5663230240549828
0.333,2910,"[[823, 1198], [64, 825]]",823,64,1198,64,887,2023,2021,889,1648,1262,0.5663230240549828,0.40722414646214744,0.9278466741826381,0.4078101828966881,0.5921898171033119,0.07215332581736189,0.5660247592847318
0.334,2910,"[[823, 1197], [64, 826]]",823,64,1197,64,887,2023,2020,890,1649,1261,0.5666666666666667,0.4074257425742574,0.9278466741826381,0.4083044982698962,0.5916955017301038,0.07215332581736189,0.566219470244238
0.335,2910,"[[823, 1196], [64, 827]]",823,64,1196,64,887,2023,2019,891,1650,1260,0.5670103092783505,0.40762753838533927,0.9278466741826381,0.4087988136431043,0.5912011863568957,0.07215332581736189,0.5664143152099105
0.336,2910,"[[823, 1196], [64, 827]]",823,64,1196,64,887,2023,2019,891,1650,1260,0.5670103092783505,0.40762753838533927,0.9278466741826381,0.4087988136431043,0.5912011863568957,0.07215332581736189,0.5664143152099105
0.337,2910,"[[823, 1195], [64, 828]]",823,64,1195,64,887,2023,2018,892,1651,1259,0.5673539518900343,0.4078295341922696,0.9278466741826381,0.40929312901631243,0.5907068709836876,0.07215332581736189,0.5666092943201377
0.338,2910,"[[823, 1195], [64, 828]]",823,64,1195,64,887,2023,2018,892,1651,1259,0.5673539518900343,0.4078295341922696,0.9278466741826381,0.40929312901631243,0.5907068709836876,0.07215332581736189,0.5666092943201377
0.339,2910,"[[823, 1195], [64, 828]]",823,64,1195,64,887,2023,2018,892,1651,1259,0.5673539518900343,0.4078295341922696,0.9278466741826381,0.40929312901631243,0.5907068709836876,0.07215332581736189,0.5666092943201377
0.34,2910,"[[823, 1194], [64, 829]]",823,64,1194,64,887,2023,2017,893,1652,1258,0.5676975945017182,0.40803173029251366,0.9278466741826381,0.4097874443895205,0.5902125556104795,0.07215332581736189,0.5668044077134986
0.341,2910,"[[823, 1193], [64, 830]]",823,64,1193,64,887,2023,2016,894,1653,1257,0.568041237113402,0.408234126984127,0.9278466741826381,0.4102817597627286,0.5897182402372714,0.07215332581736189,0.5669996555287633
0.342,2910,"[[823, 1192], [64, 831]]",823,64,1192,64,887,2023,2015,895,1654,1256,0.5683848797250859,0.4084367245657568,0.9278466741826381,0.4107760751359367,0.5892239248640633,0.07215332581736189,0.5671950379048931
0.343,2910,"[[823, 1190], [64, 833]]",823,64,1190,64,887,2023,2013,897,1656,1254,0.5690721649484536,0.40884252359662193,0.9278466741826381,0.4117647058823529,0.5882352941176471,0.07215332581736189,0.5675862068965517
0.344,2910,"[[823, 1188], [64, 835]]",823,64,1188,64,887,2023,2011,899,1658,1252,0.5697594501718213,0.40924912978617606,0.9278466741826381,0.4127533366287692,0.5872466633712309,0.07215332581736189,0.5679779158040028
0.345,2910,"[[823, 1187], [64, 836]]",823,64,1187,64,887,2023,2010,900,1659,1251,0.5701030927835051,0.40945273631840795,0.9278466741826381,0.4132476520019773,0.5867523479980228,0.07215332581736189,0.5681739730755954
0.346,2910,"[[823, 1186], [64, 837]]",823,64,1186,64,887,2023,2009,901,1660,1250,0.570446735395189,0.40965654554504727,0.9278466741826381,0.41374196737518537,0.5862580326248147,0.07215332581736189,0.5683701657458564
0.347,2910,"[[823, 1185], [64, 838]]",823,64,1185,64,887,2023,2008,902,1661,1249,0.5707903780068728,0.4098605577689243,0.9278466741826381,0.41423628274839347,0.5857637172516065,0.07215332581736189,0.5685664939550951
0.348,2910,"[[823, 1185], [64, 838]]",823,64,1185,64,887,2023,2008,902,1661,1249,0.5707903780068728,0.4098605577689243,0.9278466741826381,0.41423628274839347,0.5857637172516065,0.07215332581736189,0.5685664939550951
0.349,2910,"[[823, 1184], [64, 839]]",823,64,1184,64,887,2023,2007,903,1662,1248,0.5711340206185567,0.41006477329347285,0.9278466741826381,0.41473059812160157,0.5852694018783984,0.07215332581736189,0.5687629578438148
0.35,2910,"[[823, 1184], [64, 839]]",823,64,1184,64,887,2023,2007,903,1662,1248,0.5711340206185567,0.41006477329347285,0.9278466741826381,0.41473059812160157,0.5852694018783984,0.07215332581736189,0.5687629578438148
0.351,2910,"[[823, 1184], [64, 839]]",823,64,1184,64,887,2023,2007,903,1662,1248,0.5711340206185567,0.41006477329347285,0.9278466741826381,0.41473059812160157,0.5852694018783984,0.07215332581736189,0.5687629578438148
0.352,2910,"[[823, 1184], [64, 839]]",823,64,1184,64,887,2023,2007,903,1662,1248,0.5711340206185567,0.41006477329347285,0.9278466741826381,0.41473059812160157,0.5852694018783984,0.07215332581736189,0.5687629578438148
0.353,2910,"[[823, 1182], [64, 841]]",823,64,1182,64,887,2023,2005,905,1664,1246,0.5718213058419244,0.41047381546134665,0.9278466741826381,0.4157192288680178,0.5842807711319822,0.07215332581736189,0.5691562932226832
0.354,2910,"[[823, 1180], [64, 843]]",823,64,1180,64,887,2023,2003,907,1666,1244,0.5725085910652921,0.4108836744882676,0.9278466741826381,0.416707859614434,0.583292140385566,0.07215332581736189,0.5695501730103807
0.355,2910,"[[823, 1178], [64, 845]]",823,64,1178,64,887,2023,2001,909,1668,1242,0.5731958762886598,0.4112943528235882,0.9278466741826381,0.4176964903608502,0.5823035096391498,0.07215332581736189,0.5699445983379502
0.356,2910,"[[823, 1178], [64, 845]]",823,64,1178,64,887,2023,2001,909,1668,1242,0.5731958762886598,0.4112943528235882,0.9278466741826381,0.4176964903608502,0.5823035096391498,0.07215332581736189,0.5699445983379502
0.357,2910,"[[823, 1178], [64, 845]]",823,64,1178,64,887,2023,2001,909,1668,1242,0.5731958762886598,0.4112943528235882,0.9278466741826381,0.4176964903608502,0.5823035096391498,0.07215332581736189,0.5699445983379502
0.358,2910,"[[823, 1178], [64, 845]]",823,64,1178,64,887,2023,2001,909,1668,1242,0.5731958762886598,0.4112943528235882,0.9278466741826381,0.4176964903608502,0.5823035096391498,0.07215332581736189,0.5699445983379502
0.359,2910,"[[823, 1177], [64, 846]]",823,64,1177,64,887,2023,2000,910,1669,1241,0.5735395189003436,0.4115,0.9278466741826381,0.4181908057340583,0.5818091942659417,0.07215332581736189,0.570142015933495
0.36,2910,"[[823, 1177], [64, 846]]",823,64,1177,64,887,2023,2000,910,1669,1241,0.5735395189003436,0.4115,0.9278466741826381,0.4181908057340583,0.5818091942659417,0.07215332581736189,0.570142015933495
0.361,2910,"[[823, 1177], [64, 846]]",823,64,1177,64,887,2023,2000,910,1669,1241,0.5735395189003436,0.4115,0.9278466741826381,0.4181908057340583,0.5818091942659417,0.07215332581736189,0.570142015933495
0.362,2910,"[[823, 1177], [64, 846]]",823,64,1177,64,887,2023,2000,910,1669,1241,0.5735395189003436,0.4115,0.9278466741826381,0.4181908057340583,0.5818091942659417,0.07215332581736189,0.570142015933495
0.363,2910,"[[823, 1177], [64, 846]]",823,64,1177,64,887,2023,2000,910,1669,1241,0.5735395189003436,0.4115,0.9278466741826381,0.4181908057340583,0.5818091942659417,0.07215332581736189,0.570142015933495
0.364,2910,"[[823, 1177], [64, 846]]",823,64,1177,64,887,2023,2000,910,1669,1241,0.5735395189003436,0.4115,0.9278466741826381,0.4181908057340583,0.5818091942659417,0.07215332581736189,0.570142015933495
0.365,2910,"[[823, 1177], [64, 846]]",823,64,1177,64,887,2023,2000,910,1669,1241,0.5735395189003436,0.4115,0.9278466741826381,0.4181908057340583,0.5818091942659417,0.07215332581736189,0.570142015933495
0.366,2910,"[[823, 1177], [64, 846]]",823,64,1177,64,887,2023,2000,910,1669,1241,0.5735395189003436,0.4115,0.9278466741826381,0.4181908057340583,0.5818091942659417,0.07215332581736189,0.570142015933495
0.367,2910,"[[823, 1177], [64, 846]]",823,64,1177,64,887,2023,2000,910,1669,1241,0.5735395189003436,0.4115,0.9278466741826381,0.4181908057340583,0.5818091942659417,0.07215332581736189,0.570142015933495
0.368,2910,"[[823, 1175], [64, 848]]",823,64,1175,64,887,2023,1998,912,1671,1239,0.5742268041237113,0.4119119119119119,0.9278466741826381,0.41917943648047457,0.5808205635195255,0.07215332581736189,0.5705372616984402
0.369,2910,"[[823, 1174], [64, 849]]",823,64,1174,64,887,2023,1997,913,1672,1238,0.5745704467353951,0.41211817726589883,0.9278466741826381,0.41967375185368266,0.5803262481463174,0.07215332581736189,0.5707350901525658
0.37,2910,"[[822, 1174], [65, 849]]",822,65,1174,65,887,2023,1996,914,1671,1239,0.5742268041237113,0.4118236472945892,0.9267192784667418,0.41967375185368266,0.5803262481463174,0.07328072153325817,0.5702393340270552
0.371,2910,"[[821, 1174], [66, 849]]",821,66,1174,66,887,2023,1995,915,1670,1240,0.5738831615120275,0.41152882205513786,0.9255918827508456,0.41967375185368266,0.5803262481463174,0.07440811724915446,0.5697432338653713
0.372,2910,"[[821, 1174], [66, 849]]",821,66,1174,66,887,2023,1995,915,1670,1240,0.5738831615120275,0.41152882205513786,0.9255918827508456,0.41967375185368266,0.5803262481463174,0.07440811724915446,0.5697432338653713
0.373,2910,"[[821, 1174], [66, 849]]",821,66,1174,66,887,2023,1995,915,1670,1240,0.5738831615120275,0.41152882205513786,0.9255918827508456,0.41967375185368266,0.5803262481463174,0.07440811724915446,0.5697432338653713
0.374,2910,"[[821, 1174], [66, 849]]",821,66,1174,66,887,2023,1995,915,1670,1240,0.5738831615120275,0.41152882205513786,0.9255918827508456,0.41967375185368266,0.5803262481463174,0.07440811724915446,0.5697432338653713
0.375,2910,"[[821, 1173], [66, 850]]",821,66,1173,66,887,2023,1994,916,1671,1239,0.5742268041237113,0.41173520561685056,0.9255918827508456,0.42016806722689076,0.5798319327731093,0.07440811724915446,0.5699409927108643
0.376,2910,"[[821, 1172], [66, 851]]",821,66,1172,66,887,2023,1993,917,1672,1238,0.5745704467353951,0.4119417962870045,0.9255918827508456,0.42066238260009886,0.5793376173999011,0.07440811724915446,0.570138888888889
0.377,2910,"[[821, 1171], [66, 852]]",821,66,1171,66,887,2023,1992,918,1673,1237,0.574914089347079,0.41214859437751006,0.9255918827508456,0.42115669797330696,0.578843302026693,0.07440811724915446,0.5703369225425495
0.378,2910,"[[821, 1169], [66, 854]]",821,66,1169,66,887,2023,1990,920,1675,1235,0.5756013745704467,0.4125628140703518,0.9255918827508456,0.42214532871972316,0.5778546712802768,0.07440811724915446,0.5707334028501911
0.379,2910,"[[821, 1166], [66, 857]]",821,66,1166,66,887,2023,1987,923,1678,1232,0.5766323024054982,0.4131857070961248,0.9255918827508456,0.4236282748393475,0.5763717251606525,0.07440811724915446,0.5713291579679889
0.38,2910,"[[820, 1166], [67, 857]]",820,67,1166,67,887,2023,1986,924,1677,1233,0.5762886597938144,0.41289023162134947,0.9244644870349493,0.4236282748393475,0.5763717251606525,0.07553551296505073,0.5708318830490776
0.381,2910,"[[820, 1166], [67, 857]]",820,67,1166,67,887,2023,1986,924,1677,1233,0.5762886597938144,0.41289023162134947,0.9244644870349493,0.4236282748393475,0.5763717251606525,0.07553551296505073,0.5708318830490776
0.382,2910,"[[820, 1166], [67, 857]]",820,67,1166,67,887,2023,1986,924,1677,1233,0.5762886597938144,0.41289023162134947,0.9244644870349493,0.4236282748393475,0.5763717251606525,0.07553551296505073,0.5708318830490776
0.383,2910,"[[820, 1166], [67, 857]]",820,67,1166,67,887,2023,1986,924,1677,1233,0.5762886597938144,0.41289023162134947,0.9244644870349493,0.4236282748393475,0.5763717251606525,0.07553551296505073,0.5708318830490776
0.384,2910,"[[820, 1166], [67, 857]]",820,67,1166,67,887,2023,1986,924,1677,1233,0.5762886597938144,0.41289023162134947,0.9244644870349493,0.4236282748393475,0.5763717251606525,0.07553551296505073,0.5708318830490776
0.385,2910,"[[820, 1166], [67, 857]]",820,67,1166,67,887,2023,1986,924,1677,1233,0.5762886597938144,0.41289023162134947,0.9244644870349493,0.4236282748393475,0.5763717251606525,0.07553551296505073,0.5708318830490776
0.386,2910,"[[820, 1165], [67, 858]]",820,67,1165,67,887,2023,1985,925,1678,1232,0.5766323024054982,0.41309823677581864,0.9244644870349493,0.4241225902125556,0.5758774097874444,0.07553551296505073,0.5710306406685237
0.387,2910,"[[820, 1165], [67, 858]]",820,67,1165,67,887,2023,1985,925,1678,1232,0.5766323024054982,0.41309823677581864,0.9244644870349493,0.4241225902125556,0.5758774097874444,0.07553551296505073,0.5710306406685237
0.388,2910,"[[820, 1163], [67, 860]]",820,67,1163,67,887,2023,1983,927,1680,1230,0.5773195876288659,0.4135148764498235,0.9244644870349493,0.4251112209589718,0.5748887790410282,0.07553551296505073,0.5714285714285715
0.389,2910,"[[820, 1162], [67, 861]]",820,67,1162,67,887,2023,1982,928,1681,1229,0.5776632302405498,0.41372351160444,0.9244644870349493,0.42560553633217996,0.5743944636678201,0.07553551296505073,0.5716277448588358
0.39,2910,"[[820, 1160], [67, 863]]",820,67,1160,67,887,2023,1980,930,1683,1227,0.5783505154639176,0.41414141414141414,0.9244644870349493,0.42659416707859615,0.5734058329214039,0.07553551296505073,0.572026508545518
0.391,2910,"[[820, 1160], [67, 863]]",820,67,1160,67,887,2023,1980,930,1683,1227,0.5783505154639176,0.41414141414141414,0.9244644870349493,0.42659416707859615,0.5734058329214039,0.07553551296505073,0.572026508545518
0.392,2910,"[[819, 1160], [68, 863]]",819,68,1160,68,887,2023,1979,931,1682,1228,0.5780068728522336,0.41384537645275393,0.923337091319053,0.42659416707859615,0.5734058329214039,0.07666290868094701,0.5715282623866015
0.393,2910,"[[819, 1159], [68, 864]]",819,68,1159,68,887,2023,1978,932,1683,1227,0.5783505154639176,0.41405460060667343,0.923337091319053,0.42708848245180425,0.5729115175481958,0.07666290868094701,0.5717277486910995
0.394,2910,"[[819, 1158], [68, 865]]",819,68,1158,68,887,2023,1977,933,1684,1226,0.5786941580756014,0.4142640364188164,0.923337091319053,0.42758279782501235,0.5724172021749876,0.07666290868094701,0.571927374301676
0.395,2910,"[[818, 1157], [69, 866]]",818,69,1157,69,887,2023,1975,935,1684,1226,0.5786941580756014,0.41417721518987344,0.9222096956031567,0.42807711319822045,0.5719228868017795,0.0777903043968433,0.5716282320055905
0.396,2910,"[[818, 1157], [69, 866]]",818,69,1157,69,887,2023,1975,935,1684,1226,0.5786941580756014,0.41417721518987344,0.9222096956031567,0.42807711319822045,0.5719228868017795,0.0777903043968433,0.5716282320055905
0.397,2910,"[[818, 1155], [69, 868]]",818,69,1155,69,887,2023,1973,937,1686,1224,0.5793814432989691,0.41459706031424226,0.9222096956031567,0.4290657439446367,0.5709342560553633,0.0777903043968433,0.572027972027972
0.398,2910,"[[818, 1154], [69, 869]]",818,69,1154,69,887,2023,1972,938,1687,1223,0.579725085910653,0.4148073022312373,0.9222096956031567,0.4295600593178448,0.5704399406821552,0.0777903043968433,0.5722280517663518
0.399,2910,"[[818, 1154], [69, 869]]",818,69,1154,69,887,2023,1972,938,1687,1223,0.579725085910653,0.4148073022312373,0.9222096956031567,0.4295600593178448,0.5704399406821552,0.0777903043968433,0.5722280517663518
0.4,2910,"[[818, 1154], [69, 869]]",818,69,1154,69,887,2023,1972,938,1687,1223,0.579725085910653,0.4148073022312373,0.9222096956031567,0.4295600593178448,0.5704399406821552,0.0777903043968433,0.5722280517663518
0.401,2910,"[[818, 1154], [69, 869]]",818,69,1154,69,887,2023,1972,938,1687,1223,0.579725085910653,0.4148073022312373,0.9222096956031567,0.4295600593178448,0.5704399406821552,0.0777903043968433,0.5722280517663518
0.402,2910,"[[818, 1154], [69, 869]]",818,69,1154,69,887,2023,1972,938,1687,1223,0.579725085910653,0.4148073022312373,0.9222096956031567,0.4295600593178448,0.5704399406821552,0.0777903043968433,0.5722280517663518
0.403,2910,"[[818, 1154], [69, 869]]",818,69,1154,69,887,2023,1972,938,1687,1223,0.579725085910653,0.4148073022312373,0.9222096956031567,0.4295600593178448,0.5704399406821552,0.0777903043968433,0.5722280517663518
0.404,2910,"[[818, 1154], [69, 869]]",818,69,1154,69,887,2023,1972,938,1687,1223,0.579725085910653,0.4148073022312373,0.9222096956031567,0.4295600593178448,0.5704399406821552,0.0777903043968433,0.5722280517663518
0.405,2910,"[[818, 1154], [69, 869]]",818,69,1154,69,887,2023,1972,938,1687,1223,0.579725085910653,0.4148073022312373,0.9222096956031567,0.4295600593178448,0.5704399406821552,0.0777903043968433,0.5722280517663518
0.406,2910,"[[818, 1151], [69, 872]]",818,69,1151,69,887,2023,1969,941,1690,1220,0.5807560137457045,0.4154393092940579,0.9222096956031567,0.4310430054374691,0.5689569945625309,0.0777903043968433,0.5728291316526611
0.407,2910,"[[818, 1151], [69, 872]]",818,69,1151,69,887,2023,1969,941,1690,1220,0.5807560137457045,0.4154393092940579,0.9222096956031567,0.4310430054374691,0.5689569945625309,0.0777903043968433,0.5728291316526611
0.408,2910,"[[818, 1151], [69, 872]]",818,69,1151,69,887,2023,1969,941,1690,1220,0.5807560137457045,0.4154393092940579,0.9222096956031567,0.4310430054374691,0.5689569945625309,0.0777903043968433,0.5728291316526611
0.409,2910,"[[818, 1150], [69, 873]]",818,69,1150,69,887,2023,1968,942,1691,1219,0.5810996563573884,0.41565040650406504,0.9222096956031567,0.4315373208106772,0.5684626791893228,0.0777903043968433,0.5730297723292469
0.41,2910,"[[818, 1150], [69, 873]]",818,69,1150,69,887,2023,1968,942,1691,1219,0.5810996563573884,0.41565040650406504,0.9222096956031567,0.4315373208106772,0.5684626791893228,0.0777903043968433,0.5730297723292469
0.411,2910,"[[818, 1150], [69, 873]]",818,69,1150,69,887,2023,1968,942,1691,1219,0.5810996563573884,0.41565040650406504,0.9222096956031567,0.4315373208106772,0.5684626791893228,0.0777903043968433,0.5730297723292469
0.412,2910,"[[817, 1148], [70, 875]]",817,70,1148,70,887,2023,1965,945,1692,1218,0.5814432989690722,0.4157760814249364,0.9210822998872604,0.43252595155709345,0.5674740484429066,0.07891770011273957,0.5729312762973352
0.413,2910,"[[817, 1145], [70, 878]]",817,70,1145,70,887,2023,1962,948,1695,1215,0.5824742268041238,0.4164118246687054,0.9210822998872604,0.43400889767671774,0.5659911023232822,0.07891770011273957,0.5735345735345735
0.414,2910,"[[817, 1143], [70, 880]]",817,70,1143,70,887,2023,1960,950,1697,1213,0.5831615120274914,0.41683673469387755,0.9210822998872604,0.43499752842313394,0.565002471576866,0.07891770011273957,0.5739374780470671
0.415,2910,"[[817, 1142], [70, 881]]",817,70,1142,70,887,2023,1959,951,1698,1212,0.5835051546391753,0.4170495150587034,0.9210822998872604,0.4354918437963421,0.5645081562036579,0.07891770011273957,0.5741391426563599
0.416,2910,"[[817, 1141], [70, 882]]",817,70,1141,70,887,2023,1958,952,1699,1211,0.5838487972508591,0.41726251276813076,0.9210822998872604,0.4359861591695502,0.5640138408304498,0.07891770011273957,0.574340949033392
0.417,2910,"[[817, 1140], [70, 883]]",817,70,1140,70,887,2023,1957,953,1700,1210,0.584192439862543,0.4174757281553398,0.9210822998872604,0.4364804745427583,0.5635195254572417,0.07891770011273957,0.5745428973277075
0.418,2910,"[[817, 1139], [70, 884]]",817,70,1139,70,887,2023,1956,954,1701,1209,0.5845360824742268,0.4176891615541922,0.9210822998872604,0.4369747899159664,0.5630252100840336,0.07891770011273957,0.5747449876890609
0.419,2910,"[[817, 1138], [70, 885]]",817,70,1138,70,887,2023,1955,955,1702,1208,0.5848797250859107,0.41790281329923273,0.9210822998872604,0.4374691052891745,0.5625308947108255,0.07891770011273957,0.5749472202674173
0.42,2910,"[[817, 1137], [70, 886]]",817,70,1137,70,887,2023,1954,956,1703,1207,0.5852233676975945,0.4181166837256909,0.9210822998872604,0.4379634206623826,0.5620365793376174,0.07891770011273957,0.5751495952129533
0.421,2910,"[[817, 1136], [70, 887]]",817,70,1136,70,887,2023,1953,957,1704,1206,0.5855670103092784,0.41833077316948286,0.9210822998872604,0.4384577360355907,0.5615422639644093,0.07891770011273957,0.5753521126760563
0.422,2910,"[[817, 1136], [70, 887]]",817,70,1136,70,887,2023,1953,957,1704,1206,0.5855670103092784,0.41833077316948286,0.9210822998872604,0.4384577360355907,0.5615422639644093,0.07891770011273957,0.5753521126760563
0.423,2910,"[[816, 1136], [71, 887]]",816,71,1136,71,887,2023,1952,958,1703,1207,0.5852233676975945,0.4180327868852459,0.9199549041713642,0.4384577360355907,0.5615422639644093,0.08004509582863585,0.5748502994011976
0.424,2910,"[[816, 1136], [71, 887]]",816,71,1136,71,887,2023,1952,958,1703,1207,0.5852233676975945,0.4180327868852459,0.9199549041713642,0.4384577360355907,0.5615422639644093,0.08004509582863585,0.5748502994011976
0.425,2910,"[[816, 1135], [71, 888]]",816,71,1135,71,887,2023,1951,959,1704,1206,0.5855670103092784,0.41824705279343927,0.9199549041713642,0.43895205140879884,0.5610479485912012,0.08004509582863585,0.5750528541226216
0.426,2910,"[[816, 1134], [71, 889]]",816,71,1134,71,887,2023,1950,960,1705,1205,0.5859106529209622,0.41846153846153844,0.9199549041713642,0.43944636678200694,0.5605536332179931,0.08004509582863585,0.5752555516390553
0.427,2910,"[[815, 1134], [72, 889]]",815,72,1134,72,887,2023,1949,961,1704,1206,0.5855670103092784,0.418163160595177,0.9188275084554679,0.43944636678200694,0.5605536332179931,0.08117249154453213,0.57475317348378
0.428,2910,"[[815, 1134], [72, 889]]",815,72,1134,72,887,2023,1949,961,1704,1206,0.5855670103092784,0.418163160595177,0.9188275084554679,0.43944636678200694,0.5605536332179931,0.08117249154453213,0.57475317348378
0.429,2910,"[[815, 1134], [72, 889]]",815,72,1134,72,887,2023,1949,961,1704,1206,0.5855670103092784,0.418163160595177,0.9188275084554679,0.43944636678200694,0.5605536332179931,0.08117249154453213,0.57475317348378
0.43,2910,"[[815, 1134], [72, 889]]",815,72,1134,72,887,2023,1949,961,1704,1206,0.5855670103092784,0.418163160595177,0.9188275084554679,0.43944636678200694,0.5605536332179931,0.08117249154453213,0.57475317348378
0.431,2910,"[[815, 1132], [72, 891]]",815,72,1132,72,887,2023,1947,963,1706,1204,0.5862542955326461,0.41859270672829996,0.9188275084554679,0.44043499752842313,0.5595650024715768,0.08117249154453213,0.5751587861679605
0.432,2910,"[[815, 1132], [72, 891]]",815,72,1132,72,887,2023,1947,963,1706,1204,0.5862542955326461,0.41859270672829996,0.9188275084554679,0.44043499752842313,0.5595650024715768,0.08117249154453213,0.5751587861679605
0.433,2910,"[[815, 1131], [72, 892]]",815,72,1131,72,887,2023,1946,964,1707,1203,0.5865979381443299,0.4188078108941418,0.9188275084554679,0.44092931290163123,0.5590706870983687,0.08117249154453213,0.5753618072714437
0.434,2910,"[[815, 1131], [72, 892]]",815,72,1131,72,887,2023,1946,964,1707,1203,0.5865979381443299,0.4188078108941418,0.9188275084554679,0.44092931290163123,0.5590706870983687,0.08117249154453213,0.5753618072714437
0.435,2910,"[[814, 1129], [73, 894]]",814,73,1129,73,887,2023,1943,967,1708,1202,0.5869415807560138,0.4189397838394236,0.9177001127395716,0.44191794364804743,0.5580820563519525,0.08229988726042842,0.5752650176678445
0.436,2910,"[[814, 1129], [73, 894]]",814,73,1129,73,887,2023,1943,967,1708,1202,0.5869415807560138,0.4189397838394236,0.9177001127395716,0.44191794364804743,0.5580820563519525,0.08229988726042842,0.5752650176678445
0.437,2910,"[[814, 1129], [73, 894]]",814,73,1129,73,887,2023,1943,967,1708,1202,0.5869415807560138,0.4189397838394236,0.9177001127395716,0.44191794364804743,0.5580820563519525,0.08229988726042842,0.5752650176678445
0.438,2910,"[[814, 1128], [73, 895]]",814,73,1128,73,887,2023,1942,968,1709,1201,0.5872852233676976,0.4191555097837281,0.9177001127395716,0.4424122590212556,0.5575877409787444,0.08229988726042842,0.575468363379286
0.439,2910,"[[814, 1128], [73, 895]]",814,73,1128,73,887,2023,1942,968,1709,1201,0.5872852233676976,0.4191555097837281,0.9177001127395716,0.4424122590212556,0.5575877409787444,0.08229988726042842,0.575468363379286
0.44,2910,"[[814, 1128], [73, 895]]",814,73,1128,73,887,2023,1942,968,1709,1201,0.5872852233676976,0.4191555097837281,0.9177001127395716,0.4424122590212556,0.5575877409787444,0.08229988726042842,0.575468363379286
0.441,2910,"[[814, 1128], [73, 895]]",814,73,1128,73,887,2023,1942,968,1709,1201,0.5872852233676976,0.4191555097837281,0.9177001127395716,0.4424122590212556,0.5575877409787444,0.08229988726042842,0.575468363379286
0.442,2910,"[[814, 1128], [73, 895]]",814,73,1128,73,887,2023,1942,968,1709,1201,0.5872852233676976,0.4191555097837281,0.9177001127395716,0.4424122590212556,0.5575877409787444,0.08229988726042842,0.575468363379286
0.443,2910,"[[813, 1128], [74, 895]]",813,74,1128,74,887,2023,1941,969,1708,1202,0.5869415807560138,0.4188562596599691,0.9165727170236753,0.4424122590212556,0.5575877409787444,0.0834272829763247,0.5749646393210749
0.444,2910,"[[812, 1126], [75, 897]]",812,75,1126,75,887,2023,1938,972,1709,1201,0.5872852233676976,0.41898864809081526,0.915445321307779,0.4434008897676718,0.5565991102323282,0.08455467869222097,0.5748672566371681
0.445,2910,"[[812, 1126], [75, 897]]",812,75,1126,75,887,2023,1938,972,1709,1201,0.5872852233676976,0.41898864809081526,0.915445321307779,0.4434008897676718,0.5565991102323282,0.08455467869222097,0.5748672566371681
0.446,2910,"[[812, 1126], [75, 897]]",812,75,1126,75,887,2023,1938,972,1709,1201,0.5872852233676976,0.41898864809081526,0.915445321307779,0.4434008897676718,0.5565991102323282,0.08455467869222097,0.5748672566371681
0.447,2910,"[[812, 1125], [75, 898]]",812,75,1125,75,887,2023,1937,973,1710,1200,0.5876288659793815,0.4192049561177078,0.915445321307779,0.4438952051408799,0.5561047948591201,0.08455467869222097,0.575070821529745
0.448,2910,"[[812, 1125], [75, 898]]",812,75,1125,75,887,2023,1937,973,1710,1200,0.5876288659793815,0.4192049561177078,0.915445321307779,0.4438952051408799,0.5561047948591201,0.08455467869222097,0.575070821529745
0.449,2910,"[[812, 1124], [75, 899]]",812,75,1124,75,887,2023,1936,974,1711,1199,0.5879725085910653,0.4194214876033058,0.915445321307779,0.444389520514088,0.555610479485912,0.08455467869222097,0.5752745306411619
0.45,2910,"[[812, 1124], [75, 899]]",812,75,1124,75,887,2023,1936,974,1711,1199,0.5879725085910653,0.4194214876033058,0.915445321307779,0.444389520514088,0.555610479485912,0.08455467869222097,0.5752745306411619
0.451,2910,"[[812, 1123], [75, 900]]",812,75,1123,75,887,2023,1935,975,1712,1198,0.5883161512027492,0.4196382428940568,0.915445321307779,0.4448838358872961,0.5551161641127039,0.08455467869222097,0.5754783841247342
0.452,2910,"[[811, 1122], [76, 901]]",811,76,1122,76,887,2023,1933,977,1712,1198,0.5883161512027492,0.41955509570615623,0.9143179255918827,0.44537815126050423,0.5546218487394958,0.08568207440811725,0.575177304964539
0.453,2910,"[[810, 1121], [77, 902]]",810,77,1121,77,887,2023,1931,979,1712,1198,0.5883161512027492,0.41947177628171933,0.9131905298759865,0.4458724666337123,0.5541275333662877,0.08680947012401354,0.5748757984386089
0.454,2910,"[[809, 1121], [78, 902]]",809,78,1121,78,887,2023,1930,980,1711,1199,0.5879725085910653,0.4191709844559586,0.9120631341600902,0.4458724666337123,0.5541275333662877,0.08793686583990981,0.5743698970536032
0.455,2910,"[[809, 1121], [78, 902]]",809,78,1121,78,887,2023,1930,980,1711,1199,0.5879725085910653,0.4191709844559586,0.9120631341600902,0.4458724666337123,0.5541275333662877,0.08793686583990981,0.5743698970536032
0.456,2910,"[[809, 1118], [78, 905]]",809,78,1118,78,887,2023,1927,983,1714,1196,0.5890034364261169,0.419823559937727,0.9120631341600902,0.4473554127533366,0.5526445872466633,0.08793686583990981,0.5749822316986495
0.457,2910,"[[809, 1118], [78, 905]]",809,78,1118,78,887,2023,1927,983,1714,1196,0.5890034364261169,0.419823559937727,0.9120631341600902,0.4473554127533366,0.5526445872466633,0.08793686583990981,0.5749822316986495
0.458,2910,"[[809, 1117], [78, 906]]",809,78,1117,78,887,2023,1926,984,1715,1195,0.5893470790378007,0.4200415368639668,0.9120631341600902,0.4478497281265447,0.5521502718734552,0.08793686583990981,0.5751866334873801
0.459,2910,"[[808, 1117], [79, 906]]",808,79,1117,79,887,2023,1925,985,1714,1196,0.5890034364261169,0.41974025974025975,0.910935738444194,0.4478497281265447,0.5521502718734552,0.08906426155580609,0.5746799431009958
0.46,2910,"[[808, 1117], [79, 906]]",808,79,1117,79,887,2023,1925,985,1714,1196,0.5890034364261169,0.41974025974025975,0.910935738444194,0.4478497281265447,0.5521502718734552,0.08906426155580609,0.5746799431009958
0.461,2910,"[[808, 1117], [79, 906]]",808,79,1117,79,887,2023,1925,985,1714,1196,0.5890034364261169,0.41974025974025975,0.910935738444194,0.4478497281265447,0.5521502718734552,0.08906426155580609,0.5746799431009958
0.462,2910,"[[808, 1117], [79, 906]]",808,79,1117,79,887,2023,1925,985,1714,1196,0.5890034364261169,0.41974025974025975,0.910935738444194,0.4478497281265447,0.5521502718734552,0.08906426155580609,0.5746799431009958
0.463,2910,"[[808, 1117], [79, 906]]",808,79,1117,79,887,2023,1925,985,1714,1196,0.5890034364261169,0.41974025974025975,0.910935738444194,0.4478497281265447,0.5521502718734552,0.08906426155580609,0.5746799431009958
0.464,2910,"[[808, 1117], [79, 906]]",808,79,1117,79,887,2023,1925,985,1714,1196,0.5890034364261169,0.41974025974025975,0.910935738444194,0.4478497281265447,0.5521502718734552,0.08906426155580609,0.5746799431009958
0.465,2910,"[[808, 1117], [79, 906]]",808,79,1117,79,887,2023,1925,985,1714,1196,0.5890034364261169,0.41974025974025975,0.910935738444194,0.4478497281265447,0.5521502718734552,0.08906426155580609,0.5746799431009958
0.466,2910,"[[808, 1117], [79, 906]]",808,79,1117,79,887,2023,1925,985,1714,1196,0.5890034364261169,0.41974025974025975,0.910935738444194,0.4478497281265447,0.5521502718734552,0.08906426155580609,0.5746799431009958
0.467,2910,"[[808, 1116], [79, 907]]",808,79,1116,79,887,2023,1924,986,1715,1195,0.5893470790378007,0.41995841995842,0.910935738444194,0.4483440434997528,0.5516559565002471,0.08906426155580609,0.5748843827819281
0.468,2910,"[[808, 1113], [79, 910]]",808,79,1113,79,887,2023,1921,989,1718,1192,0.5903780068728522,0.42061426340447683,0.910935738444194,0.44982698961937717,0.5501730103806228,0.08906426155580609,0.5754985754985755
0.469,2910,"[[807, 1113], [80, 910]]",807,80,1113,80,887,2023,1920,990,1717,1193,0.5900343642611684,0.4203125,0.9098083427282976,0.44982698961937717,0.5501730103806228,0.09019165727170236,0.5749910936943355
0.47,2910,"[[807, 1113], [80, 910]]",807,80,1113,80,887,2023,1920,990,1717,1193,0.5900343642611684,0.4203125,0.9098083427282976,0.44982698961937717,0.5501730103806228,0.09019165727170236,0.5749910936943355
0.471,2910,"[[807, 1112], [80, 911]]",807,80,1112,80,887,2023,1919,991,1718,1192,0.5903780068728522,0.4205315268368942,0.9098083427282976,0.45032130499258527,0.5496786950074147,0.09019165727170236,0.5751960085531005
0.472,2910,"[[807, 1111], [80, 912]]",807,80,1111,80,887,2023,1918,992,1719,1191,0.5907216494845361,0.42075078206465066,0.9098083427282976,0.45081562036579337,0.5491843796342066,0.09019165727170236,0.5754010695187165
0.473,2910,"[[807, 1111], [80, 912]]",807,80,1111,80,887,2023,1918,992,1719,1191,0.5907216494845361,0.42075078206465066,0.9098083427282976,0.45081562036579337,0.5491843796342066,0.09019165727170236,0.5754010695187165
0.474,2910,"[[807, 1110], [80, 913]]",807,80,1110,80,887,2023,1917,993,1720,1190,0.5910652920962199,0.4209702660406886,0.9098083427282976,0.45130993573900147,0.5486900642609985,0.09019165727170236,0.5756062767475036
0.475,2910,"[[807, 1109], [80, 914]]",807,80,1109,80,887,2023,1916,994,1721,1189,0.5914089347079038,0.4211899791231733,0.9098083427282976,0.45180425111220957,0.5481957488877904,0.09019165727170236,0.5758116303960042
0.476,2910,"[[807, 1109], [80, 914]]",807,80,1109,80,887,2023,1916,994,1721,1189,0.5914089347079038,0.4211899791231733,0.9098083427282976,0.45180425111220957,0.5481957488877904,0.09019165727170236,0.5758116303960042
0.477,2910,"[[805, 1109], [82, 914]]",805,82,1109,82,887,2023,1914,996,1719,1191,0.5907216494845361,0.4205851619644723,0.9075535512965051,0.45180425111220957,0.5481957488877904,0.09244644870349493,0.5747947161727954
0.478,2910,"[[805, 1108], [82, 915]]",805,82,1108,82,887,2023,1913,997,1720,1190,0.5910652920962199,0.42080501829587036,0.9075535512965051,0.4522985664854177,0.5477014335145823,0.09244644870349493,0.575
0.479,2910,"[[805, 1104], [82, 919]]",805,82,1104,82,887,2023,1909,1001,1724,1186,0.5924398625429553,0.42168674698795183,0.9075535512965051,0.4542758279782501,0.5457241720217498,0.09244644870349493,0.5758226037195995
0.48,2910,"[[805, 1103], [82, 920]]",805,82,1103,82,887,2023,1908,1002,1725,1185,0.5927835051546392,0.4219077568134172,0.9075535512965051,0.4547701433514582,0.5452298566485417,0.09244644870349493,0.5760286225402504
0.481,2910,"[[805, 1103], [82, 920]]",805,82,1103,82,887,2023,1908,1002,1725,1185,0.5927835051546392,0.4219077568134172,0.9075535512965051,0.4547701433514582,0.5452298566485417,0.09244644870349493,0.5760286225402504
0.482,2910,"[[805, 1102], [82, 921]]",805,82,1102,82,887,2023,1907,1003,1726,1184,0.593127147766323,0.4221289984268485,0.9075535512965051,0.4552644587246663,0.5447355412753336,0.09244644870349493,0.5762347888332141
0.483,2910,"[[805, 1101], [82, 922]]",805,82,1101,82,887,2023,1906,1004,1727,1183,0.5934707903780069,0.4223504721930745,0.9075535512965051,0.45575877409787446,0.5442412259021255,0.09244644870349493,0.5764411027568922
0.484,2910,"[[805, 1101], [82, 922]]",805,82,1101,82,887,2023,1906,1004,1727,1183,0.5934707903780069,0.4223504721930745,0.9075535512965051,0.45575877409787446,0.5442412259021255,0.09244644870349493,0.5764411027568922
0.485,2910,"[[805, 1101], [82, 922]]",805,82,1101,82,887,2023,1906,1004,1727,1183,0.5934707903780069,0.4223504721930745,0.9075535512965051,0.45575877409787446,0.5442412259021255,0.09244644870349493,0.5764411027568922
0.486,2910,"[[804, 1100], [83, 923]]",804,83,1100,83,887,2023,1904,1006,1727,1183,0.5934707903780069,0.4222689075630252,0.9064261555806088,0.45625308947108256,0.5437469105289174,0.0935738444193912,0.576137585094948
0.487,2910,"[[804, 1098], [83, 925]]",804,83,1098,83,887,2023,1902,1008,1729,1181,0.5941580756013746,0.4227129337539432,0.9064261555806088,0.45724172021749876,0.5427582797825012,0.0935738444193912,0.5765507350304768
0.488,2910,"[[804, 1097], [83, 926]]",804,83,1097,83,887,2023,1901,1009,1730,1180,0.5945017182130584,0.4229352972119937,0.9064261555806088,0.45773603559070686,0.5422639644092931,0.0935738444193912,0.5767575322812052
0.489,2910,"[[804, 1097], [83, 926]]",804,83,1097,83,887,2023,1901,1009,1730,1180,0.5945017182130584,0.4229352972119937,0.9064261555806088,0.45773603559070686,0.5422639644092931,0.0935738444193912,0.5767575322812052
0.49,2910,"[[804, 1097], [83, 926]]",804,83,1097,83,887,2023,1901,1009,1730,1180,0.5945017182130584,0.4229352972119937,0.9064261555806088,0.45773603559070686,0.5422639644092931,0.0935738444193912,0.5767575322812052
0.491,2910,"[[804, 1096], [83, 927]]",804,83,1096,83,887,2023,1900,1010,1731,1179,0.5948453608247423,0.4231578947368421,0.9064261555806088,0.45823035096391496,0.541769649036085,0.0935738444193912,0.5769644779332616
0.492,2910,"[[804, 1095], [83, 928]]",804,83,1095,83,887,2023,1899,1011,1732,1178,0.5951890034364261,0.42338072669826227,0.9064261555806088,0.4587246663371231,0.541275333662877,0.0935738444193912,0.5771715721464465
0.493,2910,"[[804, 1094], [83, 929]]",804,83,1094,83,887,2023,1898,1012,1733,1177,0.59553264604811,0.42360379346680715,0.9064261555806088,0.4592189817103312,0.5407810182896688,0.0935738444193912,0.57737881508079
0.494,2910,"[[804, 1094], [83, 929]]",804,83,1094,83,887,2023,1898,1012,1733,1177,0.59553264604811,0.42360379346680715,0.9064261555806088,0.4592189817103312,0.5407810182896688,0.0935738444193912,0.57737881508079
0.495,2910,"[[804, 1094], [83, 929]]",804,83,1094,83,887,2023,1898,1012,1733,1177,0.59553264604811,0.42360379346680715,0.9064261555806088,0.4592189817103312,0.5407810182896688,0.0935738444193912,0.57737881508079
0.496,2910,"[[804, 1093], [83, 930]]",804,83,1093,83,887,2023,1897,1013,1734,1176,0.5958762886597938,0.4238270954138113,0.9064261555806088,0.4597132970835393,0.5402867029164607,0.0935738444193912,0.5775862068965517
0.497,2910,"[[803, 1093], [84, 930]]",803,84,1093,84,887,2023,1896,1014,1733,1177,0.59553264604811,0.42352320675105487,0.9052987598647125,0.4597132970835393,0.5402867029164607,0.09470124013528748,0.5770750988142292
0.498,2910,"[[803, 1093], [84, 930]]",803,84,1093,84,887,2023,1896,1014,1733,1177,0.59553264604811,0.42352320675105487,0.9052987598647125,0.4597132970835393,0.5402867029164607,0.09470124013528748,0.5770750988142292
0.499,2910,"[[803, 1093], [84, 930]]",803,84,1093,84,887,2023,1896,1014,1733,1177,0.59553264604811,0.42352320675105487,0.9052987598647125,0.4597132970835393,0.5402867029164607,0.09470124013528748,0.5770750988142292
0.5,2910,"[[803, 1093], [84, 930]]",803,84,1093,84,887,2023,1896,1014,1733,1177,0.59553264604811,0.42352320675105487,0.9052987598647125,0.4597132970835393,0.5402867029164607,0.09470124013528748,0.5770750988142292
0.501,2910,"[[803, 1093], [84, 930]]",803,84,1093,84,887,2023,1896,1014,1733,1177,0.59553264604811,0.42352320675105487,0.9052987598647125,0.4597132970835393,0.5402867029164607,0.09470124013528748,0.5770750988142292
0.502,2910,"[[803, 1092], [84, 931]]",803,84,1092,84,887,2023,1895,1015,1734,1176,0.5958762886597938,0.4237467018469657,0.9052987598647125,0.4602076124567474,0.5397923875432526,0.09470124013528748,0.5772825305535586
0.503,2910,"[[803, 1092], [84, 931]]",803,84,1092,84,887,2023,1895,1015,1734,1176,0.5958762886597938,0.4237467018469657,0.9052987598647125,0.4602076124567474,0.5397923875432526,0.09470124013528748,0.5772825305535586
0.504,2910,"[[803, 1092], [84, 931]]",803,84,1092,84,887,2023,1895,1015,1734,1176,0.5958762886597938,0.4237467018469657,0.9052987598647125,0.4602076124567474,0.5397923875432526,0.09470124013528748,0.5772825305535586
0.505,2910,"[[803, 1091], [84, 932]]",803,84,1091,84,887,2023,1894,1016,1735,1175,0.5962199312714777,0.4239704329461457,0.9052987598647125,0.4607019278299555,0.5392980721700444,0.09470124013528748,0.5774901114706941
0.506,2910,"[[803, 1090], [84, 933]]",803,84,1090,84,887,2023,1893,1017,1736,1174,0.5965635738831615,0.42419440042260964,0.9052987598647125,0.4611962432031636,0.5388037567968363,0.09470124013528748,0.5776978417266188
0.507,2910,"[[803, 1090], [84, 933]]",803,84,1090,84,887,2023,1893,1017,1736,1174,0.5965635738831615,0.42419440042260964,0.9052987598647125,0.4611962432031636,0.5388037567968363,0.09470124013528748,0.5776978417266188
0.508,2910,"[[802, 1089], [85, 934]]",802,85,1089,85,887,2023,1891,1019,1736,1174,0.5965635738831615,0.4241142252776309,0.9041713641488163,0.4616905585763717,0.5383094414236282,0.09582863585118377,0.5773938084953204
0.509,2910,"[[802, 1089], [85, 934]]",802,85,1089,85,887,2023,1891,1019,1736,1174,0.5965635738831615,0.4241142252776309,0.9041713641488163,0.4616905585763717,0.5383094414236282,0.09582863585118377,0.5773938084953204
0.51,2910,"[[802, 1088], [85, 935]]",802,85,1088,85,887,2023,1890,1020,1737,1173,0.5969072164948453,0.42433862433862435,0.9041713641488163,0.46218487394957986,0.5378151260504201,0.09582863585118377,0.5776017284839755
0.511,2910,"[[802, 1087], [85, 936]]",802,85,1087,85,887,2023,1889,1021,1738,1172,0.5972508591065292,0.42456326098464797,0.9041713641488163,0.46267918932278795,0.537320810677212,0.09582863585118377,0.5778097982708934
0.512,2910,"[[802, 1087], [85, 936]]",802,85,1087,85,887,2023,1889,1021,1738,1172,0.5972508591065292,0.42456326098464797,0.9041713641488163,0.46267918932278795,0.537320810677212,0.09582863585118377,0.5778097982708934
0.513,2910,"[[802, 1087], [85, 936]]",802,85,1087,85,887,2023,1889,1021,1738,1172,0.5972508591065292,0.42456326098464797,0.9041713641488163,0.46267918932278795,0.537320810677212,0.09582863585118377,0.5778097982708934
0.514,2910,"[[802, 1087], [85, 936]]",802,85,1087,85,887,2023,1889,1021,1738,1172,0.5972508591065292,0.42456326098464797,0.9041713641488163,0.46267918932278795,0.537320810677212,0.09582863585118377,0.5778097982708934
0.515,2910,"[[802, 1087], [85, 936]]",802,85,1087,85,887,2023,1889,1021,1738,1172,0.5972508591065292,0.42456326098464797,0.9041713641488163,0.46267918932278795,0.537320810677212,0.09582863585118377,0.5778097982708934
0.516,2910,"[[802, 1087], [85, 936]]",802,85,1087,85,887,2023,1889,1021,1738,1172,0.5972508591065292,0.42456326098464797,0.9041713641488163,0.46267918932278795,0.537320810677212,0.09582863585118377,0.5778097982708934
0.517,2910,"[[802, 1086], [85, 937]]",802,85,1086,85,887,2023,1888,1022,1739,1171,0.597594501718213,0.4247881355932203,0.9041713641488163,0.46317350469599605,0.536826495304004,0.09582863585118377,0.578018018018018
0.518,2910,"[[802, 1084], [85, 939]]",802,85,1084,85,887,2023,1886,1024,1741,1169,0.5982817869415807,0.4252386002120891,0.9041713641488163,0.46416213544241225,0.5358378645575878,0.09582863585118377,0.578434908041832
0.519,2910,"[[802, 1083], [85, 940]]",802,85,1083,85,887,2023,1885,1025,1742,1168,0.5986254295532646,0.42546419098143234,0.9041713641488163,0.46465645081562035,0.5353435491843797,0.09582863585118377,0.5786435786435786
0.52,2910,"[[802, 1082], [85, 941]]",802,85,1082,85,887,2023,1884,1026,1743,1167,0.5989690721649484,0.4256900212314225,0.9041713641488163,0.46515076618882845,0.5348492338111716,0.09582863585118377,0.5788523998556478
0.521,2910,"[[802, 1081], [85, 942]]",802,85,1081,85,887,2023,1883,1027,1744,1166,0.5993127147766323,0.42591609134360064,0.9041713641488163,0.4656450815620366,0.5343549184379635,0.09582863585118377,0.5790613718411552
0.522,2910,"[[802, 1080], [85, 943]]",802,85,1080,85,887,2023,1882,1028,1745,1165,0.5996563573883161,0.4261424017003188,0.9041713641488163,0.4661393969352447,0.5338606030647554,0.09582863585118377,0.5792704947634525
0.523,2910,"[[802, 1080], [85, 943]]",802,85,1080,85,887,2023,1882,1028,1745,1165,0.5996563573883161,0.4261424017003188,0.9041713641488163,0.4661393969352447,0.5338606030647554,0.09582863585118377,0.5792704947634525
0.524,2910,"[[802, 1079], [85, 944]]",802,85,1079,85,887,2023,1881,1029,1746,1164,0.6,0.4263689526847422,0.9041713641488163,0.4666337123084528,0.5333662876915473,0.09582863585118377,0.5794797687861272
0.525,2910,"[[802, 1076], [85, 947]]",802,85,1076,85,887,2023,1878,1032,1749,1161,0.6010309278350515,0.42705005324813633,0.9041713641488163,0.4681166584280771,0.5318833415719229,0.09582863585118377,0.580108499095841
0.526,2910,"[[801, 1076], [86, 947]]",801,86,1076,86,887,2023,1877,1033,1748,1162,0.6006872852233677,0.4267448055407565,0.90304396843292,0.4681166584280771,0.5318833415719229,0.09695603156708005,0.5795947901591896
0.527,2910,"[[801, 1074], [86, 949]]",801,86,1074,86,887,2023,1875,1035,1750,1160,0.6013745704467354,0.4272,0.90304396843292,0.46910528917449335,0.5308947108255067,0.09695603156708005,0.5800144822592326
0.528,2910,"[[801, 1073], [86, 950]]",801,86,1073,86,887,2023,1874,1036,1751,1159,0.6017182130584192,0.4274279615795091,0.90304396843292,0.46959960454770144,0.5304003954522986,0.09695603156708005,0.5802245563201739
0.529,2910,"[[801, 1073], [86, 950]]",801,86,1073,86,887,2023,1874,1036,1751,1159,0.6017182130584192,0.4274279615795091,0.90304396843292,0.46959960454770144,0.5304003954522986,0.09695603156708005,0.5802245563201739
0.53,2910,"[[801, 1073], [86, 950]]",801,86,1073,86,887,2023,1874,1036,1751,1159,0.6017182130584192,0.4274279615795091,0.90304396843292,0.46959960454770144,0.5304003954522986,0.09695603156708005,0.5802245563201739
0.531,2910,"[[801, 1072], [86, 951]]",801,86,1072,86,887,2023,1873,1037,1752,1158,0.6020618556701031,0.42765616657768285,0.90304396843292,0.47009391992090954,0.5299060800790905,0.09695603156708005,0.5804347826086956
0.532,2910,"[[801, 1071], [86, 952]]",801,86,1071,86,887,2023,1872,1038,1753,1157,0.6024054982817869,0.42788461538461536,0.90304396843292,0.47058823529411764,0.5294117647058824,0.09695603156708005,0.5806451612903226
0.533,2910,"[[801, 1069], [86, 954]]",801,86,1069,86,887,2023,1870,1040,1755,1155,0.6030927835051546,0.4283422459893048,0.90304396843292,0.47157686604053384,0.5284231339594662,0.09695603156708005,0.5810663764961915
0.534,2910,"[[801, 1069], [86, 954]]",801,86,1069,86,887,2023,1870,1040,1755,1155,0.6030927835051546,0.4283422459893048,0.90304396843292,0.47157686604053384,0.5284231339594662,0.09695603156708005,0.5810663764961915
0.535,2910,"[[801, 1067], [86, 956]]",801,86,1067,86,887,2023,1868,1042,1757,1153,0.6037800687285223,0.42880085653104927,0.90304396843292,0.4725654967869501,0.52743450321305,0.09695603156708005,0.5814882032667876
0.536,2910,"[[801, 1067], [86, 956]]",801,86,1067,86,887,2023,1868,1042,1757,1153,0.6037800687285223,0.42880085653104927,0.90304396843292,0.4725654967869501,0.52743450321305,0.09695603156708005,0.5814882032667876
0.537,2910,"[[801, 1067], [86, 956]]",801,86,1067,86,887,2023,1868,1042,1757,1153,0.6037800687285223,0.42880085653104927,0.90304396843292,0.4725654967869501,0.52743450321305,0.09695603156708005,0.5814882032667876
0.538,2910,"[[801, 1067], [86, 956]]",801,86,1067,86,887,2023,1868,1042,1757,1153,0.6037800687285223,0.42880085653104927,0.90304396843292,0.4725654967869501,0.52743450321305,0.09695603156708005,0.5814882032667876
0.539,2910,"[[801, 1065], [86, 958]]",801,86,1065,86,887,2023,1866,1044,1759,1151,0.60446735395189,0.4292604501607717,0.90304396843292,0.4735541275333663,0.5264458724666337,0.09695603156708005,0.5819106429349801
0.54,2910,"[[801, 1065], [86, 958]]",801,86,1065,86,887,2023,1866,1044,1759,1151,0.60446735395189,0.4292604501607717,0.90304396843292,0.4735541275333663,0.5264458724666337,0.09695603156708005,0.5819106429349801
0.541,2910,"[[801, 1065], [86, 958]]",801,86,1065,86,887,2023,1866,1044,1759,1151,0.60446735395189,0.4292604501607717,0.90304396843292,0.4735541275333663,0.5264458724666337,0.09695603156708005,0.5819106429349801
0.542,2910,"[[801, 1064], [86, 959]]",801,86,1064,86,887,2023,1865,1045,1760,1150,0.6048109965635738,0.4294906166219839,0.90304396843292,0.4740484429065744,0.5259515570934256,0.09695603156708005,0.5821220930232558
0.543,2910,"[[801, 1064], [86, 959]]",801,86,1064,86,887,2023,1865,1045,1760,1150,0.6048109965635738,0.4294906166219839,0.90304396843292,0.4740484429065744,0.5259515570934256,0.09695603156708005,0.5821220930232558
0.544,2910,"[[801, 1064], [86, 959]]",801,86,1064,86,887,2023,1865,1045,1760,1150,0.6048109965635738,0.4294906166219839,0.90304396843292,0.4740484429065744,0.5259515570934256,0.09695603156708005,0.5821220930232558
0.545,2910,"[[801, 1064], [86, 959]]",801,86,1064,86,887,2023,1865,1045,1760,1150,0.6048109965635738,0.4294906166219839,0.90304396843292,0.4740484429065744,0.5259515570934256,0.09695603156708005,0.5821220930232558
0.546,2910,"[[801, 1064], [86, 959]]",801,86,1064,86,887,2023,1865,1045,1760,1150,0.6048109965635738,0.4294906166219839,0.90304396843292,0.4740484429065744,0.5259515570934256,0.09695603156708005,0.5821220930232558
0.547,2910,"[[801, 1063], [86, 960]]",801,86,1063,86,887,2023,1864,1046,1761,1149,0.6051546391752577,0.42972103004291845,0.90304396843292,0.4745427582797825,0.5254572417202175,0.09695603156708005,0.5823336968375136
0.548,2910,"[[801, 1062], [86, 961]]",801,86,1062,86,887,2023,1863,1047,1762,1148,0.6054982817869415,0.42995169082125606,0.90304396843292,0.4750370736529906,0.5249629263470094,0.09695603156708005,0.5825454545454546
0.549,2910,"[[801, 1061], [86, 962]]",801,86,1061,86,887,2023,1862,1048,1763,1147,0.6058419243986254,0.4301825993555317,0.90304396843292,0.47553138902619874,0.5244686109738013,0.09695603156708005,0.5827573663150237
0.55,2910,"[[800, 1061], [87, 962]]",800,87,1061,87,887,2023,1861,1049,1762,1148,0.6054982817869415,0.42987641053197206,0.9019165727170236,0.47553138902619874,0.5244686109738013,0.09808342728297632,0.5822416302765648
0.551,2910,"[[800, 1061], [87, 962]]",800,87,1061,87,887,2023,1861,1049,1762,1148,0.6054982817869415,0.42987641053197206,0.9019165727170236,0.47553138902619874,0.5244686109738013,0.09808342728297632,0.5822416302765648
0.552,2910,"[[800, 1061], [87, 962]]",800,87,1061,87,887,2023,1861,1049,1762,1148,0.6054982817869415,0.42987641053197206,0.9019165727170236,0.47553138902619874,0.5244686109738013,0.09808342728297632,0.5822416302765648
0.553,2910,"[[800, 1061], [87, 962]]",800,87,1061,87,887,2023,1861,1049,1762,1148,0.6054982817869415,0.42987641053197206,0.9019165727170236,0.47553138902619874,0.5244686109738013,0.09808342728297632,0.5822416302765648
0.554,2910,"[[800, 1061], [87, 962]]",800,87,1061,87,887,2023,1861,1049,1762,1148,0.6054982817869415,0.42987641053197206,0.9019165727170236,0.47553138902619874,0.5244686109738013,0.09808342728297632,0.5822416302765648
0.555,2910,"[[799, 1060], [88, 963]]",799,88,1060,88,887,2023,1859,1051,1762,1148,0.6054982817869415,0.42980096826250674,0.9007891770011274,0.47602570439940683,0.5239742956005932,0.0992108229988726,0.5819373634377276
0.556,2910,"[[799, 1058], [88, 965]]",799,88,1058,88,887,2023,1857,1053,1764,1146,0.6061855670103092,0.43026386645126546,0.9007891770011274,0.47701433514582303,0.522985664854177,0.0992108229988726,0.5823615160349854
0.557,2910,"[[799, 1057], [88, 966]]",799,88,1057,88,887,2023,1856,1054,1765,1145,0.6065292096219931,0.43049568965517243,0.9007891770011274,0.47750865051903113,0.5224913494809689,0.0992108229988726,0.5825738242799855
0.558,2910,"[[799, 1057], [88, 966]]",799,88,1057,88,887,2023,1856,1054,1765,1145,0.6065292096219931,0.43049568965517243,0.9007891770011274,0.47750865051903113,0.5224913494809689,0.0992108229988726,0.5825738242799855
0.559,2910,"[[799, 1056], [88, 967]]",799,88,1056,88,887,2023,1855,1055,1766,1144,0.6068728522336769,0.4307277628032345,0.9007891770011274,0.47800296589223923,0.5219970341077608,0.0992108229988726,0.5827862873814734
0.56,2910,"[[799, 1055], [88, 968]]",799,88,1055,88,887,2023,1854,1056,1767,1143,0.6072164948453608,0.43096008629989213,0.9007891770011274,0.4784972812654474,0.5215027187345527,0.0992108229988726,0.5829989055089384
0.561,2910,"[[799, 1055], [88, 968]]",799,88,1055,88,887,2023,1854,1056,1767,1143,0.6072164948453608,0.43096008629989213,0.9007891770011274,0.4784972812654474,0.5215027187345527,0.0992108229988726,0.5829989055089384
0.562,2910,"[[799, 1055], [88, 968]]",799,88,1055,88,887,2023,1854,1056,1767,1143,0.6072164948453608,0.43096008629989213,0.9007891770011274,0.4784972812654474,0.5215027187345527,0.0992108229988726,0.5829989055089384
0.563,2910,"[[799, 1055], [88, 968]]",799,88,1055,88,887,2023,1854,1056,1767,1143,0.6072164948453608,0.43096008629989213,0.9007891770011274,0.4784972812654474,0.5215027187345527,0.0992108229988726,0.5829989055089384
0.564,2910,"[[799, 1054], [88, 969]]",799,88,1054,88,887,2023,1853,1057,1768,1142,0.6075601374570446,0.43119266055045874,0.9007891770011274,0.4789915966386555,0.5210084033613446,0.0992108229988726,0.5832116788321168
0.565,2910,"[[798, 1053], [89, 970]]",798,89,1053,89,887,2023,1851,1059,1768,1142,0.6075601374570446,0.43111831442463533,0.8996617812852311,0.4794859120118636,0.5205140879881365,0.10033821871476889,0.5829072315558802
0.566,2910,"[[798, 1053], [89, 970]]",798,89,1053,89,887,2023,1851,1059,1768,1142,0.6075601374570446,0.43111831442463533,0.8996617812852311,0.4794859120118636,0.5205140879881365,0.10033821871476889,0.5829072315558802
0.567,2910,"[[798, 1053], [89, 970]]",798,89,1053,89,887,2023,1851,1059,1768,1142,0.6075601374570446,0.43111831442463533,0.8996617812852311,0.4794859120118636,0.5205140879881365,0.10033821871476889,0.5829072315558802
0.568,2910,"[[798, 1053], [89, 970]]",798,89,1053,89,887,2023,1851,1059,1768,1142,0.6075601374570446,0.43111831442463533,0.8996617812852311,0.4794859120118636,0.5205140879881365,0.10033821871476889,0.5829072315558802
0.569,2910,"[[798, 1053], [89, 970]]",798,89,1053,89,887,2023,1851,1059,1768,1142,0.6075601374570446,0.43111831442463533,0.8996617812852311,0.4794859120118636,0.5205140879881365,0.10033821871476889,0.5829072315558802
0.57,2910,"[[798, 1052], [89, 971]]",798,89,1052,89,887,2023,1850,1060,1769,1141,0.6079037800687285,0.43135135135135133,0.8996617812852311,0.4799802273850717,0.5200197726149284,0.10033821871476889,0.5831202046035806
0.571,2910,"[[798, 1052], [89, 971]]",798,89,1052,89,887,2023,1850,1060,1769,1141,0.6079037800687285,0.43135135135135133,0.8996617812852311,0.4799802273850717,0.5200197726149284,0.10033821871476889,0.5831202046035806
0.572,2910,"[[798, 1052], [89, 971]]",798,89,1052,89,887,2023,1850,1060,1769,1141,0.6079037800687285,0.43135135135135133,0.8996617812852311,0.4799802273850717,0.5200197726149284,0.10033821871476889,0.5831202046035806
0.573,2910,"[[798, 1051], [89, 972]]",798,89,1051,89,887,2023,1849,1061,1770,1140,0.6082474226804123,0.43158464034613303,0.8996617812852311,0.4804745427582798,0.5195254572417202,0.10033821871476889,0.5833333333333334
0.574,2910,"[[798, 1051], [89, 972]]",798,89,1051,89,887,2023,1849,1061,1770,1140,0.6082474226804123,0.43158464034613303,0.8996617812852311,0.4804745427582798,0.5195254572417202,0.10033821871476889,0.5833333333333334
0.575,2910,"[[797, 1051], [90, 972]]",797,90,1051,90,887,2023,1848,1062,1769,1141,0.6079037800687285,0.43127705627705626,0.8985343855693348,0.4804745427582798,0.5195254572417202,0.10146561443066517,0.5828153564899451
0.576,2910,"[[797, 1051], [90, 972]]",797,90,1051,90,887,2023,1848,1062,1769,1141,0.6079037800687285,0.43127705627705626,0.8985343855693348,0.4804745427582798,0.5195254572417202,0.10146561443066517,0.5828153564899451
0.577,2910,"[[797, 1049], [90, 974]]",797,90,1049,90,887,2023,1846,1064,1771,1139,0.6085910652920962,0.43174431202600216,0.8985343855693348,0.481463173504696,0.518536826495304,0.10146561443066517,0.5832418587632638
0.578,2910,"[[797, 1048], [90, 975]]",797,90,1048,90,887,2023,1845,1065,1772,1138,0.60893470790378,0.43197831978319784,0.8985343855693348,0.4819574888779041,0.5180425111220959,0.10146561443066517,0.5834553440702781
0.579,2910,"[[797, 1048], [90, 975]]",797,90,1048,90,887,2023,1845,1065,1772,1138,0.60893470790378,0.43197831978319784,0.8985343855693348,0.4819574888779041,0.5180425111220959,0.10146561443066517,0.5834553440702781
0.58,2910,"[[797, 1048], [90, 975]]",797,90,1048,90,887,2023,1845,1065,1772,1138,0.60893470790378,0.43197831978319784,0.8985343855693348,0.4819574888779041,0.5180425111220959,0.10146561443066517,0.5834553440702781
0.581,2910,"[[796, 1048], [91, 975]]",796,91,1048,91,887,2023,1844,1066,1771,1139,0.6085910652920962,0.4316702819956616,0.8974069898534386,0.4819574888779041,0.5180425111220959,0.10259301014656144,0.5829366532405712
0.582,2910,"[[796, 1046], [91, 977]]",796,91,1046,91,887,2023,1842,1068,1773,1137,0.6092783505154639,0.43213897937024975,0.8974069898534386,0.4829461196243203,0.5170538803756797,0.10259301014656144,0.5833638695492854
0.583,2910,"[[796, 1046], [91, 977]]",796,91,1046,91,887,2023,1842,1068,1773,1137,0.6092783505154639,0.43213897937024975,0.8974069898534386,0.4829461196243203,0.5170538803756797,0.10259301014656144,0.5833638695492854
0.584,2910,"[[795, 1045], [92, 978]]",795,92,1045,92,887,2023,1840,1070,1773,1137,0.6092783505154639,0.4320652173913043,0.8962795941375423,0.4834404349975284,0.5165595650024716,0.10372040586245772,0.5830583058305829
0.585,2910,"[[795, 1045], [92, 978]]",795,92,1045,92,887,2023,1840,1070,1773,1137,0.6092783505154639,0.4320652173913043,0.8962795941375423,0.4834404349975284,0.5165595650024716,0.10372040586245772,0.5830583058305829
0.586,2910,"[[795, 1043], [92, 980]]",795,92,1043,92,887,2023,1838,1072,1775,1135,0.6099656357388317,0.4325353645266594,0.8962795941375423,0.4844290657439446,0.5155709342560554,0.10372040586245772,0.5834862385321101
0.587,2910,"[[795, 1043], [92, 980]]",795,92,1043,92,887,2023,1838,1072,1775,1135,0.6099656357388317,0.4325353645266594,0.8962795941375423,0.4844290657439446,0.5155709342560554,0.10372040586245772,0.5834862385321101
0.588,2910,"[[794, 1043], [93, 980]]",794,93,1043,93,887,2023,1837,1073,1774,1136,0.6096219931271478,0.432226456178552,0.895152198421646,0.4844290657439446,0.5155709342560554,0.10484780157835401,0.5829662261380323
0.589,2910,"[[793, 1043], [94, 980]]",793,94,1043,94,887,2023,1836,1074,1773,1137,0.6092783505154639,0.43191721132897604,0.8940248027057497,0.4844290657439446,0.5155709342560554,0.10597519729425028,0.5824458318031582
0.59,2910,"[[793, 1041], [94, 982]]",793,94,1041,94,887,2023,1834,1076,1775,1135,0.6099656357388317,0.4323882224645583,0.8940248027057497,0.4854176964903609,0.5145823035096392,0.10597519729425028,0.5828739434031606
0.591,2910,"[[793, 1041], [94, 982]]",793,94,1041,94,887,2023,1834,1076,1775,1135,0.6099656357388317,0.4323882224645583,0.8940248027057497,0.4854176964903609,0.5145823035096392,0.10597519729425028,0.5828739434031606
0.592,2910,"[[793, 1040], [94, 983]]",793,94,1040,94,887,2023,1833,1077,1776,1134,0.6103092783505155,0.4326241134751773,0.8940248027057497,0.48591201186356897,0.5140879881364311,0.10597519729425028,0.5830882352941177
0.593,2910,"[[793, 1039], [94, 984]]",793,94,1039,94,887,2023,1832,1078,1777,1133,0.6106529209621994,0.4328602620087336,0.8940248027057497,0.48640632723677707,0.513593672763223,0.10597519729425028,0.5833026848105921
0.594,2910,"[[792, 1039], [95, 984]]",792,95,1039,95,887,2023,1831,1079,1776,1134,0.6103092783505155,0.4325505188421628,0.8928974069898534,0.48640632723677707,0.513593672763223,0.10710259301014656,0.5827814569536424
0.595,2910,"[[792, 1038], [95, 985]]",792,95,1038,95,887,2023,1830,1080,1777,1133,0.6106529209621994,0.43278688524590164,0.8928974069898534,0.48690064260998517,0.5130993573900148,0.10710259301014656,0.582995951417004
0.596,2910,"[[792, 1037], [95, 986]]",792,95,1037,95,887,2023,1829,1081,1778,1132,0.6109965635738832,0.4330235101148168,0.8928974069898534,0.48739495798319327,0.5126050420168067,0.10710259301014656,0.5832106038291605
0.597,2910,"[[792, 1036], [95, 987]]",792,95,1036,95,887,2023,1828,1082,1779,1131,0.6113402061855671,0.43326039387308535,0.8928974069898534,0.48788927335640137,0.5121107266435986,0.10710259301014656,0.5834254143646409
0.598,2910,"[[792, 1035], [95, 988]]",792,95,1035,95,887,2023,1827,1083,1780,1130,0.6116838487972509,0.43349753694581283,0.8928974069898534,0.48838358872960946,0.5116164112703905,0.10710259301014656,0.5836403831982315
0.599,2910,"[[792, 1035], [95, 988]]",792,95,1035,95,887,2023,1827,1083,1780,1130,0.6116838487972509,0.43349753694581283,0.8928974069898534,0.48838358872960946,0.5116164112703905,0.10710259301014656,0.5836403831982315
0.6,2910,"[[792, 1035], [95, 988]]",792,95,1035,95,887,2023,1827,1083,1780,1130,0.6116838487972509,0.43349753694581283,0.8928974069898534,0.48838358872960946,0.5116164112703905,0.10710259301014656,0.5836403831982315
0.601,2910,"[[792, 1034], [95, 989]]",792,95,1034,95,887,2023,1826,1084,1781,1129,0.6120274914089348,0.43373493975903615,0.8928974069898534,0.4888779041028176,0.5111220958971824,0.10710259301014656,0.5838555105049761
0.602,2910,"[[792, 1033], [95, 990]]",792,95,1033,95,887,2023,1825,1085,1782,1128,0.6123711340206186,0.43397260273972604,0.8928974069898534,0.4893722194760257,0.5106277805239743,0.10710259301014656,0.584070796460177
0.603,2910,"[[792, 1033], [95, 990]]",792,95,1033,95,887,2023,1825,1085,1782,1128,0.6123711340206186,0.43397260273972604,0.8928974069898534,0.4893722194760257,0.5106277805239743,0.10710259301014656,0.584070796460177
0.604,2910,"[[792, 1031], [95, 992]]",792,95,1031,95,887,2023,1823,1087,1784,1126,0.6130584192439863,0.4344487109160724,0.8928974069898534,0.4903608502224419,0.5096391497775581,0.10710259301014656,0.5845018450184502
0.605,2910,"[[791, 1031], [96, 992]]",791,96,1031,96,887,2023,1822,1088,1783,1127,0.6127147766323024,0.4341383095499451,0.8917700112739572,0.4903608502224419,0.5096391497775581,0.10822998872604284,0.5839793281653747
0.606,2910,"[[791, 1031], [96, 992]]",791,96,1031,96,887,2023,1822,1088,1783,1127,0.6127147766323024,0.4341383095499451,0.8917700112739572,0.4903608502224419,0.5096391497775581,0.10822998872604284,0.5839793281653747
0.607,2910,"[[791, 1029], [96, 994]]",791,96,1029,96,887,2023,1820,1090,1785,1125,0.6134020618556701,0.4346153846153846,0.8917700112739572,0.4913494809688581,0.5086505190311419,0.10822998872604284,0.5844107868489101
0.608,2910,"[[791, 1028], [96, 995]]",791,96,1028,96,887,2023,1819,1091,1786,1124,0.613745704467354,0.4348543155579989,0.8917700112739572,0.49184379634206626,0.5081562036579338,0.10822998872604284,0.5846267553584628
0.609,2910,"[[791, 1027], [96, 996]]",791,96,1027,96,887,2023,1818,1092,1787,1123,0.6140893470790378,0.4350935093509351,0.8917700112739572,0.49233811171527436,0.5076618882847257,0.10822998872604284,0.5848428835489834
0.61,2910,"[[791, 1027], [96, 996]]",791,96,1027,96,887,2023,1818,1092,1787,1123,0.6140893470790378,0.4350935093509351,0.8917700112739572,0.49233811171527436,0.5076618882847257,0.10822998872604284,0.5848428835489834
0.611,2910,"[[791, 1027], [96, 996]]",791,96,1027,96,887,2023,1818,1092,1787,1123,0.6140893470790378,0.4350935093509351,0.8917700112739572,0.49233811171527436,0.5076618882847257,0.10822998872604284,0.5848428835489834
0.612,2910,"[[791, 1027], [96, 996]]",791,96,1027,96,887,2023,1818,1092,1787,1123,0.6140893470790378,0.4350935093509351,0.8917700112739572,0.49233811171527436,0.5076618882847257,0.10822998872604284,0.5848428835489834
0.613,2910,"[[791, 1026], [96, 997]]",791,96,1026,96,887,2023,1817,1093,1788,1122,0.6144329896907217,0.4353329664281783,0.8917700112739572,0.49283242708848246,0.5071675729115176,0.10822998872604284,0.5850591715976331
0.614,2910,"[[791, 1026], [96, 997]]",791,96,1026,96,887,2023,1817,1093,1788,1122,0.6144329896907217,0.4353329664281783,0.8917700112739572,0.49283242708848246,0.5071675729115176,0.10822998872604284,0.5850591715976331
0.615,2910,"[[791, 1026], [96, 997]]",791,96,1026,96,887,2023,1817,1093,1788,1122,0.6144329896907217,0.4353329664281783,0.8917700112739572,0.49283242708848246,0.5071675729115176,0.10822998872604284,0.5850591715976331
0.616,2910,"[[791, 1026], [96, 997]]",791,96,1026,96,887,2023,1817,1093,1788,1122,0.6144329896907217,0.4353329664281783,0.8917700112739572,0.49283242708848246,0.5071675729115176,0.10822998872604284,0.5850591715976331
0.617,2910,"[[790, 1025], [97, 998]]",790,97,1025,97,887,2023,1815,1095,1788,1122,0.6144329896907217,0.43526170798898073,0.8906426155580609,0.49332674246169056,0.5066732575383095,0.10935738444193913,0.5847520355292376
0.618,2910,"[[790, 1025], [97, 998]]",790,97,1025,97,887,2023,1815,1095,1788,1122,0.6144329896907217,0.43526170798898073,0.8906426155580609,0.49332674246169056,0.5066732575383095,0.10935738444193913,0.5847520355292376
0.619,2910,"[[790, 1025], [97, 998]]",790,97,1025,97,887,2023,1815,1095,1788,1122,0.6144329896907217,0.43526170798898073,0.8906426155580609,0.49332674246169056,0.5066732575383095,0.10935738444193913,0.5847520355292376
0.62,2910,"[[790, 1025], [97, 998]]",790,97,1025,97,887,2023,1815,1095,1788,1122,0.6144329896907217,0.43526170798898073,0.8906426155580609,0.49332674246169056,0.5066732575383095,0.10935738444193913,0.5847520355292376
0.621,2910,"[[790, 1025], [97, 998]]",790,97,1025,97,887,2023,1815,1095,1788,1122,0.6144329896907217,0.43526170798898073,0.8906426155580609,0.49332674246169056,0.5066732575383095,0.10935738444193913,0.5847520355292376
0.622,2910,"[[790, 1025], [97, 998]]",790,97,1025,97,887,2023,1815,1095,1788,1122,0.6144329896907217,0.43526170798898073,0.8906426155580609,0.49332674246169056,0.5066732575383095,0.10935738444193913,0.5847520355292376
0.623,2910,"[[790, 1024], [97, 999]]",790,97,1024,97,887,2023,1814,1096,1789,1121,0.6147766323024055,0.4355016538037486,0.8906426155580609,0.49382105783489866,0.5061789421651013,0.10935738444193913,0.5849685301740096
0.624,2910,"[[790, 1023], [97, 1000]]",790,97,1023,97,887,2023,1813,1097,1790,1120,0.6151202749140894,0.43574186431329287,0.8906426155580609,0.49431537320810676,0.5056846267918932,0.10935738444193913,0.5851851851851851
0.625,2910,"[[789, 1022], [98, 1001]]",789,98,1022,98,887,2023,1811,1099,1790,1120,0.6151202749140894,0.43567090005521814,0.8895152198421646,0.49480968858131485,0.5051903114186851,0.1104847801578354,0.5848776871756858
0.626,2910,"[[788, 1022], [99, 1001]]",788,99,1022,99,887,2023,1810,1100,1789,1121,0.6147766323024055,0.4353591160220994,0.8883878241262683,0.49480968858131485,0.5051903114186851,0.11161217587373168,0.5843529847979236
0.627,2910,"[[788, 1021], [99, 1002]]",788,99,1021,99,887,2023,1809,1101,1790,1120,0.6151202749140894,0.435599778883361,0.8883878241262683,0.495304003954523,0.504695996045477,0.11161217587373168,0.5845697329376855
0.628,2910,"[[788, 1021], [99, 1002]]",788,99,1021,99,887,2023,1809,1101,1790,1120,0.6151202749140894,0.435599778883361,0.8883878241262683,0.495304003954523,0.504695996045477,0.11161217587373168,0.5845697329376855
0.629,2910,"[[788, 1020], [99, 1003]]",788,99,1020,99,887,2023,1808,1102,1791,1119,0.6154639175257732,0.4358407079646018,0.8883878241262683,0.4957983193277311,0.5042016806722689,0.11161217587373168,0.584786641929499
0.63,2910,"[[788, 1019], [99, 1004]]",788,99,1019,99,887,2023,1807,1103,1792,1118,0.6158075601374571,0.436081903707803,0.8883878241262683,0.4962926347009392,0.5037073652990608,0.11161217587373168,0.5850037119524869
0.631,2910,"[[788, 1018], [99, 1005]]",788,99,1018,99,887,2023,1806,1104,1793,1117,0.6161512027491409,0.4363233665559247,0.8883878241262683,0.4967869500741473,0.5032130499258527,0.11161217587373168,0.5852209431860378
0.632,2910,"[[788, 1014], [99, 1009]]",788,99,1014,99,887,2023,1802,1108,1797,1113,0.6175257731958763,0.43729189789123196,0.8883878241262683,0.49876421156697975,0.5012357884330203,0.11161217587373168,0.5860914838229825
0.633,2910,"[[788, 1013], [99, 1010]]",788,99,1013,99,887,2023,1801,1109,1798,1112,0.6178694158075602,0.43753470294280955,0.8883878241262683,0.49925852694018785,0.5007414730598122,0.11161217587373168,0.5863095238095238
0.634,2910,"[[788, 1013], [99, 1010]]",788,99,1013,99,887,2023,1801,1109,1798,1112,0.6178694158075602,0.43753470294280955,0.8883878241262683,0.49925852694018785,0.5007414730598122,0.11161217587373168,0.5863095238095238
0.635,2910,"[[787, 1012], [100, 1011]]",787,100,1012,100,887,2023,1799,1111,1798,1112,0.6178694158075602,0.43746525847693163,0.887260428410372,0.49975284231339595,0.5002471576866041,0.11273957158962795,0.5860014892032762
0.636,2910,"[[787, 1012], [100, 1011]]",787,100,1012,100,887,2023,1799,1111,1798,1112,0.6178694158075602,0.43746525847693163,0.887260428410372,0.49975284231339595,0.5002471576866041,0.11273957158962795,0.5860014892032762
0.637,2910,"[[787, 1010], [100, 1013]]",787,100,1010,100,887,2023,1797,1113,1800,1110,0.6185567010309279,0.43795214245965497,0.887260428410372,0.5007414730598122,0.49925852694018785,0.11273957158962795,0.5864381520119225
0.638,2910,"[[787, 1010], [100, 1013]]",787,100,1010,100,887,2023,1797,1113,1800,1110,0.6185567010309279,0.43795214245965497,0.887260428410372,0.5007414730598122,0.49925852694018785,0.11273957158962795,0.5864381520119225
0.639,2910,"[[787, 1010], [100, 1013]]",787,100,1010,100,887,2023,1797,1113,1800,1110,0.6185567010309279,0.43795214245965497,0.887260428410372,0.5007414730598122,0.49925852694018785,0.11273957158962795,0.5864381520119225
0.64,2910,"[[787, 1010], [100, 1013]]",787,100,1010,100,887,2023,1797,1113,1800,1110,0.6185567010309279,0.43795214245965497,0.887260428410372,0.5007414730598122,0.49925852694018785,0.11273957158962795,0.5864381520119225
0.641,2910,"[[787, 1010], [100, 1013]]",787,100,1010,100,887,2023,1797,1113,1800,1110,0.6185567010309279,0.43795214245965497,0.887260428410372,0.5007414730598122,0.49925852694018785,0.11273957158962795,0.5864381520119225
0.642,2910,"[[787, 1008], [100, 1015]]",787,100,1008,100,887,2023,1795,1115,1802,1108,0.6192439862542956,0.4384401114206128,0.887260428410372,0.5017301038062284,0.4982698961937716,0.11273957158962795,0.586875466070097
0.643,2910,"[[787, 1007], [100, 1016]]",787,100,1007,100,887,2023,1794,1116,1803,1107,0.6195876288659794,0.43868450390189523,0.887260428410372,0.5022244191794365,0.4977755808205635,0.11273957158962795,0.587094367773219
0.644,2910,"[[787, 1007], [100, 1016]]",787,100,1007,100,887,2023,1794,1116,1803,1107,0.6195876288659794,0.43868450390189523,0.887260428410372,0.5022244191794365,0.4977755808205635,0.11273957158962795,0.587094367773219
0.645,2910,"[[786, 1007], [101, 1016]]",786,101,1007,101,887,2023,1793,1117,1802,1108,0.6192439862542956,0.43837144450641385,0.8861330326944757,0.5022244191794365,0.4977755808205635,0.11386696730552424,0.5865671641791045
0.646,2910,"[[786, 1007], [101, 1016]]",786,101,1007,101,887,2023,1793,1117,1802,1108,0.6192439862542956,0.43837144450641385,0.8861330326944757,0.5022244191794365,0.4977755808205635,0.11386696730552424,0.5865671641791045
0.647,2910,"[[786, 1007], [101, 1016]]",786,101,1007,101,887,2023,1793,1117,1802,1108,0.6192439862542956,0.43837144450641385,0.8861330326944757,0.5022244191794365,0.4977755808205635,0.11386696730552424,0.5865671641791045
0.648,2910,"[[786, 1006], [101, 1017]]",786,101,1006,101,887,2023,1792,1118,1803,1107,0.6195876288659794,0.43861607142857145,0.8861330326944757,0.5027187345526446,0.4972812654473554,0.11386696730552424,0.5867861142217246
0.649,2910,"[[785, 1005], [102, 1018]]",785,102,1005,102,887,2023,1790,1120,1803,1107,0.6195876288659794,0.43854748603351956,0.8850056369785795,0.5032130499258527,0.4967869500741473,0.11499436302142052,0.5864774000747105
0.65,2910,"[[785, 1003], [102, 1020]]",785,102,1003,102,887,2023,1788,1122,1805,1105,0.6202749140893471,0.43903803131991054,0.8850056369785795,0.5042016806722689,0.4957983193277311,0.11499436302142052,0.5869158878504673
0.651,2910,"[[784, 1002], [103, 1021]]",784,103,1002,103,887,2023,1786,1124,1805,1105,0.6202749140893471,0.43896976483762595,0.8838782412626832,0.504695996045477,0.495304003954523,0.1161217587373168,0.586606808829031
0.652,2910,"[[784, 1002], [103, 1021]]",784,103,1002,103,887,2023,1786,1124,1805,1105,0.6202749140893471,0.43896976483762595,0.8838782412626832,0.504695996045477,0.495304003954523,0.1161217587373168,0.586606808829031
0.653,2910,"[[784, 1002], [103, 1021]]",784,103,1002,103,887,2023,1786,1124,1805,1105,0.6202749140893471,0.43896976483762595,0.8838782412626832,0.504695996045477,0.495304003954523,0.1161217587373168,0.586606808829031
0.654,2910,"[[784, 1002], [103, 1021]]",784,103,1002,103,887,2023,1786,1124,1805,1105,0.6202749140893471,0.43896976483762595,0.8838782412626832,0.504695996045477,0.495304003954523,0.1161217587373168,0.586606808829031
0.655,2910,"[[784, 1002], [103, 1021]]",784,103,1002,103,887,2023,1786,1124,1805,1105,0.6202749140893471,0.43896976483762595,0.8838782412626832,0.504695996045477,0.495304003954523,0.1161217587373168,0.586606808829031
0.656,2910,"[[784, 1001], [103, 1022]]",784,103,1001,103,887,2023,1785,1125,1806,1104,0.6206185567010309,0.4392156862745098,0.8838782412626832,0.5051903114186851,0.49480968858131485,0.1161217587373168,0.5868263473053892
0.657,2910,"[[784, 1001], [103, 1022]]",784,103,1001,103,887,2023,1785,1125,1806,1104,0.6206185567010309,0.4392156862745098,0.8838782412626832,0.5051903114186851,0.49480968858131485,0.1161217587373168,0.5868263473053892
0.658,2910,"[[784, 1000], [103, 1023]]",784,103,1000,103,887,2023,1784,1126,1807,1103,0.6209621993127148,0.43946188340807174,0.8838782412626832,0.5056846267918932,0.49431537320810676,0.1161217587373168,0.5870460501684761
0.659,2910,"[[784, 1000], [103, 1023]]",784,103,1000,103,887,2023,1784,1126,1807,1103,0.6209621993127148,0.43946188340807174,0.8838782412626832,0.5056846267918932,0.49431537320810676,0.1161217587373168,0.5870460501684761
0.66,2910,"[[783, 998], [104, 1025]]",783,104,998,104,887,2023,1781,1129,1808,1102,0.6213058419243986,0.43964065131948343,0.882750845546787,0.5066732575383095,0.49332674246169056,0.11724915445321307,0.5869565217391304
0.661,2910,"[[783, 998], [104, 1025]]",783,104,998,104,887,2023,1781,1129,1808,1102,0.6213058419243986,0.43964065131948343,0.882750845546787,0.5066732575383095,0.49332674246169056,0.11724915445321307,0.5869565217391304
0.662,2910,"[[783, 996], [104, 1027]]",783,104,996,104,887,2023,1779,1131,1810,1100,0.6219931271477663,0.44013490725126475,0.882750845546787,0.5076618882847257,0.49233811171527436,0.11724915445321307,0.5873968492123031
0.663,2910,"[[783, 995], [104, 1028]]",783,104,995,104,887,2023,1778,1132,1811,1099,0.6223367697594502,0.4403824521934758,0.882750845546787,0.5081562036579338,0.49184379634206626,0.11724915445321307,0.5876172607879926
0.664,2910,"[[783, 992], [104, 1031]]",783,104,992,104,887,2023,1775,1135,1814,1096,0.6233676975945017,0.4411267605633803,0.882750845546787,0.5096391497775581,0.4903608502224419,0.11724915445321307,0.5882794891059354
0.665,2910,"[[783, 992], [104, 1031]]",783,104,992,104,887,2023,1775,1135,1814,1096,0.6233676975945017,0.4411267605633803,0.882750845546787,0.5096391497775581,0.4903608502224419,0.11724915445321307,0.5882794891059354
0.666,2910,"[[783, 992], [104, 1031]]",783,104,992,104,887,2023,1775,1135,1814,1096,0.6233676975945017,0.4411267605633803,0.882750845546787,0.5096391497775581,0.4903608502224419,0.11724915445321307,0.5882794891059354
0.667,2910,"[[783, 990], [104, 1033]]",783,104,990,104,887,2023,1773,1137,1816,1094,0.6240549828178694,0.4416243654822335,0.882750845546787,0.5106277805239743,0.4893722194760257,0.11724915445321307,0.5887218045112783
0.668,2910,"[[783, 989], [104, 1034]]",783,104,989,104,887,2023,1772,1138,1817,1093,0.6243986254295533,0.44187358916478553,0.882750845546787,0.5111220958971824,0.4888779041028176,0.11724915445321307,0.5889432117337344
0.669,2910,"[[783, 989], [104, 1034]]",783,104,989,104,887,2023,1772,1138,1817,1093,0.6243986254295533,0.44187358916478553,0.882750845546787,0.5111220958971824,0.4888779041028176,0.11724915445321307,0.5889432117337344
0.67,2910,"[[783, 987], [104, 1036]]",783,104,987,104,887,2023,1770,1140,1819,1091,0.625085910652921,0.4423728813559322,0.882750845546787,0.5121107266435986,0.48788927335640137,0.11724915445321307,0.5893865261573203
0.671,2910,"[[783, 985], [104, 1038]]",783,104,985,104,887,2023,1768,1142,1821,1089,0.6257731958762887,0.4428733031674208,0.882750845546787,0.5130993573900148,0.48690064260998517,0.11724915445321307,0.5898305084745762
0.672,2910,"[[783, 985], [104, 1038]]",783,104,985,104,887,2023,1768,1142,1821,1089,0.6257731958762887,0.4428733031674208,0.882750845546787,0.5130993573900148,0.48690064260998517,0.11724915445321307,0.5898305084745762
0.673,2910,"[[783, 985], [104, 1038]]",783,104,985,104,887,2023,1768,1142,1821,1089,0.6257731958762887,0.4428733031674208,0.882750845546787,0.5130993573900148,0.48690064260998517,0.11724915445321307,0.5898305084745762
0.674,2910,"[[783, 984], [104, 1039]]",783,104,984,104,887,2023,1767,1143,1822,1088,0.6261168384879725,0.4431239388794567,0.882750845546787,0.513593672763223,0.48640632723677707,0.11724915445321307,0.5900527505651847
0.675,2910,"[[782, 984], [105, 1039]]",782,105,984,105,887,2023,1766,1144,1821,1089,0.6257731958762887,0.44280860702151753,0.8816234498308907,0.513593672763223,0.48640632723677707,0.11837655016910936,0.5895212966453072
0.676,2910,"[[781, 984], [106, 1039]]",781,106,984,106,887,2023,1765,1145,1820,1090,0.6254295532646048,0.4424929178470255,0.8804960541149943,0.513593672763223,0.48640632723677707,0.11950394588500564,0.5889894419306184
0.677,2910,"[[780, 983], [107, 1040]]",780,107,983,107,887,2023,1763,1147,1820,1090,0.6254295532646048,0.4424276800907544,0.8793686583990981,0.5140879881364311,0.48591201186356897,0.12063134160090191,0.5886792452830187
0.678,2910,"[[780, 983], [107, 1040]]",780,107,983,107,887,2023,1763,1147,1820,1090,0.6254295532646048,0.4424276800907544,0.8793686583990981,0.5140879881364311,0.48591201186356897,0.12063134160090191,0.5886792452830187
0.679,2910,"[[779, 982], [108, 1041]]",779,108,982,108,887,2023,1761,1149,1820,1090,0.6254295532646048,0.44236229415105055,0.8782412626832018,0.5145823035096392,0.4854176964903609,0.12175873731679819,0.588368580060423
0.68,2910,"[[779, 981], [108, 1042]]",779,108,981,108,887,2023,1760,1150,1821,1089,0.6257731958762887,0.4426136363636364,0.8782412626832018,0.5150766188828473,0.4849233811171527,0.12175873731679819,0.5885908575746128
0.681,2910,"[[778, 980], [109, 1043]]",778,109,980,109,887,2023,1758,1152,1821,1089,0.6257731958762887,0.44254835039817975,0.8771138669673055,0.5155709342560554,0.4844290657439446,0.12288613303269448,0.5882797731568998
0.682,2910,"[[778, 979], [109, 1044]]",778,109,979,109,887,2023,1757,1153,1822,1088,0.6261168384879725,0.4428002276607854,0.8771138669673055,0.5160652496292635,0.4839347503707365,0.12288613303269448,0.5885022692889561
0.683,2910,"[[778, 979], [109, 1044]]",778,109,979,109,887,2023,1757,1153,1822,1088,0.6261168384879725,0.4428002276607854,0.8771138669673055,0.5160652496292635,0.4839347503707365,0.12288613303269448,0.5885022692889561
0.684,2910,"[[778, 977], [109, 1046]]",778,109,977,109,887,2023,1755,1155,1824,1086,0.6268041237113402,0.4433048433048433,0.8771138669673055,0.5170538803756797,0.4829461196243203,0.12288613303269448,0.5889477668433006
0.685,2910,"[[778, 977], [109, 1046]]",778,109,977,109,887,2023,1755,1155,1824,1086,0.6268041237113402,0.4433048433048433,0.8771138669673055,0.5170538803756797,0.4829461196243203,0.12288613303269448,0.5889477668433006
0.686,2910,"[[778, 976], [109, 1047]]",778,109,976,109,887,2023,1754,1156,1825,1085,0.627147766323024,0.443557582668187,0.8771138669673055,0.5175481957488878,0.4824518042511122,0.12288613303269448,0.5891707686482394
0.687,2910,"[[778, 976], [109, 1047]]",778,109,976,109,887,2023,1754,1156,1825,1085,0.627147766323024,0.443557582668187,0.8771138669673055,0.5175481957488878,0.4824518042511122,0.12288613303269448,0.5891707686482394
0.688,2910,"[[777, 974], [110, 1049]]",777,110,974,110,887,2023,1751,1159,1826,1084,0.6274914089347079,0.4437464306110794,0.8759864712514093,0.518536826495304,0.481463173504696,0.12401352874859076,0.5890826383623958
0.689,2910,"[[777, 974], [110, 1049]]",777,110,974,110,887,2023,1751,1159,1826,1084,0.6274914089347079,0.4437464306110794,0.8759864712514093,0.518536826495304,0.481463173504696,0.12401352874859076,0.5890826383623958
0.69,2910,"[[777, 974], [110, 1049]]",777,110,974,110,887,2023,1751,1159,1826,1084,0.6274914089347079,0.4437464306110794,0.8759864712514093,0.518536826495304,0.481463173504696,0.12401352874859076,0.5890826383623958
0.691,2910,"[[777, 974], [110, 1049]]",777,110,974,110,887,2023,1751,1159,1826,1084,0.6274914089347079,0.4437464306110794,0.8759864712514093,0.518536826495304,0.481463173504696,0.12401352874859076,0.5890826383623958
0.692,2910,"[[777, 974], [110, 1049]]",777,110,974,110,887,2023,1751,1159,1826,1084,0.6274914089347079,0.4437464306110794,0.8759864712514093,0.518536826495304,0.481463173504696,0.12401352874859076,0.5890826383623958
0.693,2910,"[[776, 974], [111, 1049]]",776,111,974,111,887,2023,1750,1160,1825,1085,0.627147766323024,0.44342857142857145,0.874859075535513,0.518536826495304,0.481463173504696,0.12514092446448705,0.5885475919605613
0.694,2910,"[[776, 973], [111, 1050]]",776,111,973,111,887,2023,1749,1161,1826,1084,0.6274914089347079,0.44368210405946257,0.874859075535513,0.5190311418685121,0.4809688581314879,0.12514092446448705,0.5887708649468892
0.695,2910,"[[776, 972], [111, 1051]]",776,111,972,111,887,2023,1748,1162,1827,1083,0.6278350515463917,0.4439359267734554,0.874859075535513,0.5195254572417202,0.4804745427582798,0.12514092446448705,0.5889943074003796
0.696,2910,"[[776, 972], [111, 1051]]",776,111,972,111,887,2023,1748,1162,1827,1083,0.6278350515463917,0.4439359267734554,0.874859075535513,0.5195254572417202,0.4804745427582798,0.12514092446448705,0.5889943074003796
0.697,2910,"[[776, 970], [111, 1053]]",776,111,970,111,887,2023,1746,1164,1829,1081,0.6285223367697594,0.4444444444444444,0.874859075535513,0.5205140879881365,0.4794859120118636,0.12514092446448705,0.5894417014812001
0.698,2910,"[[776, 969], [111, 1054]]",776,111,969,111,887,2023,1745,1165,1830,1080,0.6288659793814433,0.4446991404011461,0.874859075535513,0.5210084033613446,0.4789915966386555,0.12514092446448705,0.5896656534954408
0.699,2910,"[[776, 969], [111, 1054]]",776,111,969,111,887,2023,1745,1165,1830,1080,0.6288659793814433,0.4446991404011461,0.874859075535513,0.5210084033613446,0.4789915966386555,0.12514092446448705,0.5896656534954408
0.7,2910,"[[776, 969], [111, 1054]]",776,111,969,111,887,2023,1745,1165,1830,1080,0.6288659793814433,0.4446991404011461,0.874859075535513,0.5210084033613446,0.4789915966386555,0.12514092446448705,0.5896656534954408
0.701,2910,"[[776, 969], [111, 1054]]",776,111,969,111,887,2023,1745,1165,1830,1080,0.6288659793814433,0.4446991404011461,0.874859075535513,0.5210084033613446,0.4789915966386555,0.12514092446448705,0.5896656534954408
0.702,2910,"[[775, 969], [112, 1054]]",775,112,969,112,887,2023,1744,1166,1829,1081,0.6285223367697594,0.44438073394495414,0.8737316798196166,0.5210084033613446,0.4789915966386555,0.1262683201803833,0.5891296085138731
0.703,2910,"[[775, 969], [112, 1054]]",775,112,969,112,887,2023,1744,1166,1829,1081,0.6285223367697594,0.44438073394495414,0.8737316798196166,0.5210084033613446,0.4789915966386555,0.1262683201803833,0.5891296085138731
0.704,2910,"[[775, 968], [112, 1055]]",775,112,968,112,887,2023,1743,1167,1830,1080,0.6288659793814433,0.44463568559954103,0.8737316798196166,0.5215027187345527,0.4784972812654474,0.1262683201803833,0.5893536121673004
0.705,2910,"[[775, 967], [112, 1056]]",775,112,967,112,887,2023,1742,1168,1831,1079,0.6292096219931271,0.44489092996555685,0.8737316798196166,0.5219970341077608,0.47800296589223923,0.1262683201803833,0.5895777862305059
0.706,2910,"[[775, 967], [112, 1056]]",775,112,967,112,887,2023,1742,1168,1831,1079,0.6292096219931271,0.44489092996555685,0.8737316798196166,0.5219970341077608,0.47800296589223923,0.1262683201803833,0.5895777862305059
0.707,2910,"[[774, 966], [113, 1057]]",774,113,966,113,887,2023,1740,1170,1831,1079,0.6292096219931271,0.44482758620689655,0.8726042841037204,0.5224913494809689,0.47750865051903113,0.1273957158962796,0.5892653216596879
0.708,2910,"[[774, 965], [113, 1058]]",774,113,965,113,887,2023,1739,1171,1832,1078,0.629553264604811,0.44508338125359403,0.8726042841037204,0.522985664854177,0.47701433514582303,0.1273957158962796,0.5894897182025894
0.709,2910,"[[774, 964], [113, 1059]]",774,113,964,113,887,2023,1738,1172,1833,1077,0.6298969072164948,0.44533947065592633,0.8726042841037204,0.5234799802273851,0.47652001977261493,0.1273957158962796,0.5897142857142856
0.71,2910,"[[774, 964], [113, 1059]]",774,113,964,113,887,2023,1738,1172,1833,1077,0.6298969072164948,0.44533947065592633,0.8726042841037204,0.5234799802273851,0.47652001977261493,0.1273957158962796,0.5897142857142856
0.711,2910,"[[774, 963], [113, 1060]]",774,113,963,113,887,2023,1737,1173,1834,1076,0.6302405498281787,0.44559585492227977,0.8726042841037204,0.5239742956005932,0.47602570439940683,0.1273957158962796,0.5899390243902438
0.712,2910,"[[774, 962], [113, 1061]]",774,113,962,113,887,2023,1736,1174,1835,1075,0.6305841924398625,0.44585253456221197,0.8726042841037204,0.5244686109738013,0.47553138902619874,0.1273957158962796,0.5901639344262295
0.713,2910,"[[774, 961], [113, 1062]]",774,113,961,113,887,2023,1735,1175,1836,1074,0.6309278350515464,0.44610951008645533,0.8726042841037204,0.5249629263470094,0.4750370736529906,0.1273957158962796,0.5903890160183067
0.714,2910,"[[774, 960], [113, 1063]]",774,113,960,113,887,2023,1734,1176,1837,1073,0.6312714776632302,0.4463667820069204,0.8726042841037204,0.5254572417202175,0.4745427582797825,0.1273957158962796,0.5906142693628386
0.715,2910,"[[774, 960], [113, 1063]]",774,113,960,113,887,2023,1734,1176,1837,1073,0.6312714776632302,0.4463667820069204,0.8726042841037204,0.5254572417202175,0.4745427582797825,0.1273957158962796,0.5906142693628386
0.716,2910,"[[774, 959], [113, 1064]]",774,113,959,113,887,2023,1733,1177,1838,1072,0.6316151202749141,0.4466243508366994,0.8726042841037204,0.5259515570934256,0.4740484429065744,0.1273957158962796,0.5908396946564886
0.717,2910,"[[774, 959], [113, 1064]]",774,113,959,113,887,2023,1733,1177,1838,1072,0.6316151202749141,0.4466243508366994,0.8726042841037204,0.5259515570934256,0.4740484429065744,0.1273957158962796,0.5908396946564886
0.718,2910,"[[773, 957], [114, 1066]]",773,114,957,114,887,2023,1730,1180,1839,1071,0.6319587628865979,0.44682080924855494,0.8714768883878241,0.5269401878398419,0.4730598121601582,0.12852311161217586,0.5907527703477263
0.719,2910,"[[773, 957], [114, 1066]]",773,114,957,114,887,2023,1730,1180,1839,1071,0.6319587628865979,0.44682080924855494,0.8714768883878241,0.5269401878398419,0.4730598121601582,0.12852311161217586,0.5907527703477263
0.72,2910,"[[772, 956], [115, 1067]]",772,115,956,115,887,2023,1728,1182,1839,1071,0.6319587628865979,0.44675925925925924,0.8703494926719278,0.52743450321305,0.4725654967869501,0.12965050732807215,0.5904397705544934
0.721,2910,"[[770, 955], [117, 1068]]",770,117,955,117,887,2023,1725,1185,1838,1072,0.6316151202749141,0.4463768115942029,0.8680947012401353,0.5279288185862581,0.472071181413742,0.1319052987598647,0.5895865237366004
0.722,2910,"[[770, 954], [117, 1069]]",770,117,954,117,887,2023,1724,1186,1839,1071,0.6319587628865979,0.4466357308584687,0.8680947012401353,0.5284231339594662,0.47157686604053384,0.1319052987598647,0.5898123324396783
0.723,2910,"[[770, 954], [117, 1069]]",770,117,954,117,887,2023,1724,1186,1839,1071,0.6319587628865979,0.4466357308584687,0.8680947012401353,0.5284231339594662,0.47157686604053384,0.1319052987598647,0.5898123324396783
0.724,2910,"[[770, 953], [117, 1070]]",770,117,953,117,887,2023,1723,1187,1840,1070,0.6323024054982818,0.4468949506674405,0.8680947012401353,0.5289174493326743,0.47108255066732574,0.1319052987598647,0.5900383141762452
0.725,2910,"[[770, 952], [117, 1071]]",770,117,952,117,887,2023,1722,1188,1841,1069,0.6326460481099656,0.44715447154471544,0.8680947012401353,0.5294117647058824,0.47058823529411764,0.1319052987598647,0.5902644691452664
0.726,2910,"[[770, 949], [117, 1074]]",770,117,949,117,887,2023,1719,1191,1844,1066,0.6336769759450172,0.447934845840605,0.8680947012401353,0.5308947108255067,0.46910528917449335,0.1319052987598647,0.5909439754412893
0.727,2910,"[[770, 949], [117, 1074]]",770,117,949,117,887,2023,1719,1191,1844,1066,0.6336769759450172,0.447934845840605,0.8680947012401353,0.5308947108255067,0.46910528917449335,0.1319052987598647,0.5909439754412893
0.728,2910,"[[768, 948], [119, 1075]]",768,119,948,119,887,2023,1716,1194,1843,1067,0.6333333333333333,0.44755244755244755,0.8658399098083427,0.5313890261987148,0.46861097380128525,0.13416009019165728,0.5900883595850941
0.729,2910,"[[767, 946], [120, 1077]]",767,120,946,120,887,2023,1713,1197,1844,1066,0.6336769759450172,0.44775248102743725,0.8647125140924464,0.532377656945131,0.467622343054869,0.13528748590755355,0.59
0.73,2910,"[[767, 945], [120, 1078]]",767,120,945,120,887,2023,1712,1198,1845,1065,0.634020618556701,0.4480140186915888,0.8647125140924464,0.532871972318339,0.4671280276816609,0.13528748590755355,0.590227010388611
0.731,2910,"[[767, 945], [120, 1078]]",767,120,945,120,887,2023,1712,1198,1845,1065,0.634020618556701,0.4480140186915888,0.8647125140924464,0.532871972318339,0.4671280276816609,0.13528748590755355,0.590227010388611
0.732,2910,"[[767, 945], [120, 1078]]",767,120,945,120,887,2023,1712,1198,1845,1065,0.634020618556701,0.4480140186915888,0.8647125140924464,0.532871972318339,0.4671280276816609,0.13528748590755355,0.590227010388611
0.733,2910,"[[767, 945], [120, 1078]]",767,120,945,120,887,2023,1712,1198,1845,1065,0.634020618556701,0.4480140186915888,0.8647125140924464,0.532871972318339,0.4671280276816609,0.13528748590755355,0.590227010388611
0.734,2910,"[[767, 943], [120, 1080]]",767,120,943,120,887,2023,1710,1200,1847,1063,0.6347079037800687,0.44853801169590646,0.8647125140924464,0.5338606030647554,0.4661393969352447,0.13528748590755355,0.5906815556411243
0.735,2910,"[[766, 943], [121, 1080]]",766,121,943,121,887,2023,1709,1201,1846,1064,0.6343642611683848,0.44821533060269164,0.8635851183765502,0.5338606030647554,0.4661393969352447,0.13641488162344984,0.5901386748844376
0.736,2910,"[[764, 943], [123, 1080]]",764,123,943,123,887,2023,1707,1203,1844,1066,0.6336769759450172,0.44756883421206795,0.8613303269447576,0.5338606030647554,0.4661393969352447,0.1386696730552424,0.5890516576715498
0.737,2910,"[[764, 942], [123, 1081]]",764,123,942,123,887,2023,1706,1204,1845,1065,0.634020618556701,0.447831184056272,0.8613303269447576,0.5343549184379635,0.4656450815620366,0.1386696730552424,0.5892788276128037
0.738,2910,"[[764, 942], [123, 1081]]",764,123,942,123,887,2023,1706,1204,1845,1065,0.634020618556701,0.447831184056272,0.8613303269447576,0.5343549184379635,0.4656450815620366,0.1386696730552424,0.5892788276128037
0.739,2910,"[[764, 939], [123, 1084]]",764,123,939,123,887,2023,1703,1207,1848,1062,0.6350515463917525,0.4486200822078685,0.8613303269447576,0.5358378645575878,0.46416213544241225,0.1386696730552424,0.5899613899613899
0.74,2910,"[[763, 937], [124, 1086]]",763,124,937,124,887,2023,1700,1210,1849,1061,0.6353951890034364,0.44882352941176473,0.8602029312288614,0.536826495304004,0.46317350469599605,0.13979706877113868,0.5898724391186703
0.741,2910,"[[762, 936], [125, 1087]]",762,125,936,125,887,2023,1698,1212,1849,1061,0.6353951890034364,0.44876325088339225,0.859075535512965,0.537320810677212,0.46267918932278795,0.14092446448703494,0.5895551257253385
0.742,2910,"[[762, 934], [125, 1089]]",762,125,934,125,887,2023,1696,1214,1851,1059,0.6360824742268041,0.4492924528301887,0.859075535512965,0.5383094414236282,0.4616905585763717,0.14092446448703494,0.5900116144018583
0.743,2910,"[[761, 934], [126, 1089]]",761,126,934,126,887,2023,1695,1215,1850,1060,0.6357388316151202,0.44896755162241886,0.8579481397970687,0.5383094414236282,0.4616905585763717,0.14205186020293123,0.5894655305964369
0.744,2910,"[[761, 934], [126, 1089]]",761,126,934,126,887,2023,1695,1215,1850,1060,0.6357388316151202,0.44896755162241886,0.8579481397970687,0.5383094414236282,0.4616905585763717,0.14205186020293123,0.5894655305964369
0.745,2910,"[[761, 934], [126, 1089]]",761,126,934,126,887,2023,1695,1215,1850,1060,0.6357388316151202,0.44896755162241886,0.8579481397970687,0.5383094414236282,0.4616905585763717,0.14205186020293123,0.5894655305964369
0.746,2910,"[[761, 932], [126, 1091]]",761,126,932,126,887,2023,1693,1217,1852,1058,0.6364261168384879,0.4494979326639102,0.8579481397970687,0.5392980721700444,0.4607019278299555,0.14205186020293123,0.5899224806201551
0.747,2910,"[[761, 932], [126, 1091]]",761,126,932,126,887,2023,1693,1217,1852,1058,0.6364261168384879,0.4494979326639102,0.8579481397970687,0.5392980721700444,0.4607019278299555,0.14205186020293123,0.5899224806201551
0.748,2910,"[[761, 931], [126, 1092]]",761,126,931,126,887,2023,1692,1218,1853,1057,0.6367697594501718,0.44976359338061467,0.8579481397970687,0.5397923875432526,0.4602076124567474,0.14205186020293123,0.5901512214036448
0.749,2910,"[[761, 930], [126, 1093]]",761,126,930,126,887,2023,1691,1219,1854,1056,0.6371134020618556,0.4500295683027794,0.8579481397970687,0.5402867029164607,0.4597132970835393,0.14205186020293123,0.5903801396431342
0.75,2910,"[[761, 927], [126, 1096]]",761,126,927,126,887,2023,1688,1222,1857,1053,0.6381443298969072,0.45082938388625593,0.8579481397970687,0.541769649036085,0.45823035096391496,0.14205186020293123,0.5910679611650484
0.751,2910,"[[761, 927], [126, 1096]]",761,126,927,126,887,2023,1688,1222,1857,1053,0.6381443298969072,0.45082938388625593,0.8579481397970687,0.541769649036085,0.45823035096391496,0.14205186020293123,0.5910679611650484
0.752,2910,"[[761, 925], [126, 1098]]",761,126,925,126,887,2023,1686,1224,1859,1051,0.6388316151202749,0.4513641755634638,0.8579481397970687,0.5427582797825012,0.45724172021749876,0.14205186020293123,0.5915273999222697
0.753,2910,"[[760, 924], [127, 1099]]",760,127,924,127,887,2023,1684,1226,1859,1051,0.6388316151202749,0.4513064133016627,0.8568207440811725,0.5432525951557093,0.45674740484429066,0.14317925591882752,0.5912096460521198
0.754,2910,"[[759, 922], [128, 1101]]",759,128,922,128,887,2023,1681,1229,1860,1050,0.6391752577319587,0.4515169541939322,0.8556933483652762,0.5442412259021255,0.45575877409787446,0.14430665163472378,0.5911214953271029
0.755,2910,"[[759, 922], [128, 1101]]",759,128,922,128,887,2023,1681,1229,1860,1050,0.6391752577319587,0.4515169541939322,0.8556933483652762,0.5442412259021255,0.45575877409787446,0.14430665163472378,0.5911214953271029
0.756,2910,"[[759, 921], [128, 1102]]",759,128,921,128,887,2023,1680,1230,1861,1049,0.6395189003436426,0.4517857142857143,0.8556933483652762,0.5447355412753336,0.4552644587246663,0.14430665163472378,0.5913517724970784
0.757,2910,"[[759, 921], [128, 1102]]",759,128,921,128,887,2023,1680,1230,1861,1049,0.6395189003436426,0.4517857142857143,0.8556933483652762,0.5447355412753336,0.4552644587246663,0.14430665163472378,0.5913517724970784
0.758,2910,"[[759, 921], [128, 1102]]",759,128,921,128,887,2023,1680,1230,1861,1049,0.6395189003436426,0.4517857142857143,0.8556933483652762,0.5447355412753336,0.4552644587246663,0.14430665163472378,0.5913517724970784
0.759,2910,"[[757, 921], [130, 1102]]",757,130,921,130,887,2023,1678,1232,1859,1051,0.6388316151202749,0.4511323003575685,0.8534385569334837,0.5447355412753336,0.4552644587246663,0.14656144306651633,0.5902534113060429
0.76,2910,"[[757, 921], [130, 1102]]",757,130,921,130,887,2023,1678,1232,1859,1051,0.6388316151202749,0.4511323003575685,0.8534385569334837,0.5447355412753336,0.4552644587246663,0.14656144306651633,0.5902534113060429
0.761,2910,"[[756, 920], [131, 1103]]",756,131,920,131,887,2023,1676,1234,1859,1051,0.6388316151202749,0.4510739856801909,0.8523111612175873,0.5452298566485417,0.4547701433514582,0.14768883878241262,0.5899336714787359
0.762,2910,"[[756, 920], [131, 1103]]",756,131,920,131,887,2023,1676,1234,1859,1051,0.6388316151202749,0.4510739856801909,0.8523111612175873,0.5452298566485417,0.4547701433514582,0.14768883878241262,0.5899336714787359
0.763,2910,"[[756, 920], [131, 1103]]",756,131,920,131,887,2023,1676,1234,1859,1051,0.6388316151202749,0.4510739856801909,0.8523111612175873,0.5452298566485417,0.4547701433514582,0.14768883878241262,0.5899336714787359
0.764,2910,"[[756, 920], [131, 1103]]",756,131,920,131,887,2023,1676,1234,1859,1051,0.6388316151202749,0.4510739856801909,0.8523111612175873,0.5452298566485417,0.4547701433514582,0.14768883878241262,0.5899336714787359
0.765,2910,"[[756, 920], [131, 1103]]",756,131,920,131,887,2023,1676,1234,1859,1051,0.6388316151202749,0.4510739856801909,0.8523111612175873,0.5452298566485417,0.4547701433514582,0.14768883878241262,0.5899336714787359
0.766,2910,"[[756, 918], [131, 1105]]",756,131,918,131,887,2023,1674,1236,1861,1049,0.6395189003436426,0.45161290322580644,0.8523111612175873,0.5462184873949579,0.453781512605042,0.14768883878241262,0.5903943771964076
0.767,2910,"[[755, 918], [132, 1105]]",755,132,918,132,887,2023,1673,1237,1860,1050,0.6391752577319587,0.4512851165570831,0.8511837655016911,0.5462184873949579,0.453781512605042,0.1488162344983089,0.58984375
0.768,2910,"[[755, 918], [132, 1105]]",755,132,918,132,887,2023,1673,1237,1860,1050,0.6391752577319587,0.4512851165570831,0.8511837655016911,0.5462184873949579,0.453781512605042,0.1488162344983089,0.58984375
0.769,2910,"[[755, 918], [132, 1105]]",755,132,918,132,887,2023,1673,1237,1860,1050,0.6391752577319587,0.4512851165570831,0.8511837655016911,0.5462184873949579,0.453781512605042,0.1488162344983089,0.58984375
0.77,2910,"[[754, 917], [133, 1106]]",754,133,917,133,887,2023,1671,1239,1860,1050,0.6391752577319587,0.4512268102932376,0.8500563697857948,0.5467128027681661,0.4532871972318339,0.14994363021420518,0.5895230648944488
0.771,2910,"[[754, 917], [133, 1106]]",754,133,917,133,887,2023,1671,1239,1860,1050,0.6391752577319587,0.4512268102932376,0.8500563697857948,0.5467128027681661,0.4532871972318339,0.14994363021420518,0.5895230648944488
0.772,2910,"[[754, 917], [133, 1106]]",754,133,917,133,887,2023,1671,1239,1860,1050,0.6391752577319587,0.4512268102932376,0.8500563697857948,0.5467128027681661,0.4532871972318339,0.14994363021420518,0.5895230648944488
0.773,2910,"[[754, 915], [133, 1108]]",754,133,915,133,887,2023,1669,1241,1862,1048,0.6398625429553264,0.4517675254643499,0.8500563697857948,0.5477014335145823,0.4522985664854177,0.14994363021420518,0.5899843505477308
0.774,2910,"[[754, 915], [133, 1108]]",754,133,915,133,887,2023,1669,1241,1862,1048,0.6398625429553264,0.4517675254643499,0.8500563697857948,0.5477014335145823,0.4522985664854177,0.14994363021420518,0.5899843505477308
0.775,2910,"[[753, 912], [134, 1111]]",753,134,912,134,887,2023,1665,1245,1864,1046,0.6405498281786941,0.45225225225225224,0.8489289740698985,0.5491843796342066,0.45081562036579337,0.15107102593010147,0.5901253918495297
0.776,2910,"[[751, 909], [136, 1114]]",751,136,909,136,887,2023,1660,1250,1865,1045,0.6408934707903781,0.45240963855421684,0.846674182638106,0.5506673257538309,0.4493326742461691,0.15332581736189402,0.5897133882999608
0.777,2910,"[[750, 909], [137, 1114]]",750,137,909,137,887,2023,1659,1251,1864,1046,0.6405498281786941,0.45207956600361665,0.8455467869222097,0.5506673257538309,0.4493326742461691,0.1544532130777903,0.5891594658287509
0.778,2910,"[[750, 908], [137, 1115]]",750,137,908,137,887,2023,1658,1252,1865,1045,0.6408934707903781,0.45235223160434257,0.8455467869222097,0.551161641127039,0.448838358872961,0.1544532130777903,0.5893909626719057
0.779,2910,"[[750, 907], [137, 1116]]",750,137,907,137,887,2023,1657,1253,1866,1044,0.6412371134020619,0.45262522631261315,0.8455467869222097,0.5516559565002471,0.4483440434997528,0.1544532130777903,0.589622641509434
0.78,2910,"[[749, 907], [138, 1116]]",749,138,907,138,887,2023,1656,1254,1865,1045,0.6408934707903781,0.4522946859903382,0.8444193912063134,0.5516559565002471,0.4483440434997528,0.1555806087936866,0.5890680298859615
0.781,2910,"[[748, 906], [139, 1117]]",748,139,906,139,887,2023,1654,1256,1865,1045,0.6408934707903781,0.45223700120918986,0.8432919954904171,0.5521502718734552,0.4478497281265447,0.15670800450958286,0.5887445887445888
0.782,2910,"[[748, 905], [139, 1118]]",748,139,905,139,887,2023,1653,1257,1866,1044,0.6412371134020619,0.45251058681185724,0.8432919954904171,0.5526445872466633,0.4473554127533366,0.15670800450958286,0.5889763779527559
0.783,2910,"[[748, 904], [139, 1119]]",748,139,904,139,887,2023,1652,1258,1867,1043,0.6415807560137458,0.45278450363196127,0.8432919954904171,0.5531389026198715,0.4468610973801285,0.15670800450958286,0.5892083497439937
0.784,2910,"[[748, 904], [139, 1119]]",748,139,904,139,887,2023,1652,1258,1867,1043,0.6415807560137458,0.45278450363196127,0.8432919954904171,0.5531389026198715,0.4468610973801285,0.15670800450958286,0.5892083497439937
0.785,2910,"[[747, 903], [140, 1120]]",747,140,903,140,887,2023,1650,1260,1867,1043,0.6415807560137458,0.4527272727272727,0.8421645997745209,0.5536332179930796,0.4463667820069204,0.15783540022547915,0.588884509262909
0.786,2910,"[[744, 900], [143, 1123]]",744,143,900,143,887,2023,1644,1266,1867,1043,0.6415807560137458,0.45255474452554745,0.8387824126268321,0.5551161641127039,0.4448838358872961,0.161217587373168,0.5879099170288424
0.787,2910,"[[743, 897], [144, 1126]]",743,144,897,144,887,2023,1640,1270,1869,1041,0.6422680412371135,0.4530487804878049,0.8376550169109357,0.5565991102323282,0.4434008897676718,0.16234498308906425,0.5880490700435299
0.788,2910,"[[743, 896], [144, 1127]]",743,144,896,144,887,2023,1639,1271,1870,1040,0.6426116838487973,0.45332519829164125,0.8376550169109357,0.5570934256055363,0.4429065743944637,0.16234498308906425,0.5882818685669042
0.789,2910,"[[741, 894], [146, 1129]]",741,146,894,146,887,2023,1635,1275,1870,1040,0.6426116838487973,0.45321100917431195,0.8354002254791432,0.5580820563519525,0.44191794364804743,0.16459977452085683,0.5876288659793815
0.79,2910,"[[740, 893], [147, 1130]]",740,147,893,147,887,2023,1633,1277,1870,1040,0.6426116838487973,0.453153704837722,0.8342728297632469,0.5585763717251606,0.44142362827483933,0.1657271702367531,0.5873015873015874
0.791,2910,"[[740, 893], [147, 1130]]",740,147,893,147,887,2023,1633,1277,1870,1040,0.6426116838487973,0.453153704837722,0.8342728297632469,0.5585763717251606,0.44142362827483933,0.1657271702367531,0.5873015873015874
0.792,2910,"[[739, 892], [148, 1131]]",739,148,892,148,887,2023,1631,1279,1870,1040,0.6426116838487973,0.45309625996321273,0.8331454340473506,0.5590706870983687,0.44092931290163123,0.1668545659526494,0.5869737887212073
0.793,2910,"[[739, 892], [148, 1131]]",739,148,892,148,887,2023,1631,1279,1870,1040,0.6426116838487973,0.45309625996321273,0.8331454340473506,0.5590706870983687,0.44092931290163123,0.1668545659526494,0.5869737887212073
0.794,2910,"[[738, 891], [149, 1132]]",738,149,891,149,887,2023,1629,1281,1870,1040,0.6426116838487973,0.4530386740331492,0.8320180383314544,0.5595650024715768,0.44043499752842313,0.16798196166854565,0.5866454689984103
0.795,2910,"[[737, 890], [150, 1133]]",737,150,890,150,887,2023,1627,1283,1870,1040,0.6426116838487973,0.45298094652735094,0.830890642615558,0.560059317844785,0.43994068215521503,0.16910935738444194,0.5863166268894192
0.796,2910,"[[736, 888], [151, 1135]]",736,151,888,151,887,2023,1624,1286,1871,1039,0.6429553264604811,0.45320197044334976,0.8297632468996617,0.5610479485912012,0.43895205140879884,0.17023675310033823,0.5862206292313819
0.797,2910,"[[735, 888], [152, 1135]]",735,152,888,152,887,2023,1623,1287,1870,1040,0.6426116838487973,0.45286506469500926,0.8286358511837655,0.5610479485912012,0.43895205140879884,0.1713641488162345,0.5856573705179283
0.798,2910,"[[735, 888], [152, 1135]]",735,152,888,152,887,2023,1623,1287,1870,1040,0.6426116838487973,0.45286506469500926,0.8286358511837655,0.5610479485912012,0.43895205140879884,0.1713641488162345,0.5856573705179283
0.799,2910,"[[735, 888], [152, 1135]]",735,152,888,152,887,2023,1623,1287,1870,1040,0.6426116838487973,0.45286506469500926,0.8286358511837655,0.5610479485912012,0.43895205140879884,0.1713641488162345,0.5856573705179283
0.8,2910,"[[735, 885], [152, 1138]]",735,152,885,152,887,2023,1620,1290,1873,1037,0.6436426116838488,0.4537037037037037,0.8286358511837655,0.5625308947108255,0.4374691052891745,0.1713641488162345,0.5863581970482649
0.801,2910,"[[733, 883], [154, 1140]]",733,154,883,154,887,2023,1616,1294,1873,1037,0.6436426116838488,0.4535891089108911,0.826381059751973,0.5635195254572417,0.4364804745427583,0.17361894024802707,0.5856971634039153
0.802,2910,"[[732, 882], [155, 1141]]",732,155,882,155,887,2023,1614,1296,1873,1037,0.6436426116838488,0.45353159851301117,0.8252536640360767,0.5640138408304498,0.4359861591695502,0.17474633596392333,0.5853658536585366
0.803,2910,"[[732, 882], [155, 1141]]",732,155,882,155,887,2023,1614,1296,1873,1037,0.6436426116838488,0.45353159851301117,0.8252536640360767,0.5640138408304498,0.4359861591695502,0.17474633596392333,0.5853658536585366
0.804,2910,"[[732, 881], [155, 1142]]",732,155,881,155,887,2023,1613,1297,1874,1036,0.6439862542955327,0.453812771233726,0.8252536640360767,0.5645081562036579,0.4354918437963421,0.17474633596392333,0.5856
0.805,2910,"[[732, 878], [155, 1145]]",732,155,878,155,887,2023,1610,1300,1877,1033,0.6450171821305842,0.4546583850931677,0.8252536640360767,0.5659911023232822,0.43400889767671774,0.17474633596392333,0.5863035642771325
0.806,2910,"[[732, 876], [155, 1147]]",732,155,876,155,887,2023,1608,1302,1879,1031,0.6457044673539519,0.4552238805970149,0.8252536640360767,0.5669797330696985,0.43302026693030155,0.17474633596392333,0.5867735470941884
0.807,2910,"[[732, 876], [155, 1147]]",732,155,876,155,887,2023,1608,1302,1879,1031,0.6457044673539519,0.4552238805970149,0.8252536640360767,0.5669797330696985,0.43302026693030155,0.17474633596392333,0.5867735470941884
0.808,2910,"[[732, 876], [155, 1147]]",732,155,876,155,887,2023,1608,1302,1879,1031,0.6457044673539519,0.4552238805970149,0.8252536640360767,0.5669797330696985,0.43302026693030155,0.17474633596392333,0.5867735470941884
0.809,2910,"[[730, 876], [157, 1147]]",730,157,876,157,887,2023,1606,1304,1877,1033,0.6450171821305842,0.45454545454545453,0.8229988726042841,0.5669797330696985,0.43302026693030155,0.17700112739571588,0.5856397914159647
0.81,2910,"[[730, 876], [157, 1147]]",730,157,876,157,887,2023,1606,1304,1877,1033,0.6450171821305842,0.45454545454545453,0.8229988726042841,0.5669797330696985,0.43302026693030155,0.17700112739571588,0.5856397914159647
0.811,2910,"[[730, 874], [157, 1149]]",730,157,874,157,887,2023,1604,1306,1879,1031,0.6457044673539519,0.4551122194513716,0.8229988726042841,0.5679683638161147,0.4320316361838853,0.17700112739571588,0.586109995985548
0.812,2910,"[[730, 870], [157, 1153]]",730,157,870,157,887,2023,1600,1310,1883,1027,0.6470790378006873,0.45625,0.8229988726042841,0.5699456253089471,0.4300543746910529,0.17700112739571588,0.5870526739043023
0.813,2910,"[[730, 870], [157, 1153]]",730,157,870,157,887,2023,1600,1310,1883,1027,0.6470790378006873,0.45625,0.8229988726042841,0.5699456253089471,0.4300543746910529,0.17700112739571588,0.5870526739043023
0.814,2910,"[[730, 869], [157, 1154]]",730,157,869,157,887,2023,1599,1311,1884,1026,0.6474226804123712,0.45653533458411505,0.8229988726042841,0.5704399406821552,0.4295600593178448,0.17700112739571588,0.587288817377313
0.815,2910,"[[730, 868], [157, 1155]]",730,157,868,157,887,2023,1598,1312,1885,1025,0.647766323024055,0.4568210262828536,0.8229988726042841,0.5709342560553633,0.4290657439446367,0.17700112739571588,0.5875251509054326
0.816,2910,"[[730, 867], [157, 1156]]",730,157,867,157,887,2023,1597,1313,1886,1024,0.6481099656357389,0.4571070757670632,0.8229988726042841,0.5714285714285714,0.42857142857142855,0.17700112739571588,0.5877616747181964
0.817,2910,"[[730, 867], [157, 1156]]",730,157,867,157,887,2023,1597,1313,1886,1024,0.6481099656357389,0.4571070757670632,0.8229988726042841,0.5714285714285714,0.42857142857142855,0.17700112739571588,0.5877616747181964
0.818,2910,"[[730, 866], [157, 1157]]",730,157,866,157,887,2023,1596,1314,1887,1023,0.6484536082474227,0.4573934837092732,0.8229988726042841,0.5719228868017795,0.42807711319822045,0.17700112739571588,0.5879983890455094
0.819,2910,"[[730, 866], [157, 1157]]",730,157,866,157,887,2023,1596,1314,1887,1023,0.6484536082474227,0.4573934837092732,0.8229988726042841,0.5719228868017795,0.42807711319822045,0.17700112739571588,0.5879983890455094
0.82,2910,"[[730, 866], [157, 1157]]",730,157,866,157,887,2023,1596,1314,1887,1023,0.6484536082474227,0.4573934837092732,0.8229988726042841,0.5719228868017795,0.42807711319822045,0.17700112739571588,0.5879983890455094
0.821,2910,"[[730, 864], [157, 1159]]",730,157,864,157,887,2023,1594,1316,1889,1021,0.6491408934707904,0.45796737766624845,0.8229988726042841,0.5729115175481958,0.42708848245180425,0.17700112739571588,0.5884723901652559
0.822,2910,"[[730, 863], [157, 1160]]",730,157,863,157,887,2023,1593,1317,1890,1020,0.6494845360824743,0.45825486503452606,0.8229988726042841,0.5734058329214039,0.42659416707859615,0.17700112739571588,0.5887096774193549
0.823,2910,"[[730, 861], [157, 1162]]",730,157,861,157,887,2023,1591,1319,1892,1018,0.650171821305842,0.45883092394720304,0.8229988726042841,0.5743944636678201,0.42560553633217996,0.17700112739571588,0.5891848264729621
0.824,2910,"[[730, 859], [157, 1164]]",730,157,859,157,887,2023,1589,1321,1894,1016,0.6508591065292096,0.4594084329767149,0.8229988726042841,0.5753830944142363,0.4246169055857637,0.17700112739571588,0.5896607431340872
0.825,2910,"[[730, 859], [157, 1164]]",730,157,859,157,887,2023,1589,1321,1894,1016,0.6508591065292096,0.4594084329767149,0.8229988726042841,0.5753830944142363,0.4246169055857637,0.17700112739571588,0.5896607431340872
0.826,2910,"[[730, 859], [157, 1164]]",730,157,859,157,887,2023,1589,1321,1894,1016,0.6508591065292096,0.4594084329767149,0.8229988726042841,0.5753830944142363,0.4246169055857637,0.17700112739571588,0.5896607431340872
0.827,2910,"[[729, 857], [158, 1166]]",729,158,857,158,887,2023,1586,1324,1895,1015,0.6512027491408935,0.45964691046658257,0.8218714768883878,0.5763717251606525,0.4236282748393475,0.17812852311161217,0.5895673271330367
0.828,2910,"[[729, 855], [158, 1168]]",729,158,855,158,887,2023,1584,1326,1897,1013,0.6518900343642612,0.4602272727272727,0.8218714768883878,0.5773603559070687,0.4226396440929313,0.17812852311161217,0.5900445163901253
0.829,2910,"[[729, 855], [158, 1168]]",729,158,855,158,887,2023,1584,1326,1897,1013,0.6518900343642612,0.4602272727272727,0.8218714768883878,0.5773603559070687,0.4226396440929313,0.17812852311161217,0.5900445163901253
0.83,2910,"[[729, 854], [158, 1169]]",729,158,854,158,887,2023,1583,1327,1898,1012,0.652233676975945,0.46051800379027164,0.8218714768883878,0.5778546712802768,0.42214532871972316,0.17812852311161217,0.5902834008097166
0.831,2910,"[[729, 854], [158, 1169]]",729,158,854,158,887,2023,1583,1327,1898,1012,0.652233676975945,0.46051800379027164,0.8218714768883878,0.5778546712802768,0.42214532871972316,0.17812852311161217,0.5902834008097166
0.832,2910,"[[727, 850], [160, 1173]]",727,160,850,160,887,2023,1577,1333,1900,1010,0.6529209621993127,0.461001902346227,0.8196166854565953,0.5798319327731093,0.42016806722689076,0.18038331454340473,0.5900974025974026
0.833,2910,"[[727, 850], [160, 1173]]",727,160,850,160,887,2023,1577,1333,1900,1010,0.6529209621993127,0.461001902346227,0.8196166854565953,0.5798319327731093,0.42016806722689076,0.18038331454340473,0.5900974025974026
0.834,2910,"[[725, 850], [162, 1173]]",725,162,850,162,887,2023,1575,1335,1898,1012,0.652233676975945,0.4603174603174603,0.8173618940248027,0.5798319327731093,0.42016806722689076,0.1826381059751973,0.5889520714865962
0.835,2910,"[[725, 848], [162, 1175]]",725,162,848,162,887,2023,1573,1337,1900,1010,0.6529209621993127,0.46090273363000633,0.8173618940248027,0.5808205635195255,0.41917943648047457,0.1826381059751973,0.589430894308943
0.836,2910,"[[724, 844], [163, 1179]]",724,163,844,163,887,2023,1568,1342,1903,1007,0.6539518900343643,0.461734693877551,0.8162344983089064,0.5827978250123579,0.4172021749876421,0.18376550169109357,0.5898167006109979
0.837,2910,"[[723, 840], [164, 1183]]",723,164,840,164,887,2023,1563,1347,1906,1004,0.6549828178694158,0.46257197696737046,0.8151071025930101,0.5847750865051903,0.41522491349480967,0.18489289740698986,0.590204081632653
0.838,2910,"[[723, 837], [164, 1186]]",723,164,837,164,887,2023,1560,1350,1909,1001,0.6560137457044674,0.4634615384615385,0.8151071025930101,0.5862580326248147,0.41374196737518537,0.18489289740698986,0.5909276665304455
0.839,2910,"[[722, 837], [165, 1186]]",722,165,837,165,887,2023,1559,1351,1908,1002,0.6556701030927835,0.46311738293778065,0.8139797068771139,0.5862580326248147,0.41374196737518537,0.18602029312288612,0.5903515944399018
0.84,2910,"[[722, 837], [165, 1186]]",722,165,837,165,887,2023,1559,1351,1908,1002,0.6556701030927835,0.46311738293778065,0.8139797068771139,0.5862580326248147,0.41374196737518537,0.18602029312288612,0.5903515944399018
0.841,2910,"[[722, 837], [165, 1186]]",722,165,837,165,887,2023,1559,1351,1908,1002,0.6556701030927835,0.46311738293778065,0.8139797068771139,0.5862580326248147,0.41374196737518537,0.18602029312288612,0.5903515944399018
0.842,2910,"[[722, 834], [165, 1189]]",722,165,834,165,887,2023,1556,1354,1911,999,0.656701030927835,0.4640102827763496,0.8139797068771139,0.587740978744439,0.4122590212555611,0.18602029312288612,0.5910765452312731
0.843,2910,"[[722, 834], [165, 1189]]",722,165,834,165,887,2023,1556,1354,1911,999,0.656701030927835,0.4640102827763496,0.8139797068771139,0.587740978744439,0.4122590212555611,0.18602029312288612,0.5910765452312731
0.844,2910,"[[721, 831], [166, 1192]]",721,166,831,166,887,2023,1552,1358,1913,997,0.6573883161512027,0.4645618556701031,0.8128523111612176,0.5892239248640633,0.4107760751359367,0.1871476888387824,0.5912259122591226
0.845,2910,"[[721, 831], [166, 1192]]",721,166,831,166,887,2023,1552,1358,1913,997,0.6573883161512027,0.4645618556701031,0.8128523111612176,0.5892239248640633,0.4107760751359367,0.1871476888387824,0.5912259122591226
0.846,2910,"[[721, 830], [166, 1193]]",721,166,830,166,887,2023,1551,1359,1914,996,0.6577319587628866,0.46486137975499675,0.8128523111612176,0.5897182402372714,0.4102817597627286,0.1871476888387824,0.5914684167350287
0.847,2910,"[[718, 830], [169, 1193]]",718,169,830,169,887,2023,1548,1362,1911,999,0.656701030927835,0.46382428940568476,0.8094701240135288,0.5897182402372714,0.4102817597627286,0.19052987598647125,0.5897330595482547
0.848,2910,"[[718, 830], [169, 1193]]",718,169,830,169,887,2023,1548,1362,1911,999,0.656701030927835,0.46382428940568476,0.8094701240135288,0.5897182402372714,0.4102817597627286,0.19052987598647125,0.5897330595482547
0.849,2910,"[[717, 829], [170, 1194]]",717,170,829,170,887,2023,1546,1364,1911,999,0.656701030927835,0.46377749029754206,0.8083427282976324,0.5902125556104795,0.4097874443895205,0.19165727170236754,0.5893958076448829
0.85,2910,"[[717, 827], [170, 1196]]",717,170,827,170,887,2023,1544,1366,1913,997,0.6573883161512027,0.4643782383419689,0.8083427282976324,0.5912011863568957,0.4087988136431043,0.19165727170236754,0.5898807075277663
0.851,2910,"[[717, 824], [170, 1199]]",717,170,824,170,887,2023,1541,1369,1916,994,0.6584192439862543,0.4652822842310188,0.8083427282976324,0.59268413247652,0.40731586752348,0.19165727170236754,0.5906095551894563
0.852,2910,"[[716, 824], [171, 1199]]",716,171,824,171,887,2023,1540,1370,1915,995,0.6580756013745704,0.4649350649350649,0.8072153325817362,0.59268413247652,0.40731586752348,0.1927846674182638,0.5900288421920066
0.853,2910,"[[716, 820], [171, 1203]]",716,171,820,171,887,2023,1536,1374,1919,991,0.6594501718213058,0.4661458333333333,0.8072153325817362,0.5946613939693525,0.40533860603064753,0.1927846674182638,0.5910028889806025
0.854,2910,"[[716, 820], [171, 1203]]",716,171,820,171,887,2023,1536,1374,1919,991,0.6594501718213058,0.4661458333333333,0.8072153325817362,0.5946613939693525,0.40533860603064753,0.1927846674182638,0.5910028889806025
0.855,2910,"[[715, 820], [172, 1203]]",715,172,820,172,887,2023,1535,1375,1918,992,0.659106529209622,0.46579804560260585,0.8060879368658399,0.5946613939693525,0.40533860603064753,0.1939120631341601,0.5904211395540875
0.856,2910,"[[715, 819], [172, 1204]]",715,172,819,172,887,2023,1534,1376,1919,991,0.6594501718213058,0.4661016949152542,0.8060879368658399,0.5951557093425606,0.40484429065743943,0.1939120631341601,0.590665014456836
0.857,2910,"[[715, 818], [172, 1205]]",715,172,818,172,887,2023,1533,1377,1920,990,0.6597938144329897,0.4664057403783431,0.8060879368658399,0.5956500247157687,0.40434997528423133,0.1939120631341601,0.5909090909090908
0.858,2910,"[[714, 815], [173, 1208]]",714,173,815,173,887,2023,1529,1381,1922,988,0.6604810996563574,0.4669718770438195,0.8049605411499436,0.597132970835393,0.40286702916460704,0.19503945885005636,0.5910596026490066
0.859,2910,"[[714, 811], [173, 1212]]",714,173,811,173,887,2023,1525,1385,1926,984,0.6618556701030928,0.4681967213114754,0.8049605411499436,0.5991102323282254,0.4008897676717746,0.19503945885005636,0.5920398009950248
0.86,2910,"[[713, 810], [174, 1213]]",713,174,810,174,887,2023,1523,1387,1926,984,0.6618556701030928,0.4681549573210768,0.8038331454340474,0.5996045477014336,0.4003954522985665,0.19616685456595265,0.591701244813278
0.861,2910,"[[713, 808], [174, 1215]]",713,174,808,174,887,2023,1521,1389,1928,982,0.6625429553264605,0.46877054569362264,0.8038331454340474,0.6005931784478498,0.3994068215521503,0.19616685456595265,0.5921926910299005
0.862,2910,"[[713, 806], [174, 1217]]",713,174,806,174,887,2023,1519,1391,1930,980,0.6632302405498282,0.46938775510204084,0.8038331454340474,0.601581809194266,0.39841819080573404,0.19616685456595265,0.5926849542809643
0.863,2910,"[[713, 803], [174, 1220]]",713,174,803,174,887,2023,1516,1394,1933,977,0.6642611683848797,0.4703166226912929,0.8038331454340474,0.6030647553138903,0.39693524468610974,0.19616685456595265,0.5934248855597171
0.864,2910,"[[711, 799], [176, 1224]]",711,176,799,176,887,2023,1510,1400,1935,975,0.6649484536082474,0.47086092715231787,0.8015783540022547,0.6050420168067226,0.3949579831932773,0.1984216459977452,0.5932415519399249
0.865,2910,"[[711, 796], [176, 1227]]",711,176,796,176,887,2023,1507,1403,1938,972,0.6659793814432989,0.47179827471798275,0.8015783540022547,0.606524962926347,0.393475037073653,0.1984216459977452,0.593984962406015
0.866,2910,"[[711, 795], [176, 1228]]",711,176,795,176,887,2023,1506,1404,1939,971,0.6663230240549828,0.4721115537848606,0.8015783540022547,0.6070192782995552,0.3929807217004449,0.1984216459977452,0.5942331801086502
0.867,2910,"[[710, 793], [177, 1230]]",710,177,793,177,887,2023,1503,1407,1940,970,0.6666666666666666,0.47238855622089154,0.8004509582863585,0.6080079090459714,0.39199209095402865,0.1995490417136415,0.5941422594142259
0.868,2910,"[[709, 793], [178, 1230]]",709,178,793,178,887,2023,1502,1408,1939,971,0.6663230240549828,0.47203728362183756,0.7993235625704622,0.6080079090459714,0.39199209095402865,0.20067643742953778,0.5935537881958979
0.869,2910,"[[709, 793], [178, 1230]]",709,178,793,178,887,2023,1502,1408,1939,971,0.6663230240549828,0.47203728362183756,0.7993235625704622,0.6080079090459714,0.39199209095402865,0.20067643742953778,0.5935537881958979
0.87,2910,"[[709, 791], [178, 1232]]",709,178,791,178,887,2023,1500,1410,1941,969,0.6670103092783505,0.4726666666666667,0.7993235625704622,0.6089965397923875,0.39100346020761245,0.20067643742953778,0.5940511101801423
0.871,2910,"[[709, 791], [178, 1232]]",709,178,791,178,887,2023,1500,1410,1941,969,0.6670103092783505,0.4726666666666667,0.7993235625704622,0.6089965397923875,0.39100346020761245,0.20067643742953778,0.5940511101801423
0.872,2910,"[[709, 790], [178, 1233]]",709,178,790,178,887,2023,1499,1411,1942,968,0.6673539518900343,0.47298198799199465,0.7993235625704622,0.6094908551655956,0.39050914483440435,0.20067643742953778,0.5943000838222968
0.873,2910,"[[709, 789], [178, 1234]]",709,178,789,178,887,2023,1498,1412,1943,967,0.6676975945017182,0.4732977303070761,0.7993235625704622,0.6099851705388037,0.39001482946119626,0.20067643742953778,0.5945492662473795
0.874,2910,"[[707, 788], [180, 1235]]",707,180,788,180,887,2023,1495,1415,1942,968,0.6673539518900343,0.4729096989966555,0.7970687711386697,0.6104794859120118,0.38952051408798816,0.20293122886133033,0.5936188077246012
0.875,2910,"[[706, 785], [181, 1238]]",706,181,785,181,887,2023,1491,1419,1944,966,0.668041237113402,0.47350771294433264,0.7959413754227734,0.6119624320316361,0.3880375679683638,0.2040586245772266,0.593776282590412
0.876,2910,"[[706, 784], [181, 1239]]",706,181,784,181,887,2023,1490,1420,1945,965,0.6683848797250859,0.4738255033557047,0.7959413754227734,0.6124567474048442,0.3875432525951557,0.2040586245772266,0.5940260832982751
0.877,2910,"[[705, 784], [182, 1239]]",705,182,784,182,887,2023,1489,1421,1944,966,0.668041237113402,0.4734721289456011,0.7948139797068771,0.6124567474048442,0.3875432525951557,0.20518602029312288,0.5934343434343434
0.878,2910,"[[705, 781], [182, 1242]]",705,182,781,182,887,2023,1486,1424,1947,963,0.6690721649484536,0.47442799461641993,0.7948139797068771,0.6139396935244686,0.3860603064755314,0.20518602029312288,0.5941845764854614
0.879,2910,"[[705, 776], [182, 1247]]",705,182,776,182,887,2023,1481,1429,1952,958,0.6707903780068728,0.47602970965563807,0.7948139797068771,0.6164112703905091,0.38358872960949086,0.20518602029312288,0.595439189189189
0.88,2910,"[[705, 772], [182, 1251]]",705,182,772,182,887,2023,1477,1433,1956,954,0.6721649484536083,0.47731888964116453,0.7948139797068771,0.6183885318833415,0.3816114681166584,0.20518602029312288,0.5964467005076142
0.881,2910,"[[703, 769], [184, 1254]]",703,184,769,184,887,2023,1472,1438,1957,953,0.6725085910652921,0.47758152173913043,0.7925591882750845,0.6198714780029659,0.3801285219970341,0.20744081172491544,0.5960152607036879
0.882,2910,"[[703, 767], [184, 1256]]",703,184,767,184,887,2023,1470,1440,1959,951,0.6731958762886598,0.4782312925170068,0.7925591882750845,0.6208601087493821,0.3791398912506179,0.20744081172491544,0.5965210012728045
0.883,2910,"[[703, 764], [184, 1259]]",703,184,764,184,887,2023,1467,1443,1962,948,0.6742268041237114,0.47920927062031354,0.7925591882750845,0.6223430548690064,0.37765694513099357,0.20744081172491544,0.5972812234494477
0.884,2910,"[[702, 763], [185, 1260]]",702,185,763,185,887,2023,1465,1445,1962,948,0.6742268041237114,0.47918088737201364,0.7914317925591883,0.6228373702422145,0.3771626297577855,0.20856820744081173,0.5969387755102041
0.885,2910,"[[702, 763], [185, 1260]]",702,185,763,185,887,2023,1465,1445,1962,948,0.6742268041237114,0.47918088737201364,0.7914317925591883,0.6228373702422145,0.3771626297577855,0.20856820744081173,0.5969387755102041
0.886,2910,"[[702, 762], [185, 1261]]",702,185,762,185,887,2023,1464,1446,1963,947,0.6745704467353952,0.47950819672131145,0.7914317925591883,0.6233316856154226,0.3766683143845774,0.20856820744081173,0.5971926839642705
0.887,2910,"[[702, 762], [185, 1261]]",702,185,762,185,887,2023,1464,1446,1963,947,0.6745704467353952,0.47950819672131145,0.7914317925591883,0.6233316856154226,0.3766683143845774,0.20856820744081173,0.5971926839642705
0.888,2910,"[[702, 761], [185, 1262]]",702,185,761,185,887,2023,1463,1447,1964,946,0.6749140893470791,0.47983595352016406,0.7914317925591883,0.6238260009886307,0.3761739990113693,0.20856820744081173,0.5974468085106382
0.889,2910,"[[702, 758], [185, 1265]]",702,185,758,185,887,2023,1460,1450,1967,943,0.6759450171821306,0.4808219178082192,0.7914317925591883,0.625308947108255,0.3746910528917449,0.20856820744081173,0.5982104814657009
0.89,2910,"[[701, 756], [186, 1267]]",701,186,756,186,887,2023,1457,1453,1968,942,0.6762886597938145,0.48112560054907344,0.790304396843292,0.6262975778546713,0.3737024221453287,0.20969560315670802,0.5981228668941979
0.891,2910,"[[699, 756], [188, 1267]]",699,188,756,188,887,2023,1455,1455,1966,944,0.6756013745704468,0.48041237113402063,0.7880496054114995,0.6262975778546713,0.3737024221453287,0.21195039458850057,0.5969257045260461
0.892,2910,"[[699, 754], [188, 1269]]",699,188,754,188,887,2023,1453,1457,1968,942,0.6762886597938145,0.48107364074328973,0.7880496054114995,0.6272862086010875,0.37271379139891253,0.21195039458850057,0.5974358974358974
0.893,2910,"[[698, 749], [189, 1274]]",698,189,749,189,887,2023,1447,1463,1972,938,0.6776632302405499,0.4823773324118867,0.7869222096956031,0.629757785467128,0.370242214532872,0.21307779030439683,0.598114824335904
0.894,2910,"[[697, 749], [190, 1274]]",697,190,749,190,887,2023,1446,1464,1971,939,0.677319587628866,0.48201936376210236,0.7857948139797069,0.629757785467128,0.370242214532872,0.21420518602029312,0.5975139305615088
0.895,2910,"[[697, 747], [190, 1276]]",697,190,747,190,887,2023,1444,1466,1973,937,0.6780068728522337,0.4826869806094183,0.7857948139797069,0.6307464162135442,0.3692535837864558,0.21420518602029312,0.598026598026598
0.896,2910,"[[696, 745], [191, 1278]]",696,191,745,191,887,2023,1441,1469,1974,936,0.6783505154639176,0.48299791811242193,0.7846674182638106,0.6317350469599604,0.36826495304003953,0.2153325817361894,0.5979381443298969
0.897,2910,"[[695, 743], [192, 1280]]",695,192,743,192,887,2023,1438,1472,1975,935,0.6786941580756014,0.48331015299026425,0.7835400225479143,0.6327236777063767,0.36727632229362334,0.21645997745208567,0.5978494623655914
0.898,2910,"[[694, 742], [193, 1281]]",694,193,742,193,887,2023,1436,1474,1975,935,0.6786941580756014,0.4832869080779944,0.7824126268320181,0.6332179930795848,0.36678200692041524,0.21758737316798196,0.597503228583728
0.899,2910,"[[694, 741], [193, 1282]]",694,193,741,193,887,2023,1435,1475,1976,934,0.6790378006872853,0.48362369337979094,0.7824126268320181,0.6337123084527929,0.36628769154720714,0.21758737316798196,0.5977605512489234
0.9,2910,"[[693, 740], [194, 1283]]",693,194,740,194,887,2023,1433,1477,1976,934,0.6790378006872853,0.48360083740404747,0.7812852311161218,0.634206623826001,0.365793376173999,0.21871476888387825,0.5974137931034483
0.901,2910,"[[693, 739], [194, 1284]]",693,194,739,194,887,2023,1432,1478,1977,933,0.6793814432989691,0.48393854748603354,0.7812852311161218,0.6347009391992091,0.3652990608007909,0.21871476888387825,0.5976714100905562
0.902,2910,"[[693, 737], [194, 1286]]",693,194,737,194,887,2023,1430,1480,1979,931,0.6800687285223368,0.4846153846153846,0.7812852311161218,0.6356895699456253,0.3643104300543747,0.21871476888387825,0.5981873111782477
0.903,2910,"[[691, 735], [196, 1288]]",691,196,735,196,887,2023,1426,1484,1979,931,0.6800687285223368,0.4845722300140252,0.7790304396843292,0.6366782006920415,0.3633217993079585,0.2209695603156708,0.5974924340683095
0.904,2910,"[[690, 734], [197, 1289]]",690,197,734,197,887,2023,1424,1486,1979,931,0.6800687285223368,0.4845505617977528,0.7779030439684329,0.6371725160652496,0.3628274839347504,0.22209695603156707,0.597144093466032
0.905,2910,"[[688, 734], [199, 1289]]",688,199,734,199,887,2023,1422,1488,1977,933,0.6793814432989691,0.4838255977496484,0.7756482525366404,0.6371725160652496,0.3628274839347504,0.22435174746335965,0.5959289735816371
0.906,2910,"[[686, 733], [201, 1290]]",686,201,733,201,887,2023,1419,1491,1976,934,0.6790378006872853,0.4834390415785765,0.7733934611048479,0.6376668314384577,0.36233316856154224,0.2266065388951522,0.5949696444058976
0.907,2910,"[[681, 730], [206, 1293]]",681,206,730,206,887,2023,1411,1499,1974,936,0.6783505154639176,0.48263642806520196,0.7677564825253664,0.6391497775580821,0.36085022244191794,0.2322435174746336,0.5926892950391645
0.908,2910,"[[681, 728], [206, 1295]]",681,206,728,206,887,2023,1409,1501,1976,934,0.6790378006872853,0.48332150461320084,0.7677564825253664,0.6401384083044983,0.35986159169550175,0.2322435174746336,0.5932055749128919
0.909,2910,"[[681, 728], [206, 1295]]",681,206,728,206,887,2023,1409,1501,1976,934,0.6790378006872853,0.48332150461320084,0.7677564825253664,0.6401384083044983,0.35986159169550175,0.2322435174746336,0.5932055749128919
0.91,2910,"[[679, 725], [208, 1298]]",679,208,725,208,887,2023,1404,1506,1977,933,0.6793814432989691,0.48361823361823364,0.7655016910935738,0.6416213544241226,0.3583786455758774,0.23449830890642615,0.5927542557835007
0.911,2910,"[[679, 724], [208, 1299]]",679,208,724,208,887,2023,1403,1507,1978,932,0.679725085910653,0.4839629365645046,0.7655016910935738,0.6421156697973307,0.3578843302026693,0.23449830890642615,0.5930131004366811
0.912,2910,"[[678, 723], [209, 1300]]",678,209,723,209,887,2023,1401,1509,1978,932,0.679725085910653,0.48394004282655245,0.7643742953776775,0.6426099851705388,0.3573900148294612,0.23562570462232243,0.5926573426573426
0.913,2910,"[[677, 721], [210, 1302]]",677,210,721,210,887,2023,1398,1512,1979,931,0.6800687285223368,0.4842632331902718,0.7632468996617813,0.643598615916955,0.356401384083045,0.23675310033821872,0.5925601750547047
0.914,2910,"[[676, 720], [211, 1303]]",676,211,720,211,887,2023,1396,1514,1979,931,0.6800687285223368,0.48424068767908307,0.762119503945885,0.6440929312901631,0.35590706870983685,0.237880496054115,0.5922032413491021
0.915,2910,"[[674, 719], [213, 1304]]",674,213,719,213,887,2023,1393,1517,1978,932,0.679725085910653,0.4838478104809763,0.7598647125140925,0.6445872466633712,0.35541275333662875,0.24013528748590757,0.5912280701754387
0.916,2910,"[[674, 719], [213, 1304]]",674,213,719,213,887,2023,1393,1517,1978,932,0.679725085910653,0.4838478104809763,0.7598647125140925,0.6445872466633712,0.35541275333662875,0.24013528748590757,0.5912280701754387
0.917,2910,"[[671, 718], [216, 1305]]",671,216,718,216,887,2023,1389,1521,1976,934,0.6790378006872853,0.48308135349172066,0.7564825253664036,0.6450815620365793,0.35491843796342065,0.24351747463359638,0.5896309314586995
0.918,2910,"[[671, 713], [216, 1310]]",671,216,713,216,887,2023,1384,1526,1981,929,0.6807560137457045,0.4848265895953757,0.7564825253664036,0.6475531389026199,0.3524468610973801,0.24351747463359638,0.5909291061206516
0.919,2910,"[[671, 712], [216, 1311]]",671,216,712,216,887,2023,1383,1527,1982,928,0.6810996563573883,0.485177151120752,0.7564825253664036,0.648047454275828,0.351952545724172,0.24351747463359638,0.5911894273127754
0.92,2910,"[[670, 710], [217, 1313]]",670,217,710,217,887,2023,1380,1530,1983,927,0.6814432989690722,0.4855072463768116,0.7553551296505073,0.6490360850222442,0.3509639149777558,0.24464487034949267,0.5910895456550507
0.921,2910,"[[668, 708], [219, 1315]]",668,219,708,219,887,2023,1376,1534,1983,927,0.6814432989690722,0.48546511627906974,0.7531003382187148,0.6500247157686604,0.3499752842313396,0.24689966178128522,0.5903667697746354
0.922,2910,"[[667, 707], [220, 1316]]",667,220,707,220,887,2023,1374,1536,1983,927,0.6814432989690722,0.48544395924308587,0.7519729425028185,0.6505190311418685,0.3494809688581315,0.2480270574971815,0.5900044228217602
0.923,2910,"[[667, 704], [220, 1319]]",667,220,704,220,887,2023,1371,1539,1986,924,0.6824742268041237,0.4865061998541211,0.7519729425028185,0.6520019772614928,0.34799802273850716,0.2480270574971815,0.5907883082373782
0.924,2910,"[[665, 701], [222, 1322]]",665,222,701,222,887,2023,1366,1544,1987,923,0.6828178694158076,0.4868228404099561,0.7497181510710259,0.6534849233811172,0.34651507661888287,0.2502818489289741,0.590324012427874
0.925,2910,"[[665, 701], [222, 1322]]",665,222,701,222,887,2023,1366,1544,1987,923,0.6828178694158076,0.4868228404099561,0.7497181510710259,0.6534849233811172,0.34651507661888287,0.2502818489289741,0.590324012427874
0.926,2910,"[[662, 698], [225, 1325]]",662,225,698,225,887,2023,1360,1550,1987,923,0.6828178694158076,0.48676470588235293,0.7463359639233371,0.6549678695007415,0.3450321304992585,0.25366403607666294,0.5892300845571874
0.927,2910,"[[660, 696], [227, 1327]]",660,227,696,227,887,2023,1356,1554,1987,923,0.6828178694158076,0.48672566371681414,0.7440811724915445,0.6559565002471577,0.3440434997528423,0.25591882750845546,0.5884975479268836
0.928,2910,"[[658, 693], [229, 1330]]",658,229,693,229,887,2023,1351,1559,1988,922,0.6831615120274914,0.48704663212435234,0.741826381059752,0.657439446366782,0.34256055363321797,0.25817361894024804,0.5880250223413762
0.929,2910,"[[658, 687], [229, 1336]]",658,229,687,229,887,2023,1345,1565,1994,916,0.6852233676975945,0.48921933085501856,0.741826381059752,0.6604053386060307,0.3395946613939694,0.25817361894024804,0.589605734767025
0.93,2910,"[[656, 683], [231, 1340]]",656,231,683,231,887,2023,1339,1571,1996,914,0.6859106529209622,0.4899178491411501,0.7395715896279594,0.6623826000988631,0.3376173999011369,0.26042841037204056,0.5893980233602875
0.931,2910,"[[656, 682], [231, 1341]]",656,231,682,231,887,2023,1338,1572,1997,913,0.686254295532646,0.49028400597907323,0.7395715896279594,0.6628769154720712,0.33712308452792883,0.26042841037204056,0.5896629213483146
0.932,2910,"[[656, 678], [231, 1345]]",656,231,678,231,887,2023,1334,1576,2001,909,0.6876288659793814,0.4917541229385307,0.7395715896279594,0.6648541769649036,0.3351458230350964,0.26042841037204056,0.5907248986942818
0.933,2910,"[[655, 675], [232, 1348]]",655,232,675,232,887,2023,1330,1580,2003,907,0.6883161512027491,0.4924812030075188,0.7384441939120632,0.666337123084528,0.3336628769154721,0.2615558060879369,0.5908885881822282
0.934,2910,"[[653, 672], [234, 1351]]",653,234,672,234,887,2023,1325,1585,2004,906,0.688659793814433,0.4928301886792453,0.7361894024802705,0.6678200692041523,0.33217993079584773,0.2638105975197294,0.5904159132007233
0.935,2910,"[[651, 667], [236, 1356]]",651,236,667,236,887,2023,1318,1592,2007,903,0.6896907216494845,0.4939301972685888,0.733934611048478,0.6702916460701928,0.32970835392980724,0.266065388951522,0.5904761904761904
0.936,2910,"[[649, 663], [238, 1360]]",649,238,663,238,887,2023,1312,1598,2009,901,0.6903780068728522,0.4946646341463415,0.7316798196166855,0.6722689075630253,0.3277310924369748,0.26832018038331457,0.590268303774443
0.937,2910,"[[646, 660], [241, 1363]]",646,241,660,241,887,2023,1306,1604,2009,901,0.6903780068728522,0.4946401225114854,0.7282976324689966,0.6737518536826496,0.3262481463173505,0.2717023675310034,0.5891472868217054
0.938,2910,"[[645, 659], [242, 1364]]",645,242,659,242,887,2023,1304,1606,2009,901,0.6903780068728522,0.4946319018404908,0.7271702367531003,0.6742461690558577,0.32575383094414234,0.27282976324689967,0.5887722501141031
0.939,2910,"[[644, 657], [243, 1366]]",644,243,657,243,887,2023,1301,1609,2010,900,0.6907216494845361,0.49500384319754037,0.7260428410372041,0.6752347998022739,0.32476520019772614,0.27395715896279593,0.5886654478976234
0.94,2910,"[[644, 653], [243, 1370]]",644,243,653,243,887,2023,1297,1613,2014,896,0.6920962199312715,0.49653045489591363,0.7260428410372041,0.6772120612951062,0.3227879387048937,0.27395715896279593,0.5897435897435898
0.941,2910,"[[642, 648], [245, 1375]]",642,245,648,245,887,2023,1290,1620,2017,893,0.693127147766323,0.49767441860465117,0.7237880496054115,0.6796836381611469,0.3203163618388532,0.2762119503945885,0.5898024804777217
0.942,2910,"[[641, 646], [246, 1377]]",641,246,646,246,887,2023,1287,1623,2018,892,0.6934707903780069,0.49805749805749805,0.7226606538895152,0.680672268907563,0.31932773109243695,0.2773393461104848,0.5896964121435142
0.943,2910,"[[640, 639], [247, 1384]]",640,247,639,247,887,2023,1279,1631,2024,886,0.6955326460481099,0.5003909304143862,0.7215332581736189,0.6841324765200197,0.3158675234799802,0.27846674182638104,0.5909510618651892
0.944,2910,"[[637, 634], [250, 1389]]",637,250,634,250,887,2023,1271,1639,2026,884,0.6962199312714776,0.5011801730920535,0.7181510710259301,0.6866040533860603,0.3133959466139397,0.2818489289740699,0.5903614457831325
0.945,2910,"[[635, 631], [252, 1392]]",635,252,631,252,887,2023,1266,1644,2027,883,0.6965635738831615,0.5015797788309637,0.7158962795941376,0.6880869995056846,0.31191300049431536,0.28410372040586246,0.5898745935903392
0.946,2910,"[[634, 630], [253, 1393]]",634,253,630,253,887,2023,1264,1646,2027,883,0.6965635738831615,0.5015822784810127,0.7147688838782412,0.6885813148788927,0.31141868512110726,0.2852311161217587,0.5894932589493258
0.947,2910,"[[633, 627], [254, 1396]]",633,254,627,254,887,2023,1260,1650,2029,881,0.6972508591065292,0.5023809523809524,0.713641488162345,0.690064260998517,0.30993573900148297,0.28635851183765504,0.5896599906846763
0.948,2910,"[[632, 625], [255, 1398]]",632,255,625,255,887,2023,1257,1653,2030,880,0.697594501718213,0.5027844073190135,0.7125140924464487,0.6910528917449332,0.3089471082550667,0.2874859075535513,0.5895522388059702
0.949,2910,"[[631, 620], [256, 1403]]",631,256,620,256,887,2023,1251,1659,2034,876,0.6989690721649484,0.504396482813749,0.7113866967305524,0.6935244686109738,0.3064755313890262,0.28861330326944756,0.5902712815715623
0.95,2910,"[[631, 618], [256, 1405]]",631,256,618,256,887,2023,1249,1661,2036,874,0.6996563573883161,0.5052041633306645,0.7113866967305524,0.69451309935739,0.30548690064260997,0.28861330326944756,0.5908239700374532
0.951,2910,"[[630, 616], [257, 1407]]",630,257,616,257,887,2023,1246,1664,2037,873,0.7,0.5056179775280899,0.7102593010146562,0.6955017301038062,0.3044982698961938,0.2897406989853439,0.5907172995780591
0.952,2910,"[[630, 613], [257, 1410]]",630,257,613,257,887,2023,1243,1667,2040,870,0.7010309278350515,0.5068382944489139,0.7102593010146562,0.6969846762234305,0.3030153237765695,0.2897406989853439,0.5915492957746479
0.953,2910,"[[629, 610], [258, 1413]]",629,258,610,258,887,2023,1239,1671,2042,868,0.7017182130584192,0.5076674737691687,0.7091319052987599,0.6984676223430548,0.3015323776569451,0.29086809470124014,0.5917215428033866
0.954,2910,"[[629, 606], [258, 1417]]",629,258,606,258,887,2023,1235,1675,2046,864,0.7030927835051546,0.5093117408906883,0.7091319052987599,0.7004448838358873,0.2995551161641127,0.29086809470124014,0.5928369462770972
0.955,2910,"[[628, 601], [259, 1422]]",628,259,601,259,887,2023,1229,1681,2050,860,0.7044673539518901,0.5109845402766476,0.7080045095828635,0.7029164607019278,0.2970835392980722,0.2919954904171364,0.5935727788279772
0.956,2910,"[[624, 597], [263, 1426]]",624,263,597,263,887,2023,1221,1689,2050,860,0.7044673539518901,0.5110565110565111,0.7034949267192785,0.7048937221947602,0.29510627780523974,0.2965050732807215,0.5920303605313093
0.957,2910,"[[621, 593], [266, 1430]]",621,266,593,266,887,2023,1214,1696,2051,859,0.7048109965635739,0.5115321252059308,0.7001127395715896,0.7068709836875927,0.29312901631240734,0.29988726042841035,0.5911470728224655
0.958,2910,"[[619, 589], [268, 1434]]",619,268,589,268,887,2023,1208,1702,2053,857,0.7054982817869416,0.5124172185430463,0.6978579481397971,0.7088482451804251,0.2911517548195749,0.30214205186020293,0.5909307875894989
0.959,2910,"[[617, 584], [270, 1439]]",617,270,584,270,887,2023,1201,1709,2056,854,0.7065292096219932,0.5137385512073273,0.6956031567080045,0.7113198220464656,0.28868017795353434,0.3043968432919955,0.5909961685823755
0.96,2910,"[[616, 583], [271, 1440]]",616,271,583,271,887,2023,1199,1711,2056,854,0.7065292096219932,0.5137614678899083,0.6944757609921083,0.7118141374196737,0.28818586258032625,0.3055242390078918,0.5906040268456377
0.961,2910,"[[615, 579], [272, 1444]]",615,272,579,272,887,2023,1194,1716,2059,851,0.7075601374570447,0.5150753768844221,0.6933483652762119,0.7137913989125062,0.2862086010874938,0.30665163472378804,0.5910619894281595
0.962,2910,"[[612, 575], [275, 1448]]",612,275,575,275,887,2023,1187,1723,2060,850,0.7079037800687286,0.5155855096882898,0.6899661781285231,0.7157686604053386,0.2842313395946614,0.3100338218714769,0.5901639344262295
0.963,2910,"[[612, 567], [275, 1456]]",612,275,567,275,887,2023,1179,1731,2068,842,0.7106529209621993,0.5190839694656488,0.6899661781285231,0.7197231833910035,0.28027681660899656,0.3100338218714769,0.5924491771539205
0.964,2910,"[[609, 566], [278, 1457]]",609,278,566,278,887,2023,1175,1735,2066,844,0.7099656357388316,0.5182978723404256,0.6865839909808342,0.7202174987642116,0.2797825012357884,0.3134160090191657,0.5906886517943745
0.965,2910,"[[609, 559], [278, 1464]]",609,278,559,278,887,2023,1168,1742,2073,837,0.7123711340206186,0.521404109589041,0.6865839909808342,0.7236777063766683,0.27632229362333166,0.3134160090191657,0.5927007299270073
0.966,2910,"[[604, 554], [283, 1469]]",604,283,554,283,887,2023,1158,1752,2073,837,0.7123711340206186,0.5215889464594128,0.6809470124013529,0.7261492832427089,0.27385071675729117,0.31905298759864714,0.5907090464547677
0.967,2910,"[[602, 549], [285, 1474]]",602,285,549,285,887,2023,1151,1759,2076,834,0.7134020618556701,0.5230234578627281,0.6786922209695603,0.7286208601087494,0.2713791398912506,0.32130777903043967,0.590775269872424
0.968,2910,"[[599, 543], [288, 1480]]",599,288,543,288,887,2023,1142,1768,2079,831,0.7144329896907217,0.5245183887915937,0.6753100338218715,0.731586752347998,0.268413247652002,0.3246899661781285,0.590438639724002
0.969,2910,"[[593, 538], [294, 1485]]",593,294,538,294,887,2023,1131,1779,2078,832,0.7140893470790378,0.5243147656940761,0.6685456595264938,0.7340583292140386,0.2659416707859614,0.3314543404735062,0.5877106045589693
0.97,2910,"[[590, 536], [297, 1487]]",590,297,536,297,887,2023,1126,1784,2077,833,0.713745704467354,0.5239786856127886,0.6651634723788049,0.7350469599604548,0.26495304003954523,0.33483652762119503,0.5861897665176353
0.971,2910,"[[589, 527], [298, 1496]]",589,298,527,298,887,2023,1116,1794,2085,825,0.7164948453608248,0.5277777777777778,0.6640360766629086,0.7394957983193278,0.2605042016806723,0.3359639233370913,0.5881178232651023
0.972,2910,"[[588, 521], [299, 1502]]",588,299,521,299,887,2023,1109,1801,2090,820,0.718213058419244,0.5302073940486925,0.6629086809470124,0.7424616905585764,0.25753830944142364,0.3370913190529876,0.5891783567134268
0.973,2910,"[[587, 514], [300, 1509]]",587,300,514,300,887,2023,1101,1809,2096,814,0.7202749140893471,0.5331516802906449,0.6617812852311161,0.7459218981710332,0.2540781018289669,0.3382187147688839,0.5905432595573441
0.974,2910,"[[585, 510], [302, 1513]]",585,302,510,302,887,2023,1095,1815,2098,812,0.7209621993127148,0.5342465753424658,0.6595264937993236,0.7478991596638656,0.25210084033613445,0.34047350620067646,0.5903128153380425
0.975,2910,"[[579, 501], [308, 1522]]",579,308,501,308,887,2023,1080,1830,2101,809,0.7219931271477663,0.5361111111111111,0.6527621195039459,0.7523479980227386,0.2476520019772615,0.34723788049605414,0.588713777325877
0.976,2910,"[[579, 493], [308, 1530]]",579,308,493,308,887,2023,1072,1838,2109,801,0.7247422680412371,0.5401119402985075,0.6527621195039459,0.7563025210084033,0.24369747899159663,0.34723788049605414,0.5911179173047473
0.977,2910,"[[579, 487], [308, 1536]]",579,308,487,308,887,2023,1066,1844,2115,795,0.7268041237113402,0.5431519699812383,0.6527621195039459,0.759268413247652,0.240731586752348,0.34723788049605414,0.5929339477726574
0.978,2910,"[[575, 484], [312, 1539]]",575,312,484,312,887,2023,1059,1851,2114,796,0.7264604810996563,0.5429650613786591,0.6482525366403608,0.7607513593672763,0.2392486406327237,0.35174746335963925,0.5909558067831449
0.979,2910,"[[568, 475], [319, 1548]]",568,319,475,319,887,2023,1043,1867,2116,794,0.727147766323024,0.5445829338446788,0.6403607666290868,0.7652001977261493,0.23479980227385072,0.3596392333709132,0.58860103626943
0.98,2910,"[[565, 468], [322, 1555]]",565,322,468,322,887,2023,1033,1877,2120,790,0.7285223367697594,0.5469506292352372,0.636978579481398,0.768660405338606,0.23133959466139398,0.36302142051860203,0.5885416666666667
0.981,2910,"[[559, 459], [328, 1564]]",559,328,459,328,887,2023,1018,1892,2123,787,0.729553264604811,0.5491159135559921,0.6302142051860203,0.773109243697479,0.226890756302521,0.3697857948139797,0.5868766404199475
0.982,2910,"[[558, 449], [329, 1574]]",558,329,449,329,887,2023,1007,1903,2132,778,0.7326460481099656,0.5541211519364448,0.629086809470124,0.77805239742956,0.22194760257043994,0.370913190529876,0.5892291446673705
0.983,2910,"[[555, 440], [332, 1583]]",555,332,440,332,887,2023,995,1915,2138,772,0.7347079037800688,0.5577889447236181,0.6257046223224352,0.782501235788433,0.21749876421156697,0.3742953776775648,0.5897980871413391
0.984,2910,"[[551, 431], [336, 1592]]",551,336,431,336,887,2023,982,1928,2143,767,0.736426116838488,0.5610997963340122,0.62119503945885,0.786950074147306,0.21304992585269403,0.3788049605411499,0.5896201177100053
0.985,2910,"[[544, 425], [343, 1598]]",544,343,425,343,887,2023,969,1941,2142,768,0.7360824742268042,0.5614035087719298,0.6133032694475761,0.7899159663865546,0.21008403361344538,0.38669673055242393,0.5862068965517241
0.986,2910,"[[532, 414], [355, 1609]]",532,355,414,355,887,2023,946,1964,2141,769,0.7357388316151203,0.5623678646934461,0.5997745208568207,0.7953534354918438,0.20464656450815621,0.40022547914317924,0.5804691762138571
0.987,2910,"[[524, 396], [363, 1627]]",524,363,396,363,887,2023,920,1990,2151,759,0.7391752577319588,0.5695652173913044,0.5907553551296505,0.8042511122095897,0.19574888779041028,0.4092446448703495,0.579966795794134
0.988,2910,"[[516, 389], [371, 1634]]",516,371,389,371,887,2023,905,2005,2150,760,0.738831615120275,0.5701657458563536,0.5817361894024803,0.8077113198220465,0.19228868017795353,0.4182638105975197,0.5758928571428571
0.989,2910,"[[506, 373], [381, 1650]]",506,381,373,381,887,2023,879,2031,2156,754,0.740893470790378,0.5756541524459613,0.5704622322435174,0.8156203657933762,0.18437963420662382,0.4295377677564825,0.5730464326160816
0.99,2910,"[[497, 362], [390, 1661]]",497,390,362,390,887,2023,859,2051,2158,752,0.7415807560137457,0.5785797438882422,0.560315670800451,0.8210578348986654,0.17894216510133465,0.43968432919954903,0.5693012600229095
0.991,2910,"[[485, 346], [402, 1677]]",485,402,346,402,887,2023,831,2079,2162,748,0.7429553264604811,0.5836341756919374,0.5467869222096956,0.828966880869995,0.17103311913000493,0.4532130777903044,0.5646100116414435
0.992,2910,"[[476, 327], [411, 1696]]",476,411,327,411,887,2023,803,2107,2172,738,0.7463917525773196,0.5927770859277709,0.5366403607666291,0.8383588729609491,0.16164112703905092,0.4633596392333709,0.5633136094674557
0.993,2910,"[[469, 307], [418, 1716]]",469,418,307,418,887,2023,776,2134,2185,725,0.7508591065292096,0.604381443298969,0.5287485907553551,0.8482451804251112,0.1517548195748888,0.47125140924464487,0.5640408899579072
0.994,2910,"[[451, 295], [436, 1728]]",451,436,295,436,887,2023,746,2164,2179,731,0.7487972508591065,0.6045576407506702,0.5084554678692221,0.8541769649036085,0.1458230350963915,0.4915445321307779,0.552357624004899
0.995,2910,"[[436, 270], [451, 1753]]",436,451,270,451,887,2023,706,2204,2189,721,0.752233676975945,0.6175637393767706,0.4915445321307779,0.8665348492338112,0.13346515076618884,0.5084554678692221,0.5473948524795983
0.996,2910,"[[415, 251], [472, 1772]]",415,472,251,472,887,2023,666,2244,2187,723,0.7515463917525773,0.6231231231231231,0.46786922209695603,0.8759268413247652,0.1240731586752348,0.532130777903044,0.5344494526722473
0.997,2910,"[[386, 222], [501, 1801]]",386,501,222,501,887,2023,608,2302,2187,723,0.7515463917525773,0.6348684210526315,0.4351747463359639,0.8902619871478002,0.10973801285219971,0.5648252536640361,0.5163879598662207
0.998,2910,"[[354, 181], [533, 1842]]",354,533,181,533,887,2023,535,2375,2196,714,0.7546391752577319,0.6616822429906543,0.399098083427283,0.9105289174493326,0.08947108255066732,0.6009019165727171,0.49789029535864987
0.999,2910,"[[293, 115], [594, 1908]]",293,594,115,594,887,2023,408,2502,2201,709,0.7563573883161512,0.7181372549019608,0.33032694475760993,0.9431537320810677,0.056846267918932276,0.6696730552423901,0.4525096525096525
1.0,2910,"[[2, 0], [885, 2023]]",2,885,0,885,887,2023,2,2908,2025,885,0.6958762886597938,1.0,0.002254791431792559,1.0,0.0,0.9977452085682075,0.004499437570303712
1.001,2910,"[[0, 0], [887, 2023]]",0,887,0,887,887,2023,0,2910,2023,887,0.6951890034364261,,0.0,1.0,0.0,1.0,
