Score Threshold,Measurements (M),Confusion Matrix (cm),True Pos.s (TP),True Neg.s (TN),False Pos.s (FP),*False Neg.s* (FN),Positives (P),Negatives (N),Meas.Pos.s (MP),Meas.Neg.s (MN),Correct Meas.s (CM),Incorrect Meas.s (IM),Accuracy (ACC),Precision (PPV),Recall/Sensitivity (TPR),Specificity/Selectivity (TNR),Fallout (FPR),Miss Rate (FNR),F1 Score (F1)
0.0,400,"[[200, 200], [0, 0]]",200,0,200,0,200,200,400,0,200,200,0.5,0.5,1.0,0.0,1.0,0.0,0.6666666666666666
0.001,400,"[[194, 183], [6, 17]]",194,6,183,6,200,200,377,23,211,189,0.5275,0.5145888594164456,0.97,0.085,0.915,0.03,0.6724436741767764
0.002,400,"[[193, 180], [7, 20]]",193,7,180,7,200,200,373,27,213,187,0.5325,0.517426273458445,0.965,0.1,0.9,0.035,0.6736474694589878
0.003,400,"[[188, 178], [12, 22]]",188,12,178,12,200,200,366,34,210,190,0.525,0.5136612021857924,0.94,0.11,0.89,0.06,0.6643109540636042
0.004,400,"[[185, 175], [15, 25]]",185,15,175,15,200,200,360,40,210,190,0.525,0.5138888888888888,0.925,0.125,0.875,0.075,0.6607142857142857
0.005,400,"[[181, 171], [19, 29]]",181,19,171,19,200,200,352,48,210,190,0.525,0.5142045454545454,0.905,0.145,0.855,0.095,0.6557971014492754
0.006,400,"[[180, 167], [20, 33]]",180,20,167,20,200,200,347,53,213,187,0.5325,0.5187319884726225,0.9,0.165,0.835,0.1,0.6581352833638026
0.007,400,"[[180, 166], [20, 34]]",180,20,166,20,200,200,346,54,214,186,0.535,0.5202312138728323,0.9,0.17,0.83,0.1,0.6593406593406593
0.008,400,"[[180, 166], [20, 34]]",180,20,166,20,200,200,346,54,214,186,0.535,0.5202312138728323,0.9,0.17,0.83,0.1,0.6593406593406593
0.009,400,"[[177, 165], [23, 35]]",177,23,165,23,200,200,342,58,212,188,0.53,0.5175438596491229,0.885,0.175,0.825,0.115,0.6531365313653137
0.01,400,"[[176, 164], [24, 36]]",176,24,164,24,200,200,340,60,212,188,0.53,0.5176470588235295,0.88,0.18,0.82,0.12,0.6518518518518519
0.011,400,"[[174, 161], [26, 39]]",174,26,161,26,200,200,335,65,213,187,0.5325,0.5194029850746269,0.87,0.195,0.805,0.13,0.6504672897196262
0.012,400,"[[174, 159], [26, 41]]",174,26,159,26,200,200,333,67,215,185,0.5375,0.5225225225225225,0.87,0.205,0.795,0.13,0.6529080675422138
0.013,400,"[[174, 156], [26, 44]]",174,26,156,26,200,200,330,70,218,182,0.545,0.5272727272727272,0.87,0.22,0.78,0.13,0.6566037735849056
0.014,400,"[[173, 154], [27, 46]]",173,27,154,27,200,200,327,73,219,181,0.5475,0.5290519877675841,0.865,0.23,0.77,0.135,0.6565464895635673
0.015,400,"[[172, 152], [28, 48]]",172,28,152,28,200,200,324,76,220,180,0.55,0.5308641975308642,0.86,0.24,0.76,0.14,0.6564885496183206
0.016,400,"[[171, 151], [29, 49]]",171,29,151,29,200,200,322,78,220,180,0.55,0.531055900621118,0.855,0.245,0.755,0.145,0.6551724137931034
0.017,400,"[[169, 151], [31, 49]]",169,31,151,31,200,200,320,80,218,182,0.545,0.528125,0.845,0.245,0.755,0.155,0.6499999999999999
0.018,400,"[[169, 151], [31, 49]]",169,31,151,31,200,200,320,80,218,182,0.545,0.528125,0.845,0.245,0.755,0.155,0.6499999999999999
0.019,400,"[[169, 151], [31, 49]]",169,31,151,31,200,200,320,80,218,182,0.545,0.528125,0.845,0.245,0.755,0.155,0.6499999999999999
0.02,400,"[[169, 151], [31, 49]]",169,31,151,31,200,200,320,80,218,182,0.545,0.528125,0.845,0.245,0.755,0.155,0.6499999999999999
0.021,400,"[[169, 149], [31, 51]]",169,31,149,31,200,200,318,82,220,180,0.55,0.5314465408805031,0.845,0.255,0.745,0.155,0.6525096525096524
0.022,400,"[[167, 148], [33, 52]]",167,33,148,33,200,200,315,85,219,181,0.5475,0.5301587301587302,0.835,0.26,0.74,0.165,0.6485436893203884
0.023,400,"[[167, 147], [33, 53]]",167,33,147,33,200,200,314,86,220,180,0.55,0.5318471337579618,0.835,0.265,0.735,0.165,0.649805447470817
0.024,400,"[[167, 145], [33, 55]]",167,33,145,33,200,200,312,88,222,178,0.555,0.5352564102564102,0.835,0.275,0.725,0.165,0.65234375
0.025,400,"[[167, 144], [33, 56]]",167,33,144,33,200,200,311,89,223,177,0.5575,0.5369774919614148,0.835,0.28,0.72,0.165,0.6536203522504892
0.026,400,"[[167, 144], [33, 56]]",167,33,144,33,200,200,311,89,223,177,0.5575,0.5369774919614148,0.835,0.28,0.72,0.165,0.6536203522504892
0.027,400,"[[167, 144], [33, 56]]",167,33,144,33,200,200,311,89,223,177,0.5575,0.5369774919614148,0.835,0.28,0.72,0.165,0.6536203522504892
0.028,400,"[[167, 142], [33, 58]]",167,33,142,33,200,200,309,91,225,175,0.5625,0.540453074433657,0.835,0.29,0.71,0.165,0.656188605108055
0.029,400,"[[167, 142], [33, 58]]",167,33,142,33,200,200,309,91,225,175,0.5625,0.540453074433657,0.835,0.29,0.71,0.165,0.656188605108055
0.03,400,"[[166, 140], [34, 60]]",166,34,140,34,200,200,306,94,226,174,0.565,0.5424836601307189,0.83,0.3,0.7,0.17,0.6561264822134386
0.031,400,"[[166, 140], [34, 60]]",166,34,140,34,200,200,306,94,226,174,0.565,0.5424836601307189,0.83,0.3,0.7,0.17,0.6561264822134386
0.032,400,"[[165, 139], [35, 61]]",165,35,139,35,200,200,304,96,226,174,0.565,0.5427631578947368,0.825,0.305,0.695,0.175,0.6547619047619047
0.033,400,"[[165, 138], [35, 62]]",165,35,138,35,200,200,303,97,227,173,0.5675,0.5445544554455446,0.825,0.31,0.69,0.175,0.6560636182902585
0.034,400,"[[165, 137], [35, 63]]",165,35,137,35,200,200,302,98,228,172,0.57,0.5463576158940397,0.825,0.315,0.685,0.175,0.6573705179282869
0.035,400,"[[164, 136], [36, 64]]",164,36,136,36,200,200,300,100,228,172,0.57,0.5466666666666666,0.82,0.32,0.68,0.18,0.6559999999999999
0.036,400,"[[164, 136], [36, 64]]",164,36,136,36,200,200,300,100,228,172,0.57,0.5466666666666666,0.82,0.32,0.68,0.18,0.6559999999999999
0.037,400,"[[164, 135], [36, 65]]",164,36,135,36,200,200,299,101,229,171,0.5725,0.5484949832775919,0.82,0.325,0.675,0.18,0.657314629258517
0.038,400,"[[164, 134], [36, 66]]",164,36,134,36,200,200,298,102,230,170,0.575,0.5503355704697986,0.82,0.33,0.67,0.18,0.6586345381526104
0.039,400,"[[164, 133], [36, 67]]",164,36,133,36,200,200,297,103,231,169,0.5775,0.5521885521885522,0.82,0.335,0.665,0.18,0.6599597585513078
0.04,400,"[[164, 133], [36, 67]]",164,36,133,36,200,200,297,103,231,169,0.5775,0.5521885521885522,0.82,0.335,0.665,0.18,0.6599597585513078
0.041,400,"[[164, 133], [36, 67]]",164,36,133,36,200,200,297,103,231,169,0.5775,0.5521885521885522,0.82,0.335,0.665,0.18,0.6599597585513078
0.042,400,"[[164, 133], [36, 67]]",164,36,133,36,200,200,297,103,231,169,0.5775,0.5521885521885522,0.82,0.335,0.665,0.18,0.6599597585513078
0.043,400,"[[164, 132], [36, 68]]",164,36,132,36,200,200,296,104,232,168,0.58,0.5540540540540541,0.82,0.34,0.66,0.18,0.6612903225806451
0.044,400,"[[164, 132], [36, 68]]",164,36,132,36,200,200,296,104,232,168,0.58,0.5540540540540541,0.82,0.34,0.66,0.18,0.6612903225806451
0.045,400,"[[164, 132], [36, 68]]",164,36,132,36,200,200,296,104,232,168,0.58,0.5540540540540541,0.82,0.34,0.66,0.18,0.6612903225806451
0.046,400,"[[164, 131], [36, 69]]",164,36,131,36,200,200,295,105,233,167,0.5825,0.5559322033898305,0.82,0.345,0.655,0.18,0.6626262626262627
0.047,400,"[[163, 131], [37, 69]]",163,37,131,37,200,200,294,106,232,168,0.58,0.5544217687074829,0.815,0.345,0.655,0.185,0.6599190283400809
0.048,400,"[[163, 131], [37, 69]]",163,37,131,37,200,200,294,106,232,168,0.58,0.5544217687074829,0.815,0.345,0.655,0.185,0.6599190283400809
0.049,400,"[[163, 131], [37, 69]]",163,37,131,37,200,200,294,106,232,168,0.58,0.5544217687074829,0.815,0.345,0.655,0.185,0.6599190283400809
0.05,400,"[[163, 131], [37, 69]]",163,37,131,37,200,200,294,106,232,168,0.58,0.5544217687074829,0.815,0.345,0.655,0.185,0.6599190283400809
0.051,400,"[[162, 131], [38, 69]]",162,38,131,38,200,200,293,107,231,169,0.5775,0.552901023890785,0.81,0.345,0.655,0.19,0.6572008113590264
0.052,400,"[[161, 131], [39, 69]]",161,39,131,39,200,200,292,108,230,170,0.575,0.5513698630136986,0.805,0.345,0.655,0.195,0.6544715447154471
0.053,400,"[[161, 131], [39, 69]]",161,39,131,39,200,200,292,108,230,170,0.575,0.5513698630136986,0.805,0.345,0.655,0.195,0.6544715447154471
0.054,400,"[[161, 131], [39, 69]]",161,39,131,39,200,200,292,108,230,170,0.575,0.5513698630136986,0.805,0.345,0.655,0.195,0.6544715447154471
0.055,400,"[[161, 131], [39, 69]]",161,39,131,39,200,200,292,108,230,170,0.575,0.5513698630136986,0.805,0.345,0.655,0.195,0.6544715447154471
0.056,400,"[[161, 131], [39, 69]]",161,39,131,39,200,200,292,108,230,170,0.575,0.5513698630136986,0.805,0.345,0.655,0.195,0.6544715447154471
0.057,400,"[[161, 131], [39, 69]]",161,39,131,39,200,200,292,108,230,170,0.575,0.5513698630136986,0.805,0.345,0.655,0.195,0.6544715447154471
0.058,400,"[[161, 129], [39, 71]]",161,39,129,39,200,200,290,110,232,168,0.58,0.5551724137931034,0.805,0.355,0.645,0.195,0.6571428571428571
0.059,400,"[[161, 128], [39, 72]]",161,39,128,39,200,200,289,111,233,167,0.5825,0.5570934256055363,0.805,0.36,0.64,0.195,0.6584867075664621
0.06,400,"[[160, 127], [40, 73]]",160,40,127,40,200,200,287,113,233,167,0.5825,0.5574912891986062,0.8,0.365,0.635,0.2,0.6570841889117043
0.061,400,"[[160, 127], [40, 73]]",160,40,127,40,200,200,287,113,233,167,0.5825,0.5574912891986062,0.8,0.365,0.635,0.2,0.6570841889117043
0.062,400,"[[159, 126], [41, 74]]",159,41,126,41,200,200,285,115,233,167,0.5825,0.5578947368421052,0.795,0.37,0.63,0.205,0.6556701030927835
0.063,400,"[[159, 126], [41, 74]]",159,41,126,41,200,200,285,115,233,167,0.5825,0.5578947368421052,0.795,0.37,0.63,0.205,0.6556701030927835
0.064,400,"[[159, 124], [41, 76]]",159,41,124,41,200,200,283,117,235,165,0.5875,0.5618374558303887,0.795,0.38,0.62,0.205,0.6583850931677019
0.065,400,"[[158, 124], [42, 76]]",158,42,124,42,200,200,282,118,234,166,0.585,0.5602836879432624,0.79,0.38,0.62,0.21,0.6556016597510373
0.066,400,"[[158, 123], [42, 77]]",158,42,123,42,200,200,281,119,235,165,0.5875,0.5622775800711743,0.79,0.385,0.615,0.21,0.6569646569646569
0.067,400,"[[157, 123], [43, 77]]",157,43,123,43,200,200,280,120,234,166,0.585,0.5607142857142857,0.785,0.385,0.615,0.215,0.6541666666666667
0.068,400,"[[157, 123], [43, 77]]",157,43,123,43,200,200,280,120,234,166,0.585,0.5607142857142857,0.785,0.385,0.615,0.215,0.6541666666666667
0.069,400,"[[157, 123], [43, 77]]",157,43,123,43,200,200,280,120,234,166,0.585,0.5607142857142857,0.785,0.385,0.615,0.215,0.6541666666666667
0.07,400,"[[157, 123], [43, 77]]",157,43,123,43,200,200,280,120,234,166,0.585,0.5607142857142857,0.785,0.385,0.615,0.215,0.6541666666666667
0.071,400,"[[157, 123], [43, 77]]",157,43,123,43,200,200,280,120,234,166,0.585,0.5607142857142857,0.785,0.385,0.615,0.215,0.6541666666666667
0.072,400,"[[157, 123], [43, 77]]",157,43,123,43,200,200,280,120,234,166,0.585,0.5607142857142857,0.785,0.385,0.615,0.215,0.6541666666666667
0.073,400,"[[156, 123], [44, 77]]",156,44,123,44,200,200,279,121,233,167,0.5825,0.5591397849462365,0.78,0.385,0.615,0.22,0.651356993736952
0.074,400,"[[156, 123], [44, 77]]",156,44,123,44,200,200,279,121,233,167,0.5825,0.5591397849462365,0.78,0.385,0.615,0.22,0.651356993736952
0.075,400,"[[155, 123], [45, 77]]",155,45,123,45,200,200,278,122,232,168,0.58,0.5575539568345323,0.775,0.385,0.615,0.225,0.6485355648535565
0.076,400,"[[155, 123], [45, 77]]",155,45,123,45,200,200,278,122,232,168,0.58,0.5575539568345323,0.775,0.385,0.615,0.225,0.6485355648535565
0.077,400,"[[155, 123], [45, 77]]",155,45,123,45,200,200,278,122,232,168,0.58,0.5575539568345323,0.775,0.385,0.615,0.225,0.6485355648535565
0.078,400,"[[155, 123], [45, 77]]",155,45,123,45,200,200,278,122,232,168,0.58,0.5575539568345323,0.775,0.385,0.615,0.225,0.6485355648535565
0.079,400,"[[155, 123], [45, 77]]",155,45,123,45,200,200,278,122,232,168,0.58,0.5575539568345323,0.775,0.385,0.615,0.225,0.6485355648535565
0.08,400,"[[155, 123], [45, 77]]",155,45,123,45,200,200,278,122,232,168,0.58,0.5575539568345323,0.775,0.385,0.615,0.225,0.6485355648535565
0.081,400,"[[155, 123], [45, 77]]",155,45,123,45,200,200,278,122,232,168,0.58,0.5575539568345323,0.775,0.385,0.615,0.225,0.6485355648535565
0.082,400,"[[155, 123], [45, 77]]",155,45,123,45,200,200,278,122,232,168,0.58,0.5575539568345323,0.775,0.385,0.615,0.225,0.6485355648535565
0.083,400,"[[155, 123], [45, 77]]",155,45,123,45,200,200,278,122,232,168,0.58,0.5575539568345323,0.775,0.385,0.615,0.225,0.6485355648535565
0.084,400,"[[155, 123], [45, 77]]",155,45,123,45,200,200,278,122,232,168,0.58,0.5575539568345323,0.775,0.385,0.615,0.225,0.6485355648535565
0.085,400,"[[154, 123], [46, 77]]",154,46,123,46,200,200,277,123,231,169,0.5775,0.555956678700361,0.77,0.385,0.615,0.23,0.6457023060796646
0.086,400,"[[154, 122], [46, 78]]",154,46,122,46,200,200,276,124,232,168,0.58,0.5579710144927537,0.77,0.39,0.61,0.23,0.6470588235294118
0.087,400,"[[154, 122], [46, 78]]",154,46,122,46,200,200,276,124,232,168,0.58,0.5579710144927537,0.77,0.39,0.61,0.23,0.6470588235294118
0.088,400,"[[154, 122], [46, 78]]",154,46,122,46,200,200,276,124,232,168,0.58,0.5579710144927537,0.77,0.39,0.61,0.23,0.6470588235294118
0.089,400,"[[154, 122], [46, 78]]",154,46,122,46,200,200,276,124,232,168,0.58,0.5579710144927537,0.77,0.39,0.61,0.23,0.6470588235294118
0.09,400,"[[153, 122], [47, 78]]",153,47,122,47,200,200,275,125,231,169,0.5775,0.5563636363636364,0.765,0.39,0.61,0.235,0.6442105263157896
0.091,400,"[[153, 122], [47, 78]]",153,47,122,47,200,200,275,125,231,169,0.5775,0.5563636363636364,0.765,0.39,0.61,0.235,0.6442105263157896
0.092,400,"[[153, 121], [47, 79]]",153,47,121,47,200,200,274,126,232,168,0.58,0.5583941605839416,0.765,0.395,0.605,0.235,0.6455696202531647
0.093,400,"[[152, 120], [48, 80]]",152,48,120,48,200,200,272,128,232,168,0.58,0.5588235294117647,0.76,0.4,0.6,0.24,0.6440677966101696
0.094,400,"[[152, 120], [48, 80]]",152,48,120,48,200,200,272,128,232,168,0.58,0.5588235294117647,0.76,0.4,0.6,0.24,0.6440677966101696
0.095,400,"[[152, 119], [48, 81]]",152,48,119,48,200,200,271,129,233,167,0.5825,0.5608856088560885,0.76,0.405,0.595,0.24,0.6454352441613588
0.096,400,"[[152, 119], [48, 81]]",152,48,119,48,200,200,271,129,233,167,0.5825,0.5608856088560885,0.76,0.405,0.595,0.24,0.6454352441613588
0.097,400,"[[152, 119], [48, 81]]",152,48,119,48,200,200,271,129,233,167,0.5825,0.5608856088560885,0.76,0.405,0.595,0.24,0.6454352441613588
0.098,400,"[[152, 119], [48, 81]]",152,48,119,48,200,200,271,129,233,167,0.5825,0.5608856088560885,0.76,0.405,0.595,0.24,0.6454352441613588
0.099,400,"[[152, 119], [48, 81]]",152,48,119,48,200,200,271,129,233,167,0.5825,0.5608856088560885,0.76,0.405,0.595,0.24,0.6454352441613588
0.1,400,"[[152, 118], [48, 82]]",152,48,118,48,200,200,270,130,234,166,0.585,0.562962962962963,0.76,0.41,0.59,0.24,0.6468085106382978
0.101,400,"[[152, 118], [48, 82]]",152,48,118,48,200,200,270,130,234,166,0.585,0.562962962962963,0.76,0.41,0.59,0.24,0.6468085106382978
0.102,400,"[[152, 117], [48, 83]]",152,48,117,48,200,200,269,131,235,165,0.5875,0.5650557620817844,0.76,0.415,0.585,0.24,0.6481876332622601
0.103,400,"[[152, 117], [48, 83]]",152,48,117,48,200,200,269,131,235,165,0.5875,0.5650557620817844,0.76,0.415,0.585,0.24,0.6481876332622601
0.104,400,"[[152, 117], [48, 83]]",152,48,117,48,200,200,269,131,235,165,0.5875,0.5650557620817844,0.76,0.415,0.585,0.24,0.6481876332622601
0.105,400,"[[152, 117], [48, 83]]",152,48,117,48,200,200,269,131,235,165,0.5875,0.5650557620817844,0.76,0.415,0.585,0.24,0.6481876332622601
0.106,400,"[[151, 117], [49, 83]]",151,49,117,49,200,200,268,132,234,166,0.585,0.5634328358208955,0.755,0.415,0.585,0.245,0.6452991452991452
0.107,400,"[[151, 116], [49, 84]]",151,49,116,49,200,200,267,133,235,165,0.5875,0.5655430711610487,0.755,0.42,0.58,0.245,0.6466809421841542
0.108,400,"[[151, 116], [49, 84]]",151,49,116,49,200,200,267,133,235,165,0.5875,0.5655430711610487,0.755,0.42,0.58,0.245,0.6466809421841542
0.109,400,"[[151, 116], [49, 84]]",151,49,116,49,200,200,267,133,235,165,0.5875,0.5655430711610487,0.755,0.42,0.58,0.245,0.6466809421841542
0.11,400,"[[151, 115], [49, 85]]",151,49,115,49,200,200,266,134,236,164,0.59,0.5676691729323309,0.755,0.425,0.575,0.245,0.648068669527897
0.111,400,"[[151, 115], [49, 85]]",151,49,115,49,200,200,266,134,236,164,0.59,0.5676691729323309,0.755,0.425,0.575,0.245,0.648068669527897
0.112,400,"[[151, 115], [49, 85]]",151,49,115,49,200,200,266,134,236,164,0.59,0.5676691729323309,0.755,0.425,0.575,0.245,0.648068669527897
0.113,400,"[[151, 115], [49, 85]]",151,49,115,49,200,200,266,134,236,164,0.59,0.5676691729323309,0.755,0.425,0.575,0.245,0.648068669527897
0.114,400,"[[151, 115], [49, 85]]",151,49,115,49,200,200,266,134,236,164,0.59,0.5676691729323309,0.755,0.425,0.575,0.245,0.648068669527897
0.115,400,"[[151, 115], [49, 85]]",151,49,115,49,200,200,266,134,236,164,0.59,0.5676691729323309,0.755,0.425,0.575,0.245,0.648068669527897
0.116,400,"[[151, 115], [49, 85]]",151,49,115,49,200,200,266,134,236,164,0.59,0.5676691729323309,0.755,0.425,0.575,0.245,0.648068669527897
0.117,400,"[[151, 115], [49, 85]]",151,49,115,49,200,200,266,134,236,164,0.59,0.5676691729323309,0.755,0.425,0.575,0.245,0.648068669527897
0.118,400,"[[151, 115], [49, 85]]",151,49,115,49,200,200,266,134,236,164,0.59,0.5676691729323309,0.755,0.425,0.575,0.245,0.648068669527897
0.119,400,"[[151, 114], [49, 86]]",151,49,114,49,200,200,265,135,237,163,0.5925,0.569811320754717,0.755,0.43,0.57,0.245,0.6494623655913978
0.12,400,"[[151, 114], [49, 86]]",151,49,114,49,200,200,265,135,237,163,0.5925,0.569811320754717,0.755,0.43,0.57,0.245,0.6494623655913978
0.121,400,"[[151, 114], [49, 86]]",151,49,114,49,200,200,265,135,237,163,0.5925,0.569811320754717,0.755,0.43,0.57,0.245,0.6494623655913978
0.122,400,"[[151, 114], [49, 86]]",151,49,114,49,200,200,265,135,237,163,0.5925,0.569811320754717,0.755,0.43,0.57,0.245,0.6494623655913978
0.123,400,"[[151, 114], [49, 86]]",151,49,114,49,200,200,265,135,237,163,0.5925,0.569811320754717,0.755,0.43,0.57,0.245,0.6494623655913978
0.124,400,"[[151, 114], [49, 86]]",151,49,114,49,200,200,265,135,237,163,0.5925,0.569811320754717,0.755,0.43,0.57,0.245,0.6494623655913978
0.125,400,"[[151, 113], [49, 87]]",151,49,113,49,200,200,264,136,238,162,0.595,0.571969696969697,0.755,0.435,0.565,0.245,0.6508620689655172
0.126,400,"[[151, 113], [49, 87]]",151,49,113,49,200,200,264,136,238,162,0.595,0.571969696969697,0.755,0.435,0.565,0.245,0.6508620689655172
0.127,400,"[[151, 113], [49, 87]]",151,49,113,49,200,200,264,136,238,162,0.595,0.571969696969697,0.755,0.435,0.565,0.245,0.6508620689655172
0.128,400,"[[151, 113], [49, 87]]",151,49,113,49,200,200,264,136,238,162,0.595,0.571969696969697,0.755,0.435,0.565,0.245,0.6508620689655172
0.129,400,"[[150, 113], [50, 87]]",150,50,113,50,200,200,263,137,237,163,0.5925,0.5703422053231939,0.75,0.435,0.565,0.25,0.6479481641468683
0.13,400,"[[150, 113], [50, 87]]",150,50,113,50,200,200,263,137,237,163,0.5925,0.5703422053231939,0.75,0.435,0.565,0.25,0.6479481641468683
0.131,400,"[[150, 113], [50, 87]]",150,50,113,50,200,200,263,137,237,163,0.5925,0.5703422053231939,0.75,0.435,0.565,0.25,0.6479481641468683
0.132,400,"[[150, 113], [50, 87]]",150,50,113,50,200,200,263,137,237,163,0.5925,0.5703422053231939,0.75,0.435,0.565,0.25,0.6479481641468683
0.133,400,"[[149, 113], [51, 87]]",149,51,113,51,200,200,262,138,236,164,0.59,0.5687022900763359,0.745,0.435,0.565,0.255,0.6450216450216449
0.134,400,"[[149, 112], [51, 88]]",149,51,112,51,200,200,261,139,237,163,0.5925,0.5708812260536399,0.745,0.44,0.56,0.255,0.6464208242950109
0.135,400,"[[149, 111], [51, 89]]",149,51,111,51,200,200,260,140,238,162,0.595,0.573076923076923,0.745,0.445,0.555,0.255,0.6478260869565218
0.136,400,"[[149, 111], [51, 89]]",149,51,111,51,200,200,260,140,238,162,0.595,0.573076923076923,0.745,0.445,0.555,0.255,0.6478260869565218
0.137,400,"[[148, 111], [52, 89]]",148,52,111,52,200,200,259,141,237,163,0.5925,0.5714285714285714,0.74,0.445,0.555,0.26,0.644880174291939
0.138,400,"[[147, 111], [53, 89]]",147,53,111,53,200,200,258,142,236,164,0.59,0.5697674418604651,0.735,0.445,0.555,0.265,0.6419213973799126
0.139,400,"[[146, 110], [54, 90]]",146,54,110,54,200,200,256,144,236,164,0.59,0.5703125,0.73,0.45,0.55,0.27,0.6403508771929824
0.14,400,"[[146, 108], [54, 92]]",146,54,108,54,200,200,254,146,238,162,0.595,0.5748031496062992,0.73,0.46,0.54,0.27,0.6431718061674009
0.141,400,"[[146, 108], [54, 92]]",146,54,108,54,200,200,254,146,238,162,0.595,0.5748031496062992,0.73,0.46,0.54,0.27,0.6431718061674009
0.142,400,"[[146, 108], [54, 92]]",146,54,108,54,200,200,254,146,238,162,0.595,0.5748031496062992,0.73,0.46,0.54,0.27,0.6431718061674009
0.143,400,"[[146, 108], [54, 92]]",146,54,108,54,200,200,254,146,238,162,0.595,0.5748031496062992,0.73,0.46,0.54,0.27,0.6431718061674009
0.144,400,"[[146, 108], [54, 92]]",146,54,108,54,200,200,254,146,238,162,0.595,0.5748031496062992,0.73,0.46,0.54,0.27,0.6431718061674009
0.145,400,"[[146, 108], [54, 92]]",146,54,108,54,200,200,254,146,238,162,0.595,0.5748031496062992,0.73,0.46,0.54,0.27,0.6431718061674009
0.146,400,"[[145, 108], [55, 92]]",145,55,108,55,200,200,253,147,237,163,0.5925,0.5731225296442688,0.725,0.46,0.54,0.275,0.6401766004415012
0.147,400,"[[145, 108], [55, 92]]",145,55,108,55,200,200,253,147,237,163,0.5925,0.5731225296442688,0.725,0.46,0.54,0.275,0.6401766004415012
0.148,400,"[[145, 108], [55, 92]]",145,55,108,55,200,200,253,147,237,163,0.5925,0.5731225296442688,0.725,0.46,0.54,0.275,0.6401766004415012
0.149,400,"[[145, 106], [55, 94]]",145,55,106,55,200,200,251,149,239,161,0.5975,0.5776892430278885,0.725,0.47,0.53,0.275,0.6430155210643016
0.15,400,"[[145, 106], [55, 94]]",145,55,106,55,200,200,251,149,239,161,0.5975,0.5776892430278885,0.725,0.47,0.53,0.275,0.6430155210643016
0.151,400,"[[145, 106], [55, 94]]",145,55,106,55,200,200,251,149,239,161,0.5975,0.5776892430278885,0.725,0.47,0.53,0.275,0.6430155210643016
0.152,400,"[[145, 106], [55, 94]]",145,55,106,55,200,200,251,149,239,161,0.5975,0.5776892430278885,0.725,0.47,0.53,0.275,0.6430155210643016
0.153,400,"[[145, 106], [55, 94]]",145,55,106,55,200,200,251,149,239,161,0.5975,0.5776892430278885,0.725,0.47,0.53,0.275,0.6430155210643016
0.154,400,"[[145, 105], [55, 95]]",145,55,105,55,200,200,250,150,240,160,0.6,0.58,0.725,0.475,0.525,0.275,0.6444444444444445
0.155,400,"[[145, 105], [55, 95]]",145,55,105,55,200,200,250,150,240,160,0.6,0.58,0.725,0.475,0.525,0.275,0.6444444444444445
0.156,400,"[[145, 105], [55, 95]]",145,55,105,55,200,200,250,150,240,160,0.6,0.58,0.725,0.475,0.525,0.275,0.6444444444444445
0.157,400,"[[145, 105], [55, 95]]",145,55,105,55,200,200,250,150,240,160,0.6,0.58,0.725,0.475,0.525,0.275,0.6444444444444445
0.158,400,"[[144, 105], [56, 95]]",144,56,105,56,200,200,249,151,239,161,0.5975,0.5783132530120482,0.72,0.475,0.525,0.28,0.6414253897550112
0.159,400,"[[144, 105], [56, 95]]",144,56,105,56,200,200,249,151,239,161,0.5975,0.5783132530120482,0.72,0.475,0.525,0.28,0.6414253897550112
0.16,400,"[[144, 104], [56, 96]]",144,56,104,56,200,200,248,152,240,160,0.6,0.5806451612903226,0.72,0.48,0.52,0.28,0.6428571428571428
0.161,400,"[[144, 103], [56, 97]]",144,56,103,56,200,200,247,153,241,159,0.6025,0.582995951417004,0.72,0.485,0.515,0.28,0.6442953020134228
0.162,400,"[[144, 103], [56, 97]]",144,56,103,56,200,200,247,153,241,159,0.6025,0.582995951417004,0.72,0.485,0.515,0.28,0.6442953020134228
0.163,400,"[[144, 103], [56, 97]]",144,56,103,56,200,200,247,153,241,159,0.6025,0.582995951417004,0.72,0.485,0.515,0.28,0.6442953020134228
0.164,400,"[[144, 103], [56, 97]]",144,56,103,56,200,200,247,153,241,159,0.6025,0.582995951417004,0.72,0.485,0.515,0.28,0.6442953020134228
0.165,400,"[[144, 103], [56, 97]]",144,56,103,56,200,200,247,153,241,159,0.6025,0.582995951417004,0.72,0.485,0.515,0.28,0.6442953020134228
0.166,400,"[[144, 103], [56, 97]]",144,56,103,56,200,200,247,153,241,159,0.6025,0.582995951417004,0.72,0.485,0.515,0.28,0.6442953020134228
0.167,400,"[[144, 103], [56, 97]]",144,56,103,56,200,200,247,153,241,159,0.6025,0.582995951417004,0.72,0.485,0.515,0.28,0.6442953020134228
0.168,400,"[[144, 103], [56, 97]]",144,56,103,56,200,200,247,153,241,159,0.6025,0.582995951417004,0.72,0.485,0.515,0.28,0.6442953020134228
0.169,400,"[[144, 103], [56, 97]]",144,56,103,56,200,200,247,153,241,159,0.6025,0.582995951417004,0.72,0.485,0.515,0.28,0.6442953020134228
0.17,400,"[[144, 103], [56, 97]]",144,56,103,56,200,200,247,153,241,159,0.6025,0.582995951417004,0.72,0.485,0.515,0.28,0.6442953020134228
0.171,400,"[[144, 103], [56, 97]]",144,56,103,56,200,200,247,153,241,159,0.6025,0.582995951417004,0.72,0.485,0.515,0.28,0.6442953020134228
0.172,400,"[[144, 103], [56, 97]]",144,56,103,56,200,200,247,153,241,159,0.6025,0.582995951417004,0.72,0.485,0.515,0.28,0.6442953020134228
0.173,400,"[[144, 103], [56, 97]]",144,56,103,56,200,200,247,153,241,159,0.6025,0.582995951417004,0.72,0.485,0.515,0.28,0.6442953020134228
0.174,400,"[[143, 103], [57, 97]]",143,57,103,57,200,200,246,154,240,160,0.6,0.5813008130081301,0.715,0.485,0.515,0.285,0.6412556053811658
0.175,400,"[[143, 103], [57, 97]]",143,57,103,57,200,200,246,154,240,160,0.6,0.5813008130081301,0.715,0.485,0.515,0.285,0.6412556053811658
0.176,400,"[[143, 102], [57, 98]]",143,57,102,57,200,200,245,155,241,159,0.6025,0.5836734693877551,0.715,0.49,0.51,0.285,0.6426966292134831
0.177,400,"[[143, 102], [57, 98]]",143,57,102,57,200,200,245,155,241,159,0.6025,0.5836734693877551,0.715,0.49,0.51,0.285,0.6426966292134831
0.178,400,"[[143, 102], [57, 98]]",143,57,102,57,200,200,245,155,241,159,0.6025,0.5836734693877551,0.715,0.49,0.51,0.285,0.6426966292134831
0.179,400,"[[143, 102], [57, 98]]",143,57,102,57,200,200,245,155,241,159,0.6025,0.5836734693877551,0.715,0.49,0.51,0.285,0.6426966292134831
0.18,400,"[[143, 102], [57, 98]]",143,57,102,57,200,200,245,155,241,159,0.6025,0.5836734693877551,0.715,0.49,0.51,0.285,0.6426966292134831
0.181,400,"[[143, 100], [57, 100]]",143,57,100,57,200,200,243,157,243,157,0.6075,0.588477366255144,0.715,0.5,0.5,0.285,0.6455981941309255
0.182,400,"[[143, 100], [57, 100]]",143,57,100,57,200,200,243,157,243,157,0.6075,0.588477366255144,0.715,0.5,0.5,0.285,0.6455981941309255
0.183,400,"[[143, 100], [57, 100]]",143,57,100,57,200,200,243,157,243,157,0.6075,0.588477366255144,0.715,0.5,0.5,0.285,0.6455981941309255
0.184,400,"[[143, 100], [57, 100]]",143,57,100,57,200,200,243,157,243,157,0.6075,0.588477366255144,0.715,0.5,0.5,0.285,0.6455981941309255
0.185,400,"[[143, 100], [57, 100]]",143,57,100,57,200,200,243,157,243,157,0.6075,0.588477366255144,0.715,0.5,0.5,0.285,0.6455981941309255
0.186,400,"[[143, 100], [57, 100]]",143,57,100,57,200,200,243,157,243,157,0.6075,0.588477366255144,0.715,0.5,0.5,0.285,0.6455981941309255
0.187,400,"[[143, 99], [57, 101]]",143,57,99,57,200,200,242,158,244,156,0.61,0.5909090909090909,0.715,0.505,0.495,0.285,0.6470588235294118
0.188,400,"[[143, 99], [57, 101]]",143,57,99,57,200,200,242,158,244,156,0.61,0.5909090909090909,0.715,0.505,0.495,0.285,0.6470588235294118
0.189,400,"[[143, 99], [57, 101]]",143,57,99,57,200,200,242,158,244,156,0.61,0.5909090909090909,0.715,0.505,0.495,0.285,0.6470588235294118
0.19,400,"[[142, 99], [58, 101]]",142,58,99,58,200,200,241,159,243,157,0.6075,0.5892116182572614,0.71,0.505,0.495,0.29,0.6439909297052153
0.191,400,"[[142, 99], [58, 101]]",142,58,99,58,200,200,241,159,243,157,0.6075,0.5892116182572614,0.71,0.505,0.495,0.29,0.6439909297052153
0.192,400,"[[142, 99], [58, 101]]",142,58,99,58,200,200,241,159,243,157,0.6075,0.5892116182572614,0.71,0.505,0.495,0.29,0.6439909297052153
0.193,400,"[[142, 99], [58, 101]]",142,58,99,58,200,200,241,159,243,157,0.6075,0.5892116182572614,0.71,0.505,0.495,0.29,0.6439909297052153
0.194,400,"[[142, 98], [58, 102]]",142,58,98,58,200,200,240,160,244,156,0.61,0.5916666666666667,0.71,0.51,0.49,0.29,0.6454545454545454
0.195,400,"[[142, 98], [58, 102]]",142,58,98,58,200,200,240,160,244,156,0.61,0.5916666666666667,0.71,0.51,0.49,0.29,0.6454545454545454
0.196,400,"[[142, 98], [58, 102]]",142,58,98,58,200,200,240,160,244,156,0.61,0.5916666666666667,0.71,0.51,0.49,0.29,0.6454545454545454
0.197,400,"[[142, 98], [58, 102]]",142,58,98,58,200,200,240,160,244,156,0.61,0.5916666666666667,0.71,0.51,0.49,0.29,0.6454545454545454
0.198,400,"[[142, 98], [58, 102]]",142,58,98,58,200,200,240,160,244,156,0.61,0.5916666666666667,0.71,0.51,0.49,0.29,0.6454545454545454
0.199,400,"[[142, 98], [58, 102]]",142,58,98,58,200,200,240,160,244,156,0.61,0.5916666666666667,0.71,0.51,0.49,0.29,0.6454545454545454
0.2,400,"[[142, 98], [58, 102]]",142,58,98,58,200,200,240,160,244,156,0.61,0.5916666666666667,0.71,0.51,0.49,0.29,0.6454545454545454
0.201,400,"[[142, 98], [58, 102]]",142,58,98,58,200,200,240,160,244,156,0.61,0.5916666666666667,0.71,0.51,0.49,0.29,0.6454545454545454
0.202,400,"[[142, 98], [58, 102]]",142,58,98,58,200,200,240,160,244,156,0.61,0.5916666666666667,0.71,0.51,0.49,0.29,0.6454545454545454
0.203,400,"[[141, 98], [59, 102]]",141,59,98,59,200,200,239,161,243,157,0.6075,0.5899581589958159,0.705,0.51,0.49,0.295,0.642369020501139
0.204,400,"[[141, 98], [59, 102]]",141,59,98,59,200,200,239,161,243,157,0.6075,0.5899581589958159,0.705,0.51,0.49,0.295,0.642369020501139
0.205,400,"[[141, 98], [59, 102]]",141,59,98,59,200,200,239,161,243,157,0.6075,0.5899581589958159,0.705,0.51,0.49,0.295,0.642369020501139
0.206,400,"[[141, 97], [59, 103]]",141,59,97,59,200,200,238,162,244,156,0.61,0.592436974789916,0.705,0.515,0.485,0.295,0.6438356164383562
0.207,400,"[[141, 97], [59, 103]]",141,59,97,59,200,200,238,162,244,156,0.61,0.592436974789916,0.705,0.515,0.485,0.295,0.6438356164383562
0.208,400,"[[141, 97], [59, 103]]",141,59,97,59,200,200,238,162,244,156,0.61,0.592436974789916,0.705,0.515,0.485,0.295,0.6438356164383562
0.209,400,"[[141, 97], [59, 103]]",141,59,97,59,200,200,238,162,244,156,0.61,0.592436974789916,0.705,0.515,0.485,0.295,0.6438356164383562
0.21,400,"[[141, 97], [59, 103]]",141,59,97,59,200,200,238,162,244,156,0.61,0.592436974789916,0.705,0.515,0.485,0.295,0.6438356164383562
0.211,400,"[[141, 97], [59, 103]]",141,59,97,59,200,200,238,162,244,156,0.61,0.592436974789916,0.705,0.515,0.485,0.295,0.6438356164383562
0.212,400,"[[140, 97], [60, 103]]",140,60,97,60,200,200,237,163,243,157,0.6075,0.5907172995780591,0.7,0.515,0.485,0.3,0.6407322654462242
0.213,400,"[[140, 97], [60, 103]]",140,60,97,60,200,200,237,163,243,157,0.6075,0.5907172995780591,0.7,0.515,0.485,0.3,0.6407322654462242
0.214,400,"[[140, 97], [60, 103]]",140,60,97,60,200,200,237,163,243,157,0.6075,0.5907172995780591,0.7,0.515,0.485,0.3,0.6407322654462242
0.215,400,"[[139, 96], [61, 104]]",139,61,96,61,200,200,235,165,243,157,0.6075,0.5914893617021276,0.695,0.52,0.48,0.305,0.639080459770115
0.216,400,"[[139, 96], [61, 104]]",139,61,96,61,200,200,235,165,243,157,0.6075,0.5914893617021276,0.695,0.52,0.48,0.305,0.639080459770115
0.217,400,"[[139, 96], [61, 104]]",139,61,96,61,200,200,235,165,243,157,0.6075,0.5914893617021276,0.695,0.52,0.48,0.305,0.639080459770115
0.218,400,"[[139, 96], [61, 104]]",139,61,96,61,200,200,235,165,243,157,0.6075,0.5914893617021276,0.695,0.52,0.48,0.305,0.639080459770115
0.219,400,"[[139, 96], [61, 104]]",139,61,96,61,200,200,235,165,243,157,0.6075,0.5914893617021276,0.695,0.52,0.48,0.305,0.639080459770115
0.22,400,"[[139, 96], [61, 104]]",139,61,96,61,200,200,235,165,243,157,0.6075,0.5914893617021276,0.695,0.52,0.48,0.305,0.639080459770115
0.221,400,"[[139, 96], [61, 104]]",139,61,96,61,200,200,235,165,243,157,0.6075,0.5914893617021276,0.695,0.52,0.48,0.305,0.639080459770115
0.222,400,"[[139, 96], [61, 104]]",139,61,96,61,200,200,235,165,243,157,0.6075,0.5914893617021276,0.695,0.52,0.48,0.305,0.639080459770115
0.223,400,"[[139, 96], [61, 104]]",139,61,96,61,200,200,235,165,243,157,0.6075,0.5914893617021276,0.695,0.52,0.48,0.305,0.639080459770115
0.224,400,"[[139, 96], [61, 104]]",139,61,96,61,200,200,235,165,243,157,0.6075,0.5914893617021276,0.695,0.52,0.48,0.305,0.639080459770115
0.225,400,"[[138, 96], [62, 104]]",138,62,96,62,200,200,234,166,242,158,0.605,0.5897435897435898,0.69,0.52,0.48,0.31,0.6359447004608294
0.226,400,"[[138, 96], [62, 104]]",138,62,96,62,200,200,234,166,242,158,0.605,0.5897435897435898,0.69,0.52,0.48,0.31,0.6359447004608294
0.227,400,"[[137, 96], [63, 104]]",137,63,96,63,200,200,233,167,241,159,0.6025,0.5879828326180258,0.685,0.52,0.48,0.315,0.6327944572748267
0.228,400,"[[137, 96], [63, 104]]",137,63,96,63,200,200,233,167,241,159,0.6025,0.5879828326180258,0.685,0.52,0.48,0.315,0.6327944572748267
0.229,400,"[[137, 96], [63, 104]]",137,63,96,63,200,200,233,167,241,159,0.6025,0.5879828326180258,0.685,0.52,0.48,0.315,0.6327944572748267
0.23,400,"[[137, 96], [63, 104]]",137,63,96,63,200,200,233,167,241,159,0.6025,0.5879828326180258,0.685,0.52,0.48,0.315,0.6327944572748267
0.231,400,"[[137, 96], [63, 104]]",137,63,96,63,200,200,233,167,241,159,0.6025,0.5879828326180258,0.685,0.52,0.48,0.315,0.6327944572748267
0.232,400,"[[137, 96], [63, 104]]",137,63,96,63,200,200,233,167,241,159,0.6025,0.5879828326180258,0.685,0.52,0.48,0.315,0.6327944572748267
0.233,400,"[[137, 96], [63, 104]]",137,63,96,63,200,200,233,167,241,159,0.6025,0.5879828326180258,0.685,0.52,0.48,0.315,0.6327944572748267
0.234,400,"[[137, 96], [63, 104]]",137,63,96,63,200,200,233,167,241,159,0.6025,0.5879828326180258,0.685,0.52,0.48,0.315,0.6327944572748267
0.235,400,"[[137, 96], [63, 104]]",137,63,96,63,200,200,233,167,241,159,0.6025,0.5879828326180258,0.685,0.52,0.48,0.315,0.6327944572748267
0.236,400,"[[137, 96], [63, 104]]",137,63,96,63,200,200,233,167,241,159,0.6025,0.5879828326180258,0.685,0.52,0.48,0.315,0.6327944572748267
0.237,400,"[[137, 95], [63, 105]]",137,63,95,63,200,200,232,168,242,158,0.605,0.5905172413793104,0.685,0.525,0.475,0.315,0.6342592592592593
0.238,400,"[[137, 94], [63, 106]]",137,63,94,63,200,200,231,169,243,157,0.6075,0.5930735930735931,0.685,0.53,0.47,0.315,0.6357308584686776
0.239,400,"[[137, 94], [63, 106]]",137,63,94,63,200,200,231,169,243,157,0.6075,0.5930735930735931,0.685,0.53,0.47,0.315,0.6357308584686776
0.24,400,"[[137, 94], [63, 106]]",137,63,94,63,200,200,231,169,243,157,0.6075,0.5930735930735931,0.685,0.53,0.47,0.315,0.6357308584686776
0.241,400,"[[137, 94], [63, 106]]",137,63,94,63,200,200,231,169,243,157,0.6075,0.5930735930735931,0.685,0.53,0.47,0.315,0.6357308584686776
0.242,400,"[[137, 94], [63, 106]]",137,63,94,63,200,200,231,169,243,157,0.6075,0.5930735930735931,0.685,0.53,0.47,0.315,0.6357308584686776
0.243,400,"[[137, 94], [63, 106]]",137,63,94,63,200,200,231,169,243,157,0.6075,0.5930735930735931,0.685,0.53,0.47,0.315,0.6357308584686776
0.244,400,"[[137, 94], [63, 106]]",137,63,94,63,200,200,231,169,243,157,0.6075,0.5930735930735931,0.685,0.53,0.47,0.315,0.6357308584686776
0.245,400,"[[137, 94], [63, 106]]",137,63,94,63,200,200,231,169,243,157,0.6075,0.5930735930735931,0.685,0.53,0.47,0.315,0.6357308584686776
0.246,400,"[[137, 94], [63, 106]]",137,63,94,63,200,200,231,169,243,157,0.6075,0.5930735930735931,0.685,0.53,0.47,0.315,0.6357308584686776
0.247,400,"[[137, 94], [63, 106]]",137,63,94,63,200,200,231,169,243,157,0.6075,0.5930735930735931,0.685,0.53,0.47,0.315,0.6357308584686776
0.248,400,"[[137, 94], [63, 106]]",137,63,94,63,200,200,231,169,243,157,0.6075,0.5930735930735931,0.685,0.53,0.47,0.315,0.6357308584686776
0.249,400,"[[137, 93], [63, 107]]",137,63,93,63,200,200,230,170,244,156,0.61,0.5956521739130435,0.685,0.535,0.465,0.315,0.6372093023255815
0.25,400,"[[137, 93], [63, 107]]",137,63,93,63,200,200,230,170,244,156,0.61,0.5956521739130435,0.685,0.535,0.465,0.315,0.6372093023255815
0.251,400,"[[137, 93], [63, 107]]",137,63,93,63,200,200,230,170,244,156,0.61,0.5956521739130435,0.685,0.535,0.465,0.315,0.6372093023255815
0.252,400,"[[137, 93], [63, 107]]",137,63,93,63,200,200,230,170,244,156,0.61,0.5956521739130435,0.685,0.535,0.465,0.315,0.6372093023255815
0.253,400,"[[137, 93], [63, 107]]",137,63,93,63,200,200,230,170,244,156,0.61,0.5956521739130435,0.685,0.535,0.465,0.315,0.6372093023255815
0.254,400,"[[137, 93], [63, 107]]",137,63,93,63,200,200,230,170,244,156,0.61,0.5956521739130435,0.685,0.535,0.465,0.315,0.6372093023255815
0.255,400,"[[137, 93], [63, 107]]",137,63,93,63,200,200,230,170,244,156,0.61,0.5956521739130435,0.685,0.535,0.465,0.315,0.6372093023255815
0.256,400,"[[137, 93], [63, 107]]",137,63,93,63,200,200,230,170,244,156,0.61,0.5956521739130435,0.685,0.535,0.465,0.315,0.6372093023255815
0.257,400,"[[137, 93], [63, 107]]",137,63,93,63,200,200,230,170,244,156,0.61,0.5956521739130435,0.685,0.535,0.465,0.315,0.6372093023255815
0.258,400,"[[137, 93], [63, 107]]",137,63,93,63,200,200,230,170,244,156,0.61,0.5956521739130435,0.685,0.535,0.465,0.315,0.6372093023255815
0.259,400,"[[137, 93], [63, 107]]",137,63,93,63,200,200,230,170,244,156,0.61,0.5956521739130435,0.685,0.535,0.465,0.315,0.6372093023255815
0.26,400,"[[137, 93], [63, 107]]",137,63,93,63,200,200,230,170,244,156,0.61,0.5956521739130435,0.685,0.535,0.465,0.315,0.6372093023255815
0.261,400,"[[137, 93], [63, 107]]",137,63,93,63,200,200,230,170,244,156,0.61,0.5956521739130435,0.685,0.535,0.465,0.315,0.6372093023255815
0.262,400,"[[137, 93], [63, 107]]",137,63,93,63,200,200,230,170,244,156,0.61,0.5956521739130435,0.685,0.535,0.465,0.315,0.6372093023255815
0.263,400,"[[137, 93], [63, 107]]",137,63,93,63,200,200,230,170,244,156,0.61,0.5956521739130435,0.685,0.535,0.465,0.315,0.6372093023255815
0.264,400,"[[137, 93], [63, 107]]",137,63,93,63,200,200,230,170,244,156,0.61,0.5956521739130435,0.685,0.535,0.465,0.315,0.6372093023255815
0.265,400,"[[137, 93], [63, 107]]",137,63,93,63,200,200,230,170,244,156,0.61,0.5956521739130435,0.685,0.535,0.465,0.315,0.6372093023255815
0.266,400,"[[137, 93], [63, 107]]",137,63,93,63,200,200,230,170,244,156,0.61,0.5956521739130435,0.685,0.535,0.465,0.315,0.6372093023255815
0.267,400,"[[137, 93], [63, 107]]",137,63,93,63,200,200,230,170,244,156,0.61,0.5956521739130435,0.685,0.535,0.465,0.315,0.6372093023255815
0.268,400,"[[137, 93], [63, 107]]",137,63,93,63,200,200,230,170,244,156,0.61,0.5956521739130435,0.685,0.535,0.465,0.315,0.6372093023255815
0.269,400,"[[137, 93], [63, 107]]",137,63,93,63,200,200,230,170,244,156,0.61,0.5956521739130435,0.685,0.535,0.465,0.315,0.6372093023255815
0.27,400,"[[137, 93], [63, 107]]",137,63,93,63,200,200,230,170,244,156,0.61,0.5956521739130435,0.685,0.535,0.465,0.315,0.6372093023255815
0.271,400,"[[137, 93], [63, 107]]",137,63,93,63,200,200,230,170,244,156,0.61,0.5956521739130435,0.685,0.535,0.465,0.315,0.6372093023255815
0.272,400,"[[137, 93], [63, 107]]",137,63,93,63,200,200,230,170,244,156,0.61,0.5956521739130435,0.685,0.535,0.465,0.315,0.6372093023255815
0.273,400,"[[137, 93], [63, 107]]",137,63,93,63,200,200,230,170,244,156,0.61,0.5956521739130435,0.685,0.535,0.465,0.315,0.6372093023255815
0.274,400,"[[137, 93], [63, 107]]",137,63,93,63,200,200,230,170,244,156,0.61,0.5956521739130435,0.685,0.535,0.465,0.315,0.6372093023255815
0.275,400,"[[137, 93], [63, 107]]",137,63,93,63,200,200,230,170,244,156,0.61,0.5956521739130435,0.685,0.535,0.465,0.315,0.6372093023255815
0.276,400,"[[137, 93], [63, 107]]",137,63,93,63,200,200,230,170,244,156,0.61,0.5956521739130435,0.685,0.535,0.465,0.315,0.6372093023255815
0.277,400,"[[137, 93], [63, 107]]",137,63,93,63,200,200,230,170,244,156,0.61,0.5956521739130435,0.685,0.535,0.465,0.315,0.6372093023255815
0.278,400,"[[136, 93], [64, 107]]",136,64,93,64,200,200,229,171,243,157,0.6075,0.5938864628820961,0.68,0.535,0.465,0.32,0.634032634032634
0.279,400,"[[135, 93], [65, 107]]",135,65,93,65,200,200,228,172,242,158,0.605,0.5921052631578947,0.675,0.535,0.465,0.325,0.6308411214953271
0.28,400,"[[135, 93], [65, 107]]",135,65,93,65,200,200,228,172,242,158,0.605,0.5921052631578947,0.675,0.535,0.465,0.325,0.6308411214953271
0.281,400,"[[135, 93], [65, 107]]",135,65,93,65,200,200,228,172,242,158,0.605,0.5921052631578947,0.675,0.535,0.465,0.325,0.6308411214953271
0.282,400,"[[135, 93], [65, 107]]",135,65,93,65,200,200,228,172,242,158,0.605,0.5921052631578947,0.675,0.535,0.465,0.325,0.6308411214953271
0.283,400,"[[135, 93], [65, 107]]",135,65,93,65,200,200,228,172,242,158,0.605,0.5921052631578947,0.675,0.535,0.465,0.325,0.6308411214953271
0.284,400,"[[135, 93], [65, 107]]",135,65,93,65,200,200,228,172,242,158,0.605,0.5921052631578947,0.675,0.535,0.465,0.325,0.6308411214953271
0.285,400,"[[135, 93], [65, 107]]",135,65,93,65,200,200,228,172,242,158,0.605,0.5921052631578947,0.675,0.535,0.465,0.325,0.6308411214953271
0.286,400,"[[135, 93], [65, 107]]",135,65,93,65,200,200,228,172,242,158,0.605,0.5921052631578947,0.675,0.535,0.465,0.325,0.6308411214953271
0.287,400,"[[135, 93], [65, 107]]",135,65,93,65,200,200,228,172,242,158,0.605,0.5921052631578947,0.675,0.535,0.465,0.325,0.6308411214953271
0.288,400,"[[135, 93], [65, 107]]",135,65,93,65,200,200,228,172,242,158,0.605,0.5921052631578947,0.675,0.535,0.465,0.325,0.6308411214953271
0.289,400,"[[135, 93], [65, 107]]",135,65,93,65,200,200,228,172,242,158,0.605,0.5921052631578947,0.675,0.535,0.465,0.325,0.6308411214953271
0.29,400,"[[135, 93], [65, 107]]",135,65,93,65,200,200,228,172,242,158,0.605,0.5921052631578947,0.675,0.535,0.465,0.325,0.6308411214953271
0.291,400,"[[135, 93], [65, 107]]",135,65,93,65,200,200,228,172,242,158,0.605,0.5921052631578947,0.675,0.535,0.465,0.325,0.6308411214953271
0.292,400,"[[135, 93], [65, 107]]",135,65,93,65,200,200,228,172,242,158,0.605,0.5921052631578947,0.675,0.535,0.465,0.325,0.6308411214953271
0.293,400,"[[135, 93], [65, 107]]",135,65,93,65,200,200,228,172,242,158,0.605,0.5921052631578947,0.675,0.535,0.465,0.325,0.6308411214953271
0.294,400,"[[133, 93], [67, 107]]",133,67,93,67,200,200,226,174,240,160,0.6,0.588495575221239,0.665,0.535,0.465,0.335,0.624413145539906
0.295,400,"[[133, 93], [67, 107]]",133,67,93,67,200,200,226,174,240,160,0.6,0.588495575221239,0.665,0.535,0.465,0.335,0.624413145539906
0.296,400,"[[132, 93], [68, 107]]",132,68,93,68,200,200,225,175,239,161,0.5975,0.5866666666666667,0.66,0.535,0.465,0.34,0.6211764705882354
0.297,400,"[[132, 93], [68, 107]]",132,68,93,68,200,200,225,175,239,161,0.5975,0.5866666666666667,0.66,0.535,0.465,0.34,0.6211764705882354
0.298,400,"[[132, 93], [68, 107]]",132,68,93,68,200,200,225,175,239,161,0.5975,0.5866666666666667,0.66,0.535,0.465,0.34,0.6211764705882354
0.299,400,"[[132, 93], [68, 107]]",132,68,93,68,200,200,225,175,239,161,0.5975,0.5866666666666667,0.66,0.535,0.465,0.34,0.6211764705882354
0.3,400,"[[132, 93], [68, 107]]",132,68,93,68,200,200,225,175,239,161,0.5975,0.5866666666666667,0.66,0.535,0.465,0.34,0.6211764705882354
0.301,400,"[[132, 92], [68, 108]]",132,68,92,68,200,200,224,176,240,160,0.6,0.5892857142857143,0.66,0.54,0.46,0.34,0.6226415094339622
0.302,400,"[[132, 92], [68, 108]]",132,68,92,68,200,200,224,176,240,160,0.6,0.5892857142857143,0.66,0.54,0.46,0.34,0.6226415094339622
0.303,400,"[[132, 92], [68, 108]]",132,68,92,68,200,200,224,176,240,160,0.6,0.5892857142857143,0.66,0.54,0.46,0.34,0.6226415094339622
0.304,400,"[[132, 92], [68, 108]]",132,68,92,68,200,200,224,176,240,160,0.6,0.5892857142857143,0.66,0.54,0.46,0.34,0.6226415094339622
0.305,400,"[[132, 91], [68, 109]]",132,68,91,68,200,200,223,177,241,159,0.6025,0.5919282511210763,0.66,0.545,0.455,0.34,0.624113475177305
0.306,400,"[[132, 91], [68, 109]]",132,68,91,68,200,200,223,177,241,159,0.6025,0.5919282511210763,0.66,0.545,0.455,0.34,0.624113475177305
0.307,400,"[[132, 91], [68, 109]]",132,68,91,68,200,200,223,177,241,159,0.6025,0.5919282511210763,0.66,0.545,0.455,0.34,0.624113475177305
0.308,400,"[[131, 91], [69, 109]]",131,69,91,69,200,200,222,178,240,160,0.6,0.5900900900900901,0.655,0.545,0.455,0.345,0.6208530805687205
0.309,400,"[[131, 91], [69, 109]]",131,69,91,69,200,200,222,178,240,160,0.6,0.5900900900900901,0.655,0.545,0.455,0.345,0.6208530805687205
0.31,400,"[[131, 91], [69, 109]]",131,69,91,69,200,200,222,178,240,160,0.6,0.5900900900900901,0.655,0.545,0.455,0.345,0.6208530805687205
0.311,400,"[[131, 91], [69, 109]]",131,69,91,69,200,200,222,178,240,160,0.6,0.5900900900900901,0.655,0.545,0.455,0.345,0.6208530805687205
0.312,400,"[[131, 89], [69, 111]]",131,69,89,69,200,200,220,180,242,158,0.605,0.5954545454545455,0.655,0.555,0.445,0.345,0.6238095238095238
0.313,400,"[[131, 89], [69, 111]]",131,69,89,69,200,200,220,180,242,158,0.605,0.5954545454545455,0.655,0.555,0.445,0.345,0.6238095238095238
0.314,400,"[[131, 88], [69, 112]]",131,69,88,69,200,200,219,181,243,157,0.6075,0.5981735159817352,0.655,0.56,0.44,0.345,0.6252983293556086
0.315,400,"[[131, 88], [69, 112]]",131,69,88,69,200,200,219,181,243,157,0.6075,0.5981735159817352,0.655,0.56,0.44,0.345,0.6252983293556086
0.316,400,"[[130, 88], [70, 112]]",130,70,88,70,200,200,218,182,242,158,0.605,0.5963302752293578,0.65,0.56,0.44,0.35,0.6220095693779903
0.317,400,"[[130, 88], [70, 112]]",130,70,88,70,200,200,218,182,242,158,0.605,0.5963302752293578,0.65,0.56,0.44,0.35,0.6220095693779903
0.318,400,"[[130, 88], [70, 112]]",130,70,88,70,200,200,218,182,242,158,0.605,0.5963302752293578,0.65,0.56,0.44,0.35,0.6220095693779903
0.319,400,"[[130, 88], [70, 112]]",130,70,88,70,200,200,218,182,242,158,0.605,0.5963302752293578,0.65,0.56,0.44,0.35,0.6220095693779903
0.32,400,"[[130, 88], [70, 112]]",130,70,88,70,200,200,218,182,242,158,0.605,0.5963302752293578,0.65,0.56,0.44,0.35,0.6220095693779903
0.321,400,"[[130, 88], [70, 112]]",130,70,88,70,200,200,218,182,242,158,0.605,0.5963302752293578,0.65,0.56,0.44,0.35,0.6220095693779903
0.322,400,"[[130, 88], [70, 112]]",130,70,88,70,200,200,218,182,242,158,0.605,0.5963302752293578,0.65,0.56,0.44,0.35,0.6220095693779903
0.323,400,"[[130, 88], [70, 112]]",130,70,88,70,200,200,218,182,242,158,0.605,0.5963302752293578,0.65,0.56,0.44,0.35,0.6220095693779903
0.324,400,"[[130, 88], [70, 112]]",130,70,88,70,200,200,218,182,242,158,0.605,0.5963302752293578,0.65,0.56,0.44,0.35,0.6220095693779903
0.325,400,"[[130, 88], [70, 112]]",130,70,88,70,200,200,218,182,242,158,0.605,0.5963302752293578,0.65,0.56,0.44,0.35,0.6220095693779903
0.326,400,"[[130, 88], [70, 112]]",130,70,88,70,200,200,218,182,242,158,0.605,0.5963302752293578,0.65,0.56,0.44,0.35,0.6220095693779903
0.327,400,"[[130, 88], [70, 112]]",130,70,88,70,200,200,218,182,242,158,0.605,0.5963302752293578,0.65,0.56,0.44,0.35,0.6220095693779903
0.328,400,"[[130, 88], [70, 112]]",130,70,88,70,200,200,218,182,242,158,0.605,0.5963302752293578,0.65,0.56,0.44,0.35,0.6220095693779903
0.329,400,"[[130, 88], [70, 112]]",130,70,88,70,200,200,218,182,242,158,0.605,0.5963302752293578,0.65,0.56,0.44,0.35,0.6220095693779903
0.33,400,"[[130, 87], [70, 113]]",130,70,87,70,200,200,217,183,243,157,0.6075,0.5990783410138248,0.65,0.565,0.435,0.35,0.6235011990407674
0.331,400,"[[130, 87], [70, 113]]",130,70,87,70,200,200,217,183,243,157,0.6075,0.5990783410138248,0.65,0.565,0.435,0.35,0.6235011990407674
0.332,400,"[[130, 87], [70, 113]]",130,70,87,70,200,200,217,183,243,157,0.6075,0.5990783410138248,0.65,0.565,0.435,0.35,0.6235011990407674
0.333,400,"[[130, 87], [70, 113]]",130,70,87,70,200,200,217,183,243,157,0.6075,0.5990783410138248,0.65,0.565,0.435,0.35,0.6235011990407674
0.334,400,"[[130, 87], [70, 113]]",130,70,87,70,200,200,217,183,243,157,0.6075,0.5990783410138248,0.65,0.565,0.435,0.35,0.6235011990407674
0.335,400,"[[130, 87], [70, 113]]",130,70,87,70,200,200,217,183,243,157,0.6075,0.5990783410138248,0.65,0.565,0.435,0.35,0.6235011990407674
0.336,400,"[[130, 87], [70, 113]]",130,70,87,70,200,200,217,183,243,157,0.6075,0.5990783410138248,0.65,0.565,0.435,0.35,0.6235011990407674
0.337,400,"[[130, 87], [70, 113]]",130,70,87,70,200,200,217,183,243,157,0.6075,0.5990783410138248,0.65,0.565,0.435,0.35,0.6235011990407674
0.338,400,"[[130, 87], [70, 113]]",130,70,87,70,200,200,217,183,243,157,0.6075,0.5990783410138248,0.65,0.565,0.435,0.35,0.6235011990407674
0.339,400,"[[130, 87], [70, 113]]",130,70,87,70,200,200,217,183,243,157,0.6075,0.5990783410138248,0.65,0.565,0.435,0.35,0.6235011990407674
0.34,400,"[[130, 87], [70, 113]]",130,70,87,70,200,200,217,183,243,157,0.6075,0.5990783410138248,0.65,0.565,0.435,0.35,0.6235011990407674
0.341,400,"[[130, 87], [70, 113]]",130,70,87,70,200,200,217,183,243,157,0.6075,0.5990783410138248,0.65,0.565,0.435,0.35,0.6235011990407674
0.342,400,"[[130, 87], [70, 113]]",130,70,87,70,200,200,217,183,243,157,0.6075,0.5990783410138248,0.65,0.565,0.435,0.35,0.6235011990407674
0.343,400,"[[130, 87], [70, 113]]",130,70,87,70,200,200,217,183,243,157,0.6075,0.5990783410138248,0.65,0.565,0.435,0.35,0.6235011990407674
0.344,400,"[[130, 87], [70, 113]]",130,70,87,70,200,200,217,183,243,157,0.6075,0.5990783410138248,0.65,0.565,0.435,0.35,0.6235011990407674
0.345,400,"[[130, 86], [70, 114]]",130,70,86,70,200,200,216,184,244,156,0.61,0.6018518518518519,0.65,0.57,0.43,0.35,0.625
0.346,400,"[[129, 86], [71, 114]]",129,71,86,71,200,200,215,185,243,157,0.6075,0.6,0.645,0.57,0.43,0.355,0.6216867469879518
0.347,400,"[[129, 86], [71, 114]]",129,71,86,71,200,200,215,185,243,157,0.6075,0.6,0.645,0.57,0.43,0.355,0.6216867469879518
0.348,400,"[[129, 86], [71, 114]]",129,71,86,71,200,200,215,185,243,157,0.6075,0.6,0.645,0.57,0.43,0.355,0.6216867469879518
0.349,400,"[[129, 86], [71, 114]]",129,71,86,71,200,200,215,185,243,157,0.6075,0.6,0.645,0.57,0.43,0.355,0.6216867469879518
0.35,400,"[[129, 86], [71, 114]]",129,71,86,71,200,200,215,185,243,157,0.6075,0.6,0.645,0.57,0.43,0.355,0.6216867469879518
0.351,400,"[[129, 86], [71, 114]]",129,71,86,71,200,200,215,185,243,157,0.6075,0.6,0.645,0.57,0.43,0.355,0.6216867469879518
0.352,400,"[[129, 86], [71, 114]]",129,71,86,71,200,200,215,185,243,157,0.6075,0.6,0.645,0.57,0.43,0.355,0.6216867469879518
0.353,400,"[[129, 86], [71, 114]]",129,71,86,71,200,200,215,185,243,157,0.6075,0.6,0.645,0.57,0.43,0.355,0.6216867469879518
0.354,400,"[[129, 85], [71, 115]]",129,71,85,71,200,200,214,186,244,156,0.61,0.602803738317757,0.645,0.575,0.425,0.355,0.6231884057971016
0.355,400,"[[129, 85], [71, 115]]",129,71,85,71,200,200,214,186,244,156,0.61,0.602803738317757,0.645,0.575,0.425,0.355,0.6231884057971016
0.356,400,"[[129, 85], [71, 115]]",129,71,85,71,200,200,214,186,244,156,0.61,0.602803738317757,0.645,0.575,0.425,0.355,0.6231884057971016
0.357,400,"[[129, 85], [71, 115]]",129,71,85,71,200,200,214,186,244,156,0.61,0.602803738317757,0.645,0.575,0.425,0.355,0.6231884057971016
0.358,400,"[[129, 84], [71, 116]]",129,71,84,71,200,200,213,187,245,155,0.6125,0.6056338028169014,0.645,0.58,0.42,0.355,0.6246973365617433
0.359,400,"[[129, 84], [71, 116]]",129,71,84,71,200,200,213,187,245,155,0.6125,0.6056338028169014,0.645,0.58,0.42,0.355,0.6246973365617433
0.36,400,"[[129, 84], [71, 116]]",129,71,84,71,200,200,213,187,245,155,0.6125,0.6056338028169014,0.645,0.58,0.42,0.355,0.6246973365617433
0.361,400,"[[129, 84], [71, 116]]",129,71,84,71,200,200,213,187,245,155,0.6125,0.6056338028169014,0.645,0.58,0.42,0.355,0.6246973365617433
0.362,400,"[[129, 84], [71, 116]]",129,71,84,71,200,200,213,187,245,155,0.6125,0.6056338028169014,0.645,0.58,0.42,0.355,0.6246973365617433
0.363,400,"[[129, 83], [71, 117]]",129,71,83,71,200,200,212,188,246,154,0.615,0.6084905660377359,0.645,0.585,0.415,0.355,0.6262135922330097
0.364,400,"[[129, 83], [71, 117]]",129,71,83,71,200,200,212,188,246,154,0.615,0.6084905660377359,0.645,0.585,0.415,0.355,0.6262135922330097
0.365,400,"[[129, 83], [71, 117]]",129,71,83,71,200,200,212,188,246,154,0.615,0.6084905660377359,0.645,0.585,0.415,0.355,0.6262135922330097
0.366,400,"[[129, 83], [71, 117]]",129,71,83,71,200,200,212,188,246,154,0.615,0.6084905660377359,0.645,0.585,0.415,0.355,0.6262135922330097
0.367,400,"[[129, 83], [71, 117]]",129,71,83,71,200,200,212,188,246,154,0.615,0.6084905660377359,0.645,0.585,0.415,0.355,0.6262135922330097
0.368,400,"[[129, 83], [71, 117]]",129,71,83,71,200,200,212,188,246,154,0.615,0.6084905660377359,0.645,0.585,0.415,0.355,0.6262135922330097
0.369,400,"[[129, 83], [71, 117]]",129,71,83,71,200,200,212,188,246,154,0.615,0.6084905660377359,0.645,0.585,0.415,0.355,0.6262135922330097
0.37,400,"[[129, 83], [71, 117]]",129,71,83,71,200,200,212,188,246,154,0.615,0.6084905660377359,0.645,0.585,0.415,0.355,0.6262135922330097
0.371,400,"[[129, 83], [71, 117]]",129,71,83,71,200,200,212,188,246,154,0.615,0.6084905660377359,0.645,0.585,0.415,0.355,0.6262135922330097
0.372,400,"[[129, 82], [71, 118]]",129,71,82,71,200,200,211,189,247,153,0.6175,0.6113744075829384,0.645,0.59,0.41,0.355,0.6277372262773723
0.373,400,"[[129, 82], [71, 118]]",129,71,82,71,200,200,211,189,247,153,0.6175,0.6113744075829384,0.645,0.59,0.41,0.355,0.6277372262773723
0.374,400,"[[129, 82], [71, 118]]",129,71,82,71,200,200,211,189,247,153,0.6175,0.6113744075829384,0.645,0.59,0.41,0.355,0.6277372262773723
0.375,400,"[[129, 82], [71, 118]]",129,71,82,71,200,200,211,189,247,153,0.6175,0.6113744075829384,0.645,0.59,0.41,0.355,0.6277372262773723
0.376,400,"[[129, 82], [71, 118]]",129,71,82,71,200,200,211,189,247,153,0.6175,0.6113744075829384,0.645,0.59,0.41,0.355,0.6277372262773723
0.377,400,"[[129, 82], [71, 118]]",129,71,82,71,200,200,211,189,247,153,0.6175,0.6113744075829384,0.645,0.59,0.41,0.355,0.6277372262773723
0.378,400,"[[129, 81], [71, 119]]",129,71,81,71,200,200,210,190,248,152,0.62,0.6142857142857143,0.645,0.595,0.405,0.355,0.6292682926829268
0.379,400,"[[129, 81], [71, 119]]",129,71,81,71,200,200,210,190,248,152,0.62,0.6142857142857143,0.645,0.595,0.405,0.355,0.6292682926829268
0.38,400,"[[129, 81], [71, 119]]",129,71,81,71,200,200,210,190,248,152,0.62,0.6142857142857143,0.645,0.595,0.405,0.355,0.6292682926829268
0.381,400,"[[129, 81], [71, 119]]",129,71,81,71,200,200,210,190,248,152,0.62,0.6142857142857143,0.645,0.595,0.405,0.355,0.6292682926829268
0.382,400,"[[129, 80], [71, 120]]",129,71,80,71,200,200,209,191,249,151,0.6225,0.6172248803827751,0.645,0.6,0.4,0.355,0.6308068459657702
0.383,400,"[[129, 80], [71, 120]]",129,71,80,71,200,200,209,191,249,151,0.6225,0.6172248803827751,0.645,0.6,0.4,0.355,0.6308068459657702
0.384,400,"[[129, 80], [71, 120]]",129,71,80,71,200,200,209,191,249,151,0.6225,0.6172248803827751,0.645,0.6,0.4,0.355,0.6308068459657702
0.385,400,"[[129, 80], [71, 120]]",129,71,80,71,200,200,209,191,249,151,0.6225,0.6172248803827751,0.645,0.6,0.4,0.355,0.6308068459657702
0.386,400,"[[129, 80], [71, 120]]",129,71,80,71,200,200,209,191,249,151,0.6225,0.6172248803827751,0.645,0.6,0.4,0.355,0.6308068459657702
0.387,400,"[[129, 80], [71, 120]]",129,71,80,71,200,200,209,191,249,151,0.6225,0.6172248803827751,0.645,0.6,0.4,0.355,0.6308068459657702
0.388,400,"[[129, 80], [71, 120]]",129,71,80,71,200,200,209,191,249,151,0.6225,0.6172248803827751,0.645,0.6,0.4,0.355,0.6308068459657702
0.389,400,"[[129, 80], [71, 120]]",129,71,80,71,200,200,209,191,249,151,0.6225,0.6172248803827751,0.645,0.6,0.4,0.355,0.6308068459657702
0.39,400,"[[129, 80], [71, 120]]",129,71,80,71,200,200,209,191,249,151,0.6225,0.6172248803827751,0.645,0.6,0.4,0.355,0.6308068459657702
0.391,400,"[[129, 80], [71, 120]]",129,71,80,71,200,200,209,191,249,151,0.6225,0.6172248803827751,0.645,0.6,0.4,0.355,0.6308068459657702
0.392,400,"[[129, 80], [71, 120]]",129,71,80,71,200,200,209,191,249,151,0.6225,0.6172248803827751,0.645,0.6,0.4,0.355,0.6308068459657702
0.393,400,"[[129, 80], [71, 120]]",129,71,80,71,200,200,209,191,249,151,0.6225,0.6172248803827751,0.645,0.6,0.4,0.355,0.6308068459657702
0.394,400,"[[129, 80], [71, 120]]",129,71,80,71,200,200,209,191,249,151,0.6225,0.6172248803827751,0.645,0.6,0.4,0.355,0.6308068459657702
0.395,400,"[[129, 80], [71, 120]]",129,71,80,71,200,200,209,191,249,151,0.6225,0.6172248803827751,0.645,0.6,0.4,0.355,0.6308068459657702
0.396,400,"[[129, 79], [71, 121]]",129,71,79,71,200,200,208,192,250,150,0.625,0.6201923076923077,0.645,0.605,0.395,0.355,0.6323529411764707
0.397,400,"[[129, 79], [71, 121]]",129,71,79,71,200,200,208,192,250,150,0.625,0.6201923076923077,0.645,0.605,0.395,0.355,0.6323529411764707
0.398,400,"[[129, 79], [71, 121]]",129,71,79,71,200,200,208,192,250,150,0.625,0.6201923076923077,0.645,0.605,0.395,0.355,0.6323529411764707
0.399,400,"[[129, 79], [71, 121]]",129,71,79,71,200,200,208,192,250,150,0.625,0.6201923076923077,0.645,0.605,0.395,0.355,0.6323529411764707
0.4,400,"[[129, 78], [71, 122]]",129,71,78,71,200,200,207,193,251,149,0.6275,0.6231884057971014,0.645,0.61,0.39,0.355,0.6339066339066338
0.401,400,"[[129, 78], [71, 122]]",129,71,78,71,200,200,207,193,251,149,0.6275,0.6231884057971014,0.645,0.61,0.39,0.355,0.6339066339066338
0.402,400,"[[129, 78], [71, 122]]",129,71,78,71,200,200,207,193,251,149,0.6275,0.6231884057971014,0.645,0.61,0.39,0.355,0.6339066339066338
0.403,400,"[[129, 78], [71, 122]]",129,71,78,71,200,200,207,193,251,149,0.6275,0.6231884057971014,0.645,0.61,0.39,0.355,0.6339066339066338
0.404,400,"[[129, 78], [71, 122]]",129,71,78,71,200,200,207,193,251,149,0.6275,0.6231884057971014,0.645,0.61,0.39,0.355,0.6339066339066338
0.405,400,"[[129, 78], [71, 122]]",129,71,78,71,200,200,207,193,251,149,0.6275,0.6231884057971014,0.645,0.61,0.39,0.355,0.6339066339066338
0.406,400,"[[129, 78], [71, 122]]",129,71,78,71,200,200,207,193,251,149,0.6275,0.6231884057971014,0.645,0.61,0.39,0.355,0.6339066339066338
0.407,400,"[[129, 78], [71, 122]]",129,71,78,71,200,200,207,193,251,149,0.6275,0.6231884057971014,0.645,0.61,0.39,0.355,0.6339066339066338
0.408,400,"[[129, 78], [71, 122]]",129,71,78,71,200,200,207,193,251,149,0.6275,0.6231884057971014,0.645,0.61,0.39,0.355,0.6339066339066338
0.409,400,"[[129, 78], [71, 122]]",129,71,78,71,200,200,207,193,251,149,0.6275,0.6231884057971014,0.645,0.61,0.39,0.355,0.6339066339066338
0.41,400,"[[129, 78], [71, 122]]",129,71,78,71,200,200,207,193,251,149,0.6275,0.6231884057971014,0.645,0.61,0.39,0.355,0.6339066339066338
0.411,400,"[[129, 78], [71, 122]]",129,71,78,71,200,200,207,193,251,149,0.6275,0.6231884057971014,0.645,0.61,0.39,0.355,0.6339066339066338
0.412,400,"[[129, 78], [71, 122]]",129,71,78,71,200,200,207,193,251,149,0.6275,0.6231884057971014,0.645,0.61,0.39,0.355,0.6339066339066338
0.413,400,"[[129, 78], [71, 122]]",129,71,78,71,200,200,207,193,251,149,0.6275,0.6231884057971014,0.645,0.61,0.39,0.355,0.6339066339066338
0.414,400,"[[129, 78], [71, 122]]",129,71,78,71,200,200,207,193,251,149,0.6275,0.6231884057971014,0.645,0.61,0.39,0.355,0.6339066339066338
0.415,400,"[[128, 78], [72, 122]]",128,72,78,72,200,200,206,194,250,150,0.625,0.6213592233009708,0.64,0.61,0.39,0.36,0.6305418719211823
0.416,400,"[[128, 78], [72, 122]]",128,72,78,72,200,200,206,194,250,150,0.625,0.6213592233009708,0.64,0.61,0.39,0.36,0.6305418719211823
0.417,400,"[[128, 78], [72, 122]]",128,72,78,72,200,200,206,194,250,150,0.625,0.6213592233009708,0.64,0.61,0.39,0.36,0.6305418719211823
0.418,400,"[[128, 78], [72, 122]]",128,72,78,72,200,200,206,194,250,150,0.625,0.6213592233009708,0.64,0.61,0.39,0.36,0.6305418719211823
0.419,400,"[[128, 78], [72, 122]]",128,72,78,72,200,200,206,194,250,150,0.625,0.6213592233009708,0.64,0.61,0.39,0.36,0.6305418719211823
0.42,400,"[[128, 78], [72, 122]]",128,72,78,72,200,200,206,194,250,150,0.625,0.6213592233009708,0.64,0.61,0.39,0.36,0.6305418719211823
0.421,400,"[[128, 78], [72, 122]]",128,72,78,72,200,200,206,194,250,150,0.625,0.6213592233009708,0.64,0.61,0.39,0.36,0.6305418719211823
0.422,400,"[[128, 78], [72, 122]]",128,72,78,72,200,200,206,194,250,150,0.625,0.6213592233009708,0.64,0.61,0.39,0.36,0.6305418719211823
0.423,400,"[[128, 78], [72, 122]]",128,72,78,72,200,200,206,194,250,150,0.625,0.6213592233009708,0.64,0.61,0.39,0.36,0.6305418719211823
0.424,400,"[[128, 78], [72, 122]]",128,72,78,72,200,200,206,194,250,150,0.625,0.6213592233009708,0.64,0.61,0.39,0.36,0.6305418719211823
0.425,400,"[[128, 78], [72, 122]]",128,72,78,72,200,200,206,194,250,150,0.625,0.6213592233009708,0.64,0.61,0.39,0.36,0.6305418719211823
0.426,400,"[[128, 78], [72, 122]]",128,72,78,72,200,200,206,194,250,150,0.625,0.6213592233009708,0.64,0.61,0.39,0.36,0.6305418719211823
0.427,400,"[[128, 78], [72, 122]]",128,72,78,72,200,200,206,194,250,150,0.625,0.6213592233009708,0.64,0.61,0.39,0.36,0.6305418719211823
0.428,400,"[[127, 78], [73, 122]]",127,73,78,73,200,200,205,195,249,151,0.6225,0.6195121951219512,0.635,0.61,0.39,0.365,0.6271604938271605
0.429,400,"[[124, 78], [76, 122]]",124,76,78,76,200,200,202,198,246,154,0.615,0.6138613861386139,0.62,0.61,0.39,0.38,0.6169154228855721
0.43,400,"[[124, 78], [76, 122]]",124,76,78,76,200,200,202,198,246,154,0.615,0.6138613861386139,0.62,0.61,0.39,0.38,0.6169154228855721
0.431,400,"[[124, 78], [76, 122]]",124,76,78,76,200,200,202,198,246,154,0.615,0.6138613861386139,0.62,0.61,0.39,0.38,0.6169154228855721
0.432,400,"[[124, 78], [76, 122]]",124,76,78,76,200,200,202,198,246,154,0.615,0.6138613861386139,0.62,0.61,0.39,0.38,0.6169154228855721
0.433,400,"[[124, 78], [76, 122]]",124,76,78,76,200,200,202,198,246,154,0.615,0.6138613861386139,0.62,0.61,0.39,0.38,0.6169154228855721
0.434,400,"[[124, 78], [76, 122]]",124,76,78,76,200,200,202,198,246,154,0.615,0.6138613861386139,0.62,0.61,0.39,0.38,0.6169154228855721
0.435,400,"[[124, 78], [76, 122]]",124,76,78,76,200,200,202,198,246,154,0.615,0.6138613861386139,0.62,0.61,0.39,0.38,0.6169154228855721
0.436,400,"[[124, 78], [76, 122]]",124,76,78,76,200,200,202,198,246,154,0.615,0.6138613861386139,0.62,0.61,0.39,0.38,0.6169154228855721
0.437,400,"[[123, 78], [77, 122]]",123,77,78,77,200,200,201,199,245,155,0.6125,0.6119402985074627,0.615,0.61,0.39,0.385,0.6134663341645885
0.438,400,"[[123, 78], [77, 122]]",123,77,78,77,200,200,201,199,245,155,0.6125,0.6119402985074627,0.615,0.61,0.39,0.385,0.6134663341645885
0.439,400,"[[123, 78], [77, 122]]",123,77,78,77,200,200,201,199,245,155,0.6125,0.6119402985074627,0.615,0.61,0.39,0.385,0.6134663341645885
0.44,400,"[[123, 78], [77, 122]]",123,77,78,77,200,200,201,199,245,155,0.6125,0.6119402985074627,0.615,0.61,0.39,0.385,0.6134663341645885
0.441,400,"[[123, 77], [77, 123]]",123,77,77,77,200,200,200,200,246,154,0.615,0.615,0.615,0.615,0.385,0.385,0.615
0.442,400,"[[123, 77], [77, 123]]",123,77,77,77,200,200,200,200,246,154,0.615,0.615,0.615,0.615,0.385,0.385,0.615
0.443,400,"[[123, 77], [77, 123]]",123,77,77,77,200,200,200,200,246,154,0.615,0.615,0.615,0.615,0.385,0.385,0.615
0.444,400,"[[123, 77], [77, 123]]",123,77,77,77,200,200,200,200,246,154,0.615,0.615,0.615,0.615,0.385,0.385,0.615
0.445,400,"[[123, 77], [77, 123]]",123,77,77,77,200,200,200,200,246,154,0.615,0.615,0.615,0.615,0.385,0.385,0.615
0.446,400,"[[123, 77], [77, 123]]",123,77,77,77,200,200,200,200,246,154,0.615,0.615,0.615,0.615,0.385,0.385,0.615
0.447,400,"[[123, 77], [77, 123]]",123,77,77,77,200,200,200,200,246,154,0.615,0.615,0.615,0.615,0.385,0.385,0.615
0.448,400,"[[122, 76], [78, 124]]",122,78,76,78,200,200,198,202,246,154,0.615,0.6161616161616161,0.61,0.62,0.38,0.39,0.6130653266331657
0.449,400,"[[122, 76], [78, 124]]",122,78,76,78,200,200,198,202,246,154,0.615,0.6161616161616161,0.61,0.62,0.38,0.39,0.6130653266331657
0.45,400,"[[122, 76], [78, 124]]",122,78,76,78,200,200,198,202,246,154,0.615,0.6161616161616161,0.61,0.62,0.38,0.39,0.6130653266331657
0.451,400,"[[122, 76], [78, 124]]",122,78,76,78,200,200,198,202,246,154,0.615,0.6161616161616161,0.61,0.62,0.38,0.39,0.6130653266331657
0.452,400,"[[122, 76], [78, 124]]",122,78,76,78,200,200,198,202,246,154,0.615,0.6161616161616161,0.61,0.62,0.38,0.39,0.6130653266331657
0.453,400,"[[122, 76], [78, 124]]",122,78,76,78,200,200,198,202,246,154,0.615,0.6161616161616161,0.61,0.62,0.38,0.39,0.6130653266331657
0.454,400,"[[121, 76], [79, 124]]",121,79,76,79,200,200,197,203,245,155,0.6125,0.6142131979695431,0.605,0.62,0.38,0.395,0.6095717884130982
0.455,400,"[[121, 76], [79, 124]]",121,79,76,79,200,200,197,203,245,155,0.6125,0.6142131979695431,0.605,0.62,0.38,0.395,0.6095717884130982
0.456,400,"[[121, 76], [79, 124]]",121,79,76,79,200,200,197,203,245,155,0.6125,0.6142131979695431,0.605,0.62,0.38,0.395,0.6095717884130982
0.457,400,"[[121, 75], [79, 125]]",121,79,75,79,200,200,196,204,246,154,0.615,0.6173469387755102,0.605,0.625,0.375,0.395,0.611111111111111
0.458,400,"[[121, 75], [79, 125]]",121,79,75,79,200,200,196,204,246,154,0.615,0.6173469387755102,0.605,0.625,0.375,0.395,0.611111111111111
0.459,400,"[[121, 75], [79, 125]]",121,79,75,79,200,200,196,204,246,154,0.615,0.6173469387755102,0.605,0.625,0.375,0.395,0.611111111111111
0.46,400,"[[121, 75], [79, 125]]",121,79,75,79,200,200,196,204,246,154,0.615,0.6173469387755102,0.605,0.625,0.375,0.395,0.611111111111111
0.461,400,"[[121, 75], [79, 125]]",121,79,75,79,200,200,196,204,246,154,0.615,0.6173469387755102,0.605,0.625,0.375,0.395,0.611111111111111
0.462,400,"[[121, 75], [79, 125]]",121,79,75,79,200,200,196,204,246,154,0.615,0.6173469387755102,0.605,0.625,0.375,0.395,0.611111111111111
0.463,400,"[[121, 74], [79, 126]]",121,79,74,79,200,200,195,205,247,153,0.6175,0.6205128205128205,0.605,0.63,0.37,0.395,0.6126582278481012
0.464,400,"[[121, 74], [79, 126]]",121,79,74,79,200,200,195,205,247,153,0.6175,0.6205128205128205,0.605,0.63,0.37,0.395,0.6126582278481012
0.465,400,"[[121, 74], [79, 126]]",121,79,74,79,200,200,195,205,247,153,0.6175,0.6205128205128205,0.605,0.63,0.37,0.395,0.6126582278481012
0.466,400,"[[121, 73], [79, 127]]",121,79,73,79,200,200,194,206,248,152,0.62,0.6237113402061856,0.605,0.635,0.365,0.395,0.6142131979695431
0.467,400,"[[121, 73], [79, 127]]",121,79,73,79,200,200,194,206,248,152,0.62,0.6237113402061856,0.605,0.635,0.365,0.395,0.6142131979695431
0.468,400,"[[121, 72], [79, 128]]",121,79,72,79,200,200,193,207,249,151,0.6225,0.6269430051813472,0.605,0.64,0.36,0.395,0.6157760814249363
0.469,400,"[[121, 72], [79, 128]]",121,79,72,79,200,200,193,207,249,151,0.6225,0.6269430051813472,0.605,0.64,0.36,0.395,0.6157760814249363
0.47,400,"[[121, 72], [79, 128]]",121,79,72,79,200,200,193,207,249,151,0.6225,0.6269430051813472,0.605,0.64,0.36,0.395,0.6157760814249363
0.471,400,"[[121, 72], [79, 128]]",121,79,72,79,200,200,193,207,249,151,0.6225,0.6269430051813472,0.605,0.64,0.36,0.395,0.6157760814249363
0.472,400,"[[121, 72], [79, 128]]",121,79,72,79,200,200,193,207,249,151,0.6225,0.6269430051813472,0.605,0.64,0.36,0.395,0.6157760814249363
0.473,400,"[[121, 72], [79, 128]]",121,79,72,79,200,200,193,207,249,151,0.6225,0.6269430051813472,0.605,0.64,0.36,0.395,0.6157760814249363
0.474,400,"[[121, 72], [79, 128]]",121,79,72,79,200,200,193,207,249,151,0.6225,0.6269430051813472,0.605,0.64,0.36,0.395,0.6157760814249363
0.475,400,"[[121, 72], [79, 128]]",121,79,72,79,200,200,193,207,249,151,0.6225,0.6269430051813472,0.605,0.64,0.36,0.395,0.6157760814249363
0.476,400,"[[121, 72], [79, 128]]",121,79,72,79,200,200,193,207,249,151,0.6225,0.6269430051813472,0.605,0.64,0.36,0.395,0.6157760814249363
0.477,400,"[[121, 72], [79, 128]]",121,79,72,79,200,200,193,207,249,151,0.6225,0.6269430051813472,0.605,0.64,0.36,0.395,0.6157760814249363
0.478,400,"[[121, 72], [79, 128]]",121,79,72,79,200,200,193,207,249,151,0.6225,0.6269430051813472,0.605,0.64,0.36,0.395,0.6157760814249363
0.479,400,"[[121, 72], [79, 128]]",121,79,72,79,200,200,193,207,249,151,0.6225,0.6269430051813472,0.605,0.64,0.36,0.395,0.6157760814249363
0.48,400,"[[121, 72], [79, 128]]",121,79,72,79,200,200,193,207,249,151,0.6225,0.6269430051813472,0.605,0.64,0.36,0.395,0.6157760814249363
0.481,400,"[[121, 72], [79, 128]]",121,79,72,79,200,200,193,207,249,151,0.6225,0.6269430051813472,0.605,0.64,0.36,0.395,0.6157760814249363
0.482,400,"[[121, 72], [79, 128]]",121,79,72,79,200,200,193,207,249,151,0.6225,0.6269430051813472,0.605,0.64,0.36,0.395,0.6157760814249363
0.483,400,"[[120, 72], [80, 128]]",120,80,72,80,200,200,192,208,248,152,0.62,0.625,0.6,0.64,0.36,0.4,0.6122448979591836
0.484,400,"[[120, 72], [80, 128]]",120,80,72,80,200,200,192,208,248,152,0.62,0.625,0.6,0.64,0.36,0.4,0.6122448979591836
0.485,400,"[[120, 72], [80, 128]]",120,80,72,80,200,200,192,208,248,152,0.62,0.625,0.6,0.64,0.36,0.4,0.6122448979591836
0.486,400,"[[120, 72], [80, 128]]",120,80,72,80,200,200,192,208,248,152,0.62,0.625,0.6,0.64,0.36,0.4,0.6122448979591836
0.487,400,"[[120, 72], [80, 128]]",120,80,72,80,200,200,192,208,248,152,0.62,0.625,0.6,0.64,0.36,0.4,0.6122448979591836
0.488,400,"[[120, 72], [80, 128]]",120,80,72,80,200,200,192,208,248,152,0.62,0.625,0.6,0.64,0.36,0.4,0.6122448979591836
0.489,400,"[[120, 71], [80, 129]]",120,80,71,80,200,200,191,209,249,151,0.6225,0.6282722513089005,0.6,0.645,0.355,0.4,0.6138107416879797
0.49,400,"[[120, 71], [80, 129]]",120,80,71,80,200,200,191,209,249,151,0.6225,0.6282722513089005,0.6,0.645,0.355,0.4,0.6138107416879797
0.491,400,"[[120, 71], [80, 129]]",120,80,71,80,200,200,191,209,249,151,0.6225,0.6282722513089005,0.6,0.645,0.355,0.4,0.6138107416879797
0.492,400,"[[120, 71], [80, 129]]",120,80,71,80,200,200,191,209,249,151,0.6225,0.6282722513089005,0.6,0.645,0.355,0.4,0.6138107416879797
0.493,400,"[[120, 71], [80, 129]]",120,80,71,80,200,200,191,209,249,151,0.6225,0.6282722513089005,0.6,0.645,0.355,0.4,0.6138107416879797
0.494,400,"[[120, 71], [80, 129]]",120,80,71,80,200,200,191,209,249,151,0.6225,0.6282722513089005,0.6,0.645,0.355,0.4,0.6138107416879797
0.495,400,"[[120, 71], [80, 129]]",120,80,71,80,200,200,191,209,249,151,0.6225,0.6282722513089005,0.6,0.645,0.355,0.4,0.6138107416879797
0.496,400,"[[120, 71], [80, 129]]",120,80,71,80,200,200,191,209,249,151,0.6225,0.6282722513089005,0.6,0.645,0.355,0.4,0.6138107416879797
0.497,400,"[[120, 71], [80, 129]]",120,80,71,80,200,200,191,209,249,151,0.6225,0.6282722513089005,0.6,0.645,0.355,0.4,0.6138107416879797
0.498,400,"[[120, 71], [80, 129]]",120,80,71,80,200,200,191,209,249,151,0.6225,0.6282722513089005,0.6,0.645,0.355,0.4,0.6138107416879797
0.499,400,"[[120, 71], [80, 129]]",120,80,71,80,200,200,191,209,249,151,0.6225,0.6282722513089005,0.6,0.645,0.355,0.4,0.6138107416879797
0.5,400,"[[120, 71], [80, 129]]",120,80,71,80,200,200,191,209,249,151,0.6225,0.6282722513089005,0.6,0.645,0.355,0.4,0.6138107416879797
0.501,400,"[[120, 70], [80, 130]]",120,80,70,80,200,200,190,210,250,150,0.625,0.631578947368421,0.6,0.65,0.35,0.4,0.6153846153846154
0.502,400,"[[120, 70], [80, 130]]",120,80,70,80,200,200,190,210,250,150,0.625,0.631578947368421,0.6,0.65,0.35,0.4,0.6153846153846154
0.503,400,"[[120, 70], [80, 130]]",120,80,70,80,200,200,190,210,250,150,0.625,0.631578947368421,0.6,0.65,0.35,0.4,0.6153846153846154
0.504,400,"[[120, 70], [80, 130]]",120,80,70,80,200,200,190,210,250,150,0.625,0.631578947368421,0.6,0.65,0.35,0.4,0.6153846153846154
0.505,400,"[[120, 70], [80, 130]]",120,80,70,80,200,200,190,210,250,150,0.625,0.631578947368421,0.6,0.65,0.35,0.4,0.6153846153846154
0.506,400,"[[120, 70], [80, 130]]",120,80,70,80,200,200,190,210,250,150,0.625,0.631578947368421,0.6,0.65,0.35,0.4,0.6153846153846154
0.507,400,"[[119, 70], [81, 130]]",119,81,70,81,200,200,189,211,249,151,0.6225,0.6296296296296297,0.595,0.65,0.35,0.405,0.6118251928020566
0.508,400,"[[119, 70], [81, 130]]",119,81,70,81,200,200,189,211,249,151,0.6225,0.6296296296296297,0.595,0.65,0.35,0.405,0.6118251928020566
0.509,400,"[[119, 70], [81, 130]]",119,81,70,81,200,200,189,211,249,151,0.6225,0.6296296296296297,0.595,0.65,0.35,0.405,0.6118251928020566
0.51,400,"[[119, 70], [81, 130]]",119,81,70,81,200,200,189,211,249,151,0.6225,0.6296296296296297,0.595,0.65,0.35,0.405,0.6118251928020566
0.511,400,"[[119, 69], [81, 131]]",119,81,69,81,200,200,188,212,250,150,0.625,0.6329787234042553,0.595,0.655,0.345,0.405,0.61340206185567
0.512,400,"[[119, 69], [81, 131]]",119,81,69,81,200,200,188,212,250,150,0.625,0.6329787234042553,0.595,0.655,0.345,0.405,0.61340206185567
0.513,400,"[[119, 69], [81, 131]]",119,81,69,81,200,200,188,212,250,150,0.625,0.6329787234042553,0.595,0.655,0.345,0.405,0.61340206185567
0.514,400,"[[118, 69], [82, 131]]",118,82,69,82,200,200,187,213,249,151,0.6225,0.6310160427807486,0.59,0.655,0.345,0.41,0.6098191214470284
0.515,400,"[[118, 69], [82, 131]]",118,82,69,82,200,200,187,213,249,151,0.6225,0.6310160427807486,0.59,0.655,0.345,0.41,0.6098191214470284
0.516,400,"[[118, 69], [82, 131]]",118,82,69,82,200,200,187,213,249,151,0.6225,0.6310160427807486,0.59,0.655,0.345,0.41,0.6098191214470284
0.517,400,"[[118, 68], [82, 132]]",118,82,68,82,200,200,186,214,250,150,0.625,0.6344086021505376,0.59,0.66,0.34,0.41,0.6113989637305699
0.518,400,"[[118, 68], [82, 132]]",118,82,68,82,200,200,186,214,250,150,0.625,0.6344086021505376,0.59,0.66,0.34,0.41,0.6113989637305699
0.519,400,"[[118, 68], [82, 132]]",118,82,68,82,200,200,186,214,250,150,0.625,0.6344086021505376,0.59,0.66,0.34,0.41,0.6113989637305699
0.52,400,"[[118, 68], [82, 132]]",118,82,68,82,200,200,186,214,250,150,0.625,0.6344086021505376,0.59,0.66,0.34,0.41,0.6113989637305699
0.521,400,"[[118, 68], [82, 132]]",118,82,68,82,200,200,186,214,250,150,0.625,0.6344086021505376,0.59,0.66,0.34,0.41,0.6113989637305699
0.522,400,"[[118, 67], [82, 133]]",118,82,67,82,200,200,185,215,251,149,0.6275,0.6378378378378379,0.59,0.665,0.335,0.41,0.612987012987013
0.523,400,"[[118, 67], [82, 133]]",118,82,67,82,200,200,185,215,251,149,0.6275,0.6378378378378379,0.59,0.665,0.335,0.41,0.612987012987013
0.524,400,"[[118, 67], [82, 133]]",118,82,67,82,200,200,185,215,251,149,0.6275,0.6378378378378379,0.59,0.665,0.335,0.41,0.612987012987013
0.525,400,"[[118, 66], [82, 134]]",118,82,66,82,200,200,184,216,252,148,0.63,0.6413043478260869,0.59,0.67,0.33,0.41,0.6145833333333333
0.526,400,"[[118, 65], [82, 135]]",118,82,65,82,200,200,183,217,253,147,0.6325,0.644808743169399,0.59,0.675,0.325,0.41,0.6161879895561357
0.527,400,"[[118, 65], [82, 135]]",118,82,65,82,200,200,183,217,253,147,0.6325,0.644808743169399,0.59,0.675,0.325,0.41,0.6161879895561357
0.528,400,"[[118, 65], [82, 135]]",118,82,65,82,200,200,183,217,253,147,0.6325,0.644808743169399,0.59,0.675,0.325,0.41,0.6161879895561357
0.529,400,"[[118, 65], [82, 135]]",118,82,65,82,200,200,183,217,253,147,0.6325,0.644808743169399,0.59,0.675,0.325,0.41,0.6161879895561357
0.53,400,"[[118, 65], [82, 135]]",118,82,65,82,200,200,183,217,253,147,0.6325,0.644808743169399,0.59,0.675,0.325,0.41,0.6161879895561357
0.531,400,"[[118, 65], [82, 135]]",118,82,65,82,200,200,183,217,253,147,0.6325,0.644808743169399,0.59,0.675,0.325,0.41,0.6161879895561357
0.532,400,"[[118, 65], [82, 135]]",118,82,65,82,200,200,183,217,253,147,0.6325,0.644808743169399,0.59,0.675,0.325,0.41,0.6161879895561357
0.533,400,"[[118, 65], [82, 135]]",118,82,65,82,200,200,183,217,253,147,0.6325,0.644808743169399,0.59,0.675,0.325,0.41,0.6161879895561357
0.534,400,"[[118, 65], [82, 135]]",118,82,65,82,200,200,183,217,253,147,0.6325,0.644808743169399,0.59,0.675,0.325,0.41,0.6161879895561357
0.535,400,"[[118, 65], [82, 135]]",118,82,65,82,200,200,183,217,253,147,0.6325,0.644808743169399,0.59,0.675,0.325,0.41,0.6161879895561357
0.536,400,"[[118, 64], [82, 136]]",118,82,64,82,200,200,182,218,254,146,0.635,0.6483516483516484,0.59,0.68,0.32,0.41,0.6178010471204188
0.537,400,"[[118, 64], [82, 136]]",118,82,64,82,200,200,182,218,254,146,0.635,0.6483516483516484,0.59,0.68,0.32,0.41,0.6178010471204188
0.538,400,"[[118, 64], [82, 136]]",118,82,64,82,200,200,182,218,254,146,0.635,0.6483516483516484,0.59,0.68,0.32,0.41,0.6178010471204188
0.539,400,"[[118, 63], [82, 137]]",118,82,63,82,200,200,181,219,255,145,0.6375,0.6519337016574586,0.59,0.685,0.315,0.41,0.6194225721784776
0.54,400,"[[118, 63], [82, 137]]",118,82,63,82,200,200,181,219,255,145,0.6375,0.6519337016574586,0.59,0.685,0.315,0.41,0.6194225721784776
0.541,400,"[[118, 63], [82, 137]]",118,82,63,82,200,200,181,219,255,145,0.6375,0.6519337016574586,0.59,0.685,0.315,0.41,0.6194225721784776
0.542,400,"[[118, 62], [82, 138]]",118,82,62,82,200,200,180,220,256,144,0.64,0.6555555555555556,0.59,0.69,0.31,0.41,0.6210526315789474
0.543,400,"[[118, 62], [82, 138]]",118,82,62,82,200,200,180,220,256,144,0.64,0.6555555555555556,0.59,0.69,0.31,0.41,0.6210526315789474
0.544,400,"[[117, 62], [83, 138]]",117,83,62,83,200,200,179,221,255,145,0.6375,0.6536312849162011,0.585,0.69,0.31,0.415,0.6174142480211081
0.545,400,"[[117, 62], [83, 138]]",117,83,62,83,200,200,179,221,255,145,0.6375,0.6536312849162011,0.585,0.69,0.31,0.415,0.6174142480211081
0.546,400,"[[117, 62], [83, 138]]",117,83,62,83,200,200,179,221,255,145,0.6375,0.6536312849162011,0.585,0.69,0.31,0.415,0.6174142480211081
0.547,400,"[[117, 62], [83, 138]]",117,83,62,83,200,200,179,221,255,145,0.6375,0.6536312849162011,0.585,0.69,0.31,0.415,0.6174142480211081
0.548,400,"[[117, 62], [83, 138]]",117,83,62,83,200,200,179,221,255,145,0.6375,0.6536312849162011,0.585,0.69,0.31,0.415,0.6174142480211081
0.549,400,"[[117, 61], [83, 139]]",117,83,61,83,200,200,178,222,256,144,0.64,0.6573033707865169,0.585,0.695,0.305,0.415,0.6190476190476191
0.55,400,"[[116, 61], [84, 139]]",116,84,61,84,200,200,177,223,255,145,0.6375,0.655367231638418,0.58,0.695,0.305,0.42,0.6153846153846154
0.551,400,"[[115, 61], [85, 139]]",115,85,61,85,200,200,176,224,254,146,0.635,0.6534090909090909,0.575,0.695,0.305,0.425,0.6117021276595743
0.552,400,"[[115, 61], [85, 139]]",115,85,61,85,200,200,176,224,254,146,0.635,0.6534090909090909,0.575,0.695,0.305,0.425,0.6117021276595743
0.553,400,"[[115, 61], [85, 139]]",115,85,61,85,200,200,176,224,254,146,0.635,0.6534090909090909,0.575,0.695,0.305,0.425,0.6117021276595743
0.554,400,"[[115, 61], [85, 139]]",115,85,61,85,200,200,176,224,254,146,0.635,0.6534090909090909,0.575,0.695,0.305,0.425,0.6117021276595743
0.555,400,"[[115, 61], [85, 139]]",115,85,61,85,200,200,176,224,254,146,0.635,0.6534090909090909,0.575,0.695,0.305,0.425,0.6117021276595743
0.556,400,"[[115, 61], [85, 139]]",115,85,61,85,200,200,176,224,254,146,0.635,0.6534090909090909,0.575,0.695,0.305,0.425,0.6117021276595743
0.557,400,"[[114, 61], [86, 139]]",114,86,61,86,200,200,175,225,253,147,0.6325,0.6514285714285715,0.57,0.695,0.305,0.43,0.608
0.558,400,"[[114, 60], [86, 140]]",114,86,60,86,200,200,174,226,254,146,0.635,0.6551724137931034,0.57,0.7,0.3,0.43,0.6096256684491977
0.559,400,"[[114, 60], [86, 140]]",114,86,60,86,200,200,174,226,254,146,0.635,0.6551724137931034,0.57,0.7,0.3,0.43,0.6096256684491977
0.56,400,"[[114, 60], [86, 140]]",114,86,60,86,200,200,174,226,254,146,0.635,0.6551724137931034,0.57,0.7,0.3,0.43,0.6096256684491977
0.561,400,"[[114, 60], [86, 140]]",114,86,60,86,200,200,174,226,254,146,0.635,0.6551724137931034,0.57,0.7,0.3,0.43,0.6096256684491977
0.562,400,"[[114, 60], [86, 140]]",114,86,60,86,200,200,174,226,254,146,0.635,0.6551724137931034,0.57,0.7,0.3,0.43,0.6096256684491977
0.563,400,"[[114, 60], [86, 140]]",114,86,60,86,200,200,174,226,254,146,0.635,0.6551724137931034,0.57,0.7,0.3,0.43,0.6096256684491977
0.564,400,"[[114, 60], [86, 140]]",114,86,60,86,200,200,174,226,254,146,0.635,0.6551724137931034,0.57,0.7,0.3,0.43,0.6096256684491977
0.565,400,"[[114, 60], [86, 140]]",114,86,60,86,200,200,174,226,254,146,0.635,0.6551724137931034,0.57,0.7,0.3,0.43,0.6096256684491977
0.566,400,"[[114, 60], [86, 140]]",114,86,60,86,200,200,174,226,254,146,0.635,0.6551724137931034,0.57,0.7,0.3,0.43,0.6096256684491977
0.567,400,"[[114, 60], [86, 140]]",114,86,60,86,200,200,174,226,254,146,0.635,0.6551724137931034,0.57,0.7,0.3,0.43,0.6096256684491977
0.568,400,"[[114, 60], [86, 140]]",114,86,60,86,200,200,174,226,254,146,0.635,0.6551724137931034,0.57,0.7,0.3,0.43,0.6096256684491977
0.569,400,"[[114, 60], [86, 140]]",114,86,60,86,200,200,174,226,254,146,0.635,0.6551724137931034,0.57,0.7,0.3,0.43,0.6096256684491977
0.57,400,"[[114, 60], [86, 140]]",114,86,60,86,200,200,174,226,254,146,0.635,0.6551724137931034,0.57,0.7,0.3,0.43,0.6096256684491977
0.571,400,"[[114, 60], [86, 140]]",114,86,60,86,200,200,174,226,254,146,0.635,0.6551724137931034,0.57,0.7,0.3,0.43,0.6096256684491977
0.572,400,"[[114, 60], [86, 140]]",114,86,60,86,200,200,174,226,254,146,0.635,0.6551724137931034,0.57,0.7,0.3,0.43,0.6096256684491977
0.573,400,"[[113, 60], [87, 140]]",113,87,60,87,200,200,173,227,253,147,0.6325,0.653179190751445,0.565,0.7,0.3,0.435,0.6058981233243967
0.574,400,"[[111, 60], [89, 140]]",111,89,60,89,200,200,171,229,251,149,0.6275,0.6491228070175439,0.555,0.7,0.3,0.445,0.5983827493261457
0.575,400,"[[111, 60], [89, 140]]",111,89,60,89,200,200,171,229,251,149,0.6275,0.6491228070175439,0.555,0.7,0.3,0.445,0.5983827493261457
0.576,400,"[[110, 60], [90, 140]]",110,90,60,90,200,200,170,230,250,150,0.625,0.6470588235294118,0.55,0.7,0.3,0.45,0.5945945945945946
0.577,400,"[[110, 60], [90, 140]]",110,90,60,90,200,200,170,230,250,150,0.625,0.6470588235294118,0.55,0.7,0.3,0.45,0.5945945945945946
0.578,400,"[[110, 60], [90, 140]]",110,90,60,90,200,200,170,230,250,150,0.625,0.6470588235294118,0.55,0.7,0.3,0.45,0.5945945945945946
0.579,400,"[[110, 60], [90, 140]]",110,90,60,90,200,200,170,230,250,150,0.625,0.6470588235294118,0.55,0.7,0.3,0.45,0.5945945945945946
0.58,400,"[[110, 60], [90, 140]]",110,90,60,90,200,200,170,230,250,150,0.625,0.6470588235294118,0.55,0.7,0.3,0.45,0.5945945945945946
0.581,400,"[[110, 60], [90, 140]]",110,90,60,90,200,200,170,230,250,150,0.625,0.6470588235294118,0.55,0.7,0.3,0.45,0.5945945945945946
0.582,400,"[[110, 60], [90, 140]]",110,90,60,90,200,200,170,230,250,150,0.625,0.6470588235294118,0.55,0.7,0.3,0.45,0.5945945945945946
0.583,400,"[[110, 60], [90, 140]]",110,90,60,90,200,200,170,230,250,150,0.625,0.6470588235294118,0.55,0.7,0.3,0.45,0.5945945945945946
0.584,400,"[[110, 60], [90, 140]]",110,90,60,90,200,200,170,230,250,150,0.625,0.6470588235294118,0.55,0.7,0.3,0.45,0.5945945945945946
0.585,400,"[[110, 60], [90, 140]]",110,90,60,90,200,200,170,230,250,150,0.625,0.6470588235294118,0.55,0.7,0.3,0.45,0.5945945945945946
0.586,400,"[[109, 60], [91, 140]]",109,91,60,91,200,200,169,231,249,151,0.6225,0.6449704142011834,0.545,0.7,0.3,0.455,0.5907859078590786
0.587,400,"[[109, 60], [91, 140]]",109,91,60,91,200,200,169,231,249,151,0.6225,0.6449704142011834,0.545,0.7,0.3,0.455,0.5907859078590786
0.588,400,"[[109, 60], [91, 140]]",109,91,60,91,200,200,169,231,249,151,0.6225,0.6449704142011834,0.545,0.7,0.3,0.455,0.5907859078590786
0.589,400,"[[109, 60], [91, 140]]",109,91,60,91,200,200,169,231,249,151,0.6225,0.6449704142011834,0.545,0.7,0.3,0.455,0.5907859078590786
0.59,400,"[[109, 60], [91, 140]]",109,91,60,91,200,200,169,231,249,151,0.6225,0.6449704142011834,0.545,0.7,0.3,0.455,0.5907859078590786
0.591,400,"[[109, 60], [91, 140]]",109,91,60,91,200,200,169,231,249,151,0.6225,0.6449704142011834,0.545,0.7,0.3,0.455,0.5907859078590786
0.592,400,"[[109, 59], [91, 141]]",109,91,59,91,200,200,168,232,250,150,0.625,0.6488095238095238,0.545,0.705,0.295,0.455,0.5923913043478262
0.593,400,"[[109, 59], [91, 141]]",109,91,59,91,200,200,168,232,250,150,0.625,0.6488095238095238,0.545,0.705,0.295,0.455,0.5923913043478262
0.594,400,"[[109, 59], [91, 141]]",109,91,59,91,200,200,168,232,250,150,0.625,0.6488095238095238,0.545,0.705,0.295,0.455,0.5923913043478262
0.595,400,"[[109, 58], [91, 142]]",109,91,58,91,200,200,167,233,251,149,0.6275,0.6526946107784432,0.545,0.71,0.29,0.455,0.5940054495912807
0.596,400,"[[109, 58], [91, 142]]",109,91,58,91,200,200,167,233,251,149,0.6275,0.6526946107784432,0.545,0.71,0.29,0.455,0.5940054495912807
0.597,400,"[[109, 57], [91, 143]]",109,91,57,91,200,200,166,234,252,148,0.63,0.6566265060240963,0.545,0.715,0.285,0.455,0.5956284153005463
0.598,400,"[[109, 56], [91, 144]]",109,91,56,91,200,200,165,235,253,147,0.6325,0.6606060606060606,0.545,0.72,0.28,0.455,0.5972602739726028
0.599,400,"[[109, 56], [91, 144]]",109,91,56,91,200,200,165,235,253,147,0.6325,0.6606060606060606,0.545,0.72,0.28,0.455,0.5972602739726028
0.6,400,"[[109, 56], [91, 144]]",109,91,56,91,200,200,165,235,253,147,0.6325,0.6606060606060606,0.545,0.72,0.28,0.455,0.5972602739726028
0.601,400,"[[109, 56], [91, 144]]",109,91,56,91,200,200,165,235,253,147,0.6325,0.6606060606060606,0.545,0.72,0.28,0.455,0.5972602739726028
0.602,400,"[[109, 56], [91, 144]]",109,91,56,91,200,200,165,235,253,147,0.6325,0.6606060606060606,0.545,0.72,0.28,0.455,0.5972602739726028
0.603,400,"[[109, 56], [91, 144]]",109,91,56,91,200,200,165,235,253,147,0.6325,0.6606060606060606,0.545,0.72,0.28,0.455,0.5972602739726028
0.604,400,"[[109, 56], [91, 144]]",109,91,56,91,200,200,165,235,253,147,0.6325,0.6606060606060606,0.545,0.72,0.28,0.455,0.5972602739726028
0.605,400,"[[109, 56], [91, 144]]",109,91,56,91,200,200,165,235,253,147,0.6325,0.6606060606060606,0.545,0.72,0.28,0.455,0.5972602739726028
0.606,400,"[[109, 56], [91, 144]]",109,91,56,91,200,200,165,235,253,147,0.6325,0.6606060606060606,0.545,0.72,0.28,0.455,0.5972602739726028
0.607,400,"[[109, 55], [91, 145]]",109,91,55,91,200,200,164,236,254,146,0.635,0.6646341463414634,0.545,0.725,0.275,0.455,0.598901098901099
0.608,400,"[[109, 55], [91, 145]]",109,91,55,91,200,200,164,236,254,146,0.635,0.6646341463414634,0.545,0.725,0.275,0.455,0.598901098901099
0.609,400,"[[109, 55], [91, 145]]",109,91,55,91,200,200,164,236,254,146,0.635,0.6646341463414634,0.545,0.725,0.275,0.455,0.598901098901099
0.61,400,"[[108, 55], [92, 145]]",108,92,55,92,200,200,163,237,253,147,0.6325,0.6625766871165644,0.54,0.725,0.275,0.46,0.5950413223140496
0.611,400,"[[108, 55], [92, 145]]",108,92,55,92,200,200,163,237,253,147,0.6325,0.6625766871165644,0.54,0.725,0.275,0.46,0.5950413223140496
0.612,400,"[[107, 54], [93, 146]]",107,93,54,93,200,200,161,239,253,147,0.6325,0.6645962732919255,0.535,0.73,0.27,0.465,0.5927977839335179
0.613,400,"[[107, 54], [93, 146]]",107,93,54,93,200,200,161,239,253,147,0.6325,0.6645962732919255,0.535,0.73,0.27,0.465,0.5927977839335179
0.614,400,"[[107, 54], [93, 146]]",107,93,54,93,200,200,161,239,253,147,0.6325,0.6645962732919255,0.535,0.73,0.27,0.465,0.5927977839335179
0.615,400,"[[106, 54], [94, 146]]",106,94,54,94,200,200,160,240,252,148,0.63,0.6625,0.53,0.73,0.27,0.47,0.588888888888889
0.616,400,"[[106, 54], [94, 146]]",106,94,54,94,200,200,160,240,252,148,0.63,0.6625,0.53,0.73,0.27,0.47,0.588888888888889
0.617,400,"[[106, 54], [94, 146]]",106,94,54,94,200,200,160,240,252,148,0.63,0.6625,0.53,0.73,0.27,0.47,0.588888888888889
0.618,400,"[[106, 54], [94, 146]]",106,94,54,94,200,200,160,240,252,148,0.63,0.6625,0.53,0.73,0.27,0.47,0.588888888888889
0.619,400,"[[106, 54], [94, 146]]",106,94,54,94,200,200,160,240,252,148,0.63,0.6625,0.53,0.73,0.27,0.47,0.588888888888889
0.62,400,"[[106, 54], [94, 146]]",106,94,54,94,200,200,160,240,252,148,0.63,0.6625,0.53,0.73,0.27,0.47,0.588888888888889
0.621,400,"[[106, 54], [94, 146]]",106,94,54,94,200,200,160,240,252,148,0.63,0.6625,0.53,0.73,0.27,0.47,0.588888888888889
0.622,400,"[[106, 54], [94, 146]]",106,94,54,94,200,200,160,240,252,148,0.63,0.6625,0.53,0.73,0.27,0.47,0.588888888888889
0.623,400,"[[106, 54], [94, 146]]",106,94,54,94,200,200,160,240,252,148,0.63,0.6625,0.53,0.73,0.27,0.47,0.588888888888889
0.624,400,"[[106, 54], [94, 146]]",106,94,54,94,200,200,160,240,252,148,0.63,0.6625,0.53,0.73,0.27,0.47,0.588888888888889
0.625,400,"[[106, 54], [94, 146]]",106,94,54,94,200,200,160,240,252,148,0.63,0.6625,0.53,0.73,0.27,0.47,0.588888888888889
0.626,400,"[[106, 54], [94, 146]]",106,94,54,94,200,200,160,240,252,148,0.63,0.6625,0.53,0.73,0.27,0.47,0.588888888888889
0.627,400,"[[106, 54], [94, 146]]",106,94,54,94,200,200,160,240,252,148,0.63,0.6625,0.53,0.73,0.27,0.47,0.588888888888889
0.628,400,"[[106, 54], [94, 146]]",106,94,54,94,200,200,160,240,252,148,0.63,0.6625,0.53,0.73,0.27,0.47,0.588888888888889
0.629,400,"[[106, 54], [94, 146]]",106,94,54,94,200,200,160,240,252,148,0.63,0.6625,0.53,0.73,0.27,0.47,0.588888888888889
0.63,400,"[[106, 54], [94, 146]]",106,94,54,94,200,200,160,240,252,148,0.63,0.6625,0.53,0.73,0.27,0.47,0.588888888888889
0.631,400,"[[105, 54], [95, 146]]",105,95,54,95,200,200,159,241,251,149,0.6275,0.660377358490566,0.525,0.73,0.27,0.475,0.584958217270195
0.632,400,"[[105, 54], [95, 146]]",105,95,54,95,200,200,159,241,251,149,0.6275,0.660377358490566,0.525,0.73,0.27,0.475,0.584958217270195
0.633,400,"[[105, 54], [95, 146]]",105,95,54,95,200,200,159,241,251,149,0.6275,0.660377358490566,0.525,0.73,0.27,0.475,0.584958217270195
0.634,400,"[[105, 54], [95, 146]]",105,95,54,95,200,200,159,241,251,149,0.6275,0.660377358490566,0.525,0.73,0.27,0.475,0.584958217270195
0.635,400,"[[105, 54], [95, 146]]",105,95,54,95,200,200,159,241,251,149,0.6275,0.660377358490566,0.525,0.73,0.27,0.475,0.584958217270195
0.636,400,"[[102, 54], [98, 146]]",102,98,54,98,200,200,156,244,248,152,0.62,0.6538461538461539,0.51,0.73,0.27,0.49,0.5730337078651685
0.637,400,"[[102, 54], [98, 146]]",102,98,54,98,200,200,156,244,248,152,0.62,0.6538461538461539,0.51,0.73,0.27,0.49,0.5730337078651685
0.638,400,"[[102, 54], [98, 146]]",102,98,54,98,200,200,156,244,248,152,0.62,0.6538461538461539,0.51,0.73,0.27,0.49,0.5730337078651685
0.639,400,"[[102, 54], [98, 146]]",102,98,54,98,200,200,156,244,248,152,0.62,0.6538461538461539,0.51,0.73,0.27,0.49,0.5730337078651685
0.64,400,"[[102, 54], [98, 146]]",102,98,54,98,200,200,156,244,248,152,0.62,0.6538461538461539,0.51,0.73,0.27,0.49,0.5730337078651685
0.641,400,"[[102, 54], [98, 146]]",102,98,54,98,200,200,156,244,248,152,0.62,0.6538461538461539,0.51,0.73,0.27,0.49,0.5730337078651685
0.642,400,"[[102, 54], [98, 146]]",102,98,54,98,200,200,156,244,248,152,0.62,0.6538461538461539,0.51,0.73,0.27,0.49,0.5730337078651685
0.643,400,"[[102, 54], [98, 146]]",102,98,54,98,200,200,156,244,248,152,0.62,0.6538461538461539,0.51,0.73,0.27,0.49,0.5730337078651685
0.644,400,"[[102, 53], [98, 147]]",102,98,53,98,200,200,155,245,249,151,0.6225,0.6580645161290323,0.51,0.735,0.265,0.49,0.5746478873239437
0.645,400,"[[102, 53], [98, 147]]",102,98,53,98,200,200,155,245,249,151,0.6225,0.6580645161290323,0.51,0.735,0.265,0.49,0.5746478873239437
0.646,400,"[[102, 53], [98, 147]]",102,98,53,98,200,200,155,245,249,151,0.6225,0.6580645161290323,0.51,0.735,0.265,0.49,0.5746478873239437
0.647,400,"[[101, 53], [99, 147]]",101,99,53,99,200,200,154,246,248,152,0.62,0.6558441558441559,0.505,0.735,0.265,0.495,0.5706214689265537
0.648,400,"[[101, 53], [99, 147]]",101,99,53,99,200,200,154,246,248,152,0.62,0.6558441558441559,0.505,0.735,0.265,0.495,0.5706214689265537
0.649,400,"[[101, 53], [99, 147]]",101,99,53,99,200,200,154,246,248,152,0.62,0.6558441558441559,0.505,0.735,0.265,0.495,0.5706214689265537
0.65,400,"[[101, 53], [99, 147]]",101,99,53,99,200,200,154,246,248,152,0.62,0.6558441558441559,0.505,0.735,0.265,0.495,0.5706214689265537
0.651,400,"[[101, 53], [99, 147]]",101,99,53,99,200,200,154,246,248,152,0.62,0.6558441558441559,0.505,0.735,0.265,0.495,0.5706214689265537
0.652,400,"[[101, 53], [99, 147]]",101,99,53,99,200,200,154,246,248,152,0.62,0.6558441558441559,0.505,0.735,0.265,0.495,0.5706214689265537
0.653,400,"[[101, 53], [99, 147]]",101,99,53,99,200,200,154,246,248,152,0.62,0.6558441558441559,0.505,0.735,0.265,0.495,0.5706214689265537
0.654,400,"[[101, 53], [99, 147]]",101,99,53,99,200,200,154,246,248,152,0.62,0.6558441558441559,0.505,0.735,0.265,0.495,0.5706214689265537
0.655,400,"[[100, 53], [100, 147]]",100,100,53,100,200,200,153,247,247,153,0.6175,0.6535947712418301,0.5,0.735,0.265,0.5,0.56657223796034
0.656,400,"[[100, 53], [100, 147]]",100,100,53,100,200,200,153,247,247,153,0.6175,0.6535947712418301,0.5,0.735,0.265,0.5,0.56657223796034
0.657,400,"[[100, 53], [100, 147]]",100,100,53,100,200,200,153,247,247,153,0.6175,0.6535947712418301,0.5,0.735,0.265,0.5,0.56657223796034
0.658,400,"[[100, 53], [100, 147]]",100,100,53,100,200,200,153,247,247,153,0.6175,0.6535947712418301,0.5,0.735,0.265,0.5,0.56657223796034
0.659,400,"[[100, 53], [100, 147]]",100,100,53,100,200,200,153,247,247,153,0.6175,0.6535947712418301,0.5,0.735,0.265,0.5,0.56657223796034
0.66,400,"[[100, 53], [100, 147]]",100,100,53,100,200,200,153,247,247,153,0.6175,0.6535947712418301,0.5,0.735,0.265,0.5,0.56657223796034
0.661,400,"[[100, 53], [100, 147]]",100,100,53,100,200,200,153,247,247,153,0.6175,0.6535947712418301,0.5,0.735,0.265,0.5,0.56657223796034
0.662,400,"[[100, 52], [100, 148]]",100,100,52,100,200,200,152,248,248,152,0.62,0.6578947368421053,0.5,0.74,0.26,0.5,0.5681818181818182
0.663,400,"[[100, 52], [100, 148]]",100,100,52,100,200,200,152,248,248,152,0.62,0.6578947368421053,0.5,0.74,0.26,0.5,0.5681818181818182
0.664,400,"[[100, 51], [100, 149]]",100,100,51,100,200,200,151,249,249,151,0.6225,0.6622516556291391,0.5,0.745,0.255,0.5,0.5698005698005698
0.665,400,"[[100, 51], [100, 149]]",100,100,51,100,200,200,151,249,249,151,0.6225,0.6622516556291391,0.5,0.745,0.255,0.5,0.5698005698005698
0.666,400,"[[99, 51], [101, 149]]",99,101,51,101,200,200,150,250,248,152,0.62,0.66,0.495,0.745,0.255,0.505,0.5657142857142857
0.667,400,"[[98, 51], [102, 149]]",98,102,51,102,200,200,149,251,247,153,0.6175,0.6577181208053692,0.49,0.745,0.255,0.51,0.5616045845272207
0.668,400,"[[98, 51], [102, 149]]",98,102,51,102,200,200,149,251,247,153,0.6175,0.6577181208053692,0.49,0.745,0.255,0.51,0.5616045845272207
0.669,400,"[[98, 51], [102, 149]]",98,102,51,102,200,200,149,251,247,153,0.6175,0.6577181208053692,0.49,0.745,0.255,0.51,0.5616045845272207
0.67,400,"[[98, 51], [102, 149]]",98,102,51,102,200,200,149,251,247,153,0.6175,0.6577181208053692,0.49,0.745,0.255,0.51,0.5616045845272207
0.671,400,"[[97, 51], [103, 149]]",97,103,51,103,200,200,148,252,246,154,0.615,0.6554054054054054,0.485,0.745,0.255,0.515,0.557471264367816
0.672,400,"[[97, 51], [103, 149]]",97,103,51,103,200,200,148,252,246,154,0.615,0.6554054054054054,0.485,0.745,0.255,0.515,0.557471264367816
0.673,400,"[[97, 51], [103, 149]]",97,103,51,103,200,200,148,252,246,154,0.615,0.6554054054054054,0.485,0.745,0.255,0.515,0.557471264367816
0.674,400,"[[97, 51], [103, 149]]",97,103,51,103,200,200,148,252,246,154,0.615,0.6554054054054054,0.485,0.745,0.255,0.515,0.557471264367816
0.675,400,"[[97, 51], [103, 149]]",97,103,51,103,200,200,148,252,246,154,0.615,0.6554054054054054,0.485,0.745,0.255,0.515,0.557471264367816
0.676,400,"[[97, 51], [103, 149]]",97,103,51,103,200,200,148,252,246,154,0.615,0.6554054054054054,0.485,0.745,0.255,0.515,0.557471264367816
0.677,400,"[[97, 50], [103, 150]]",97,103,50,103,200,200,147,253,247,153,0.6175,0.6598639455782312,0.485,0.75,0.25,0.515,0.5590778097982708
0.678,400,"[[97, 50], [103, 150]]",97,103,50,103,200,200,147,253,247,153,0.6175,0.6598639455782312,0.485,0.75,0.25,0.515,0.5590778097982708
0.679,400,"[[97, 50], [103, 150]]",97,103,50,103,200,200,147,253,247,153,0.6175,0.6598639455782312,0.485,0.75,0.25,0.515,0.5590778097982708
0.68,400,"[[97, 50], [103, 150]]",97,103,50,103,200,200,147,253,247,153,0.6175,0.6598639455782312,0.485,0.75,0.25,0.515,0.5590778097982708
0.681,400,"[[97, 50], [103, 150]]",97,103,50,103,200,200,147,253,247,153,0.6175,0.6598639455782312,0.485,0.75,0.25,0.515,0.5590778097982708
0.682,400,"[[97, 50], [103, 150]]",97,103,50,103,200,200,147,253,247,153,0.6175,0.6598639455782312,0.485,0.75,0.25,0.515,0.5590778097982708
0.683,400,"[[97, 50], [103, 150]]",97,103,50,103,200,200,147,253,247,153,0.6175,0.6598639455782312,0.485,0.75,0.25,0.515,0.5590778097982708
0.684,400,"[[97, 50], [103, 150]]",97,103,50,103,200,200,147,253,247,153,0.6175,0.6598639455782312,0.485,0.75,0.25,0.515,0.5590778097982708
0.685,400,"[[97, 50], [103, 150]]",97,103,50,103,200,200,147,253,247,153,0.6175,0.6598639455782312,0.485,0.75,0.25,0.515,0.5590778097982708
0.686,400,"[[97, 50], [103, 150]]",97,103,50,103,200,200,147,253,247,153,0.6175,0.6598639455782312,0.485,0.75,0.25,0.515,0.5590778097982708
0.687,400,"[[97, 50], [103, 150]]",97,103,50,103,200,200,147,253,247,153,0.6175,0.6598639455782312,0.485,0.75,0.25,0.515,0.5590778097982708
0.688,400,"[[97, 50], [103, 150]]",97,103,50,103,200,200,147,253,247,153,0.6175,0.6598639455782312,0.485,0.75,0.25,0.515,0.5590778097982708
0.689,400,"[[97, 50], [103, 150]]",97,103,50,103,200,200,147,253,247,153,0.6175,0.6598639455782312,0.485,0.75,0.25,0.515,0.5590778097982708
0.69,400,"[[97, 49], [103, 151]]",97,103,49,103,200,200,146,254,248,152,0.62,0.6643835616438356,0.485,0.755,0.245,0.515,0.560693641618497
0.691,400,"[[97, 49], [103, 151]]",97,103,49,103,200,200,146,254,248,152,0.62,0.6643835616438356,0.485,0.755,0.245,0.515,0.560693641618497
0.692,400,"[[97, 49], [103, 151]]",97,103,49,103,200,200,146,254,248,152,0.62,0.6643835616438356,0.485,0.755,0.245,0.515,0.560693641618497
0.693,400,"[[96, 49], [104, 151]]",96,104,49,104,200,200,145,255,247,153,0.6175,0.6620689655172414,0.48,0.755,0.245,0.52,0.5565217391304347
0.694,400,"[[96, 49], [104, 151]]",96,104,49,104,200,200,145,255,247,153,0.6175,0.6620689655172414,0.48,0.755,0.245,0.52,0.5565217391304347
0.695,400,"[[96, 49], [104, 151]]",96,104,49,104,200,200,145,255,247,153,0.6175,0.6620689655172414,0.48,0.755,0.245,0.52,0.5565217391304347
0.696,400,"[[96, 49], [104, 151]]",96,104,49,104,200,200,145,255,247,153,0.6175,0.6620689655172414,0.48,0.755,0.245,0.52,0.5565217391304347
0.697,400,"[[96, 48], [104, 152]]",96,104,48,104,200,200,144,256,248,152,0.62,0.6666666666666666,0.48,0.76,0.24,0.52,0.5581395348837209
0.698,400,"[[96, 48], [104, 152]]",96,104,48,104,200,200,144,256,248,152,0.62,0.6666666666666666,0.48,0.76,0.24,0.52,0.5581395348837209
0.699,400,"[[96, 48], [104, 152]]",96,104,48,104,200,200,144,256,248,152,0.62,0.6666666666666666,0.48,0.76,0.24,0.52,0.5581395348837209
0.7,400,"[[96, 48], [104, 152]]",96,104,48,104,200,200,144,256,248,152,0.62,0.6666666666666666,0.48,0.76,0.24,0.52,0.5581395348837209
0.701,400,"[[96, 48], [104, 152]]",96,104,48,104,200,200,144,256,248,152,0.62,0.6666666666666666,0.48,0.76,0.24,0.52,0.5581395348837209
0.702,400,"[[95, 48], [105, 152]]",95,105,48,105,200,200,143,257,247,153,0.6175,0.6643356643356644,0.475,0.76,0.24,0.525,0.5539358600583091
0.703,400,"[[95, 48], [105, 152]]",95,105,48,105,200,200,143,257,247,153,0.6175,0.6643356643356644,0.475,0.76,0.24,0.525,0.5539358600583091
0.704,400,"[[95, 48], [105, 152]]",95,105,48,105,200,200,143,257,247,153,0.6175,0.6643356643356644,0.475,0.76,0.24,0.525,0.5539358600583091
0.705,400,"[[95, 48], [105, 152]]",95,105,48,105,200,200,143,257,247,153,0.6175,0.6643356643356644,0.475,0.76,0.24,0.525,0.5539358600583091
0.706,400,"[[94, 48], [106, 152]]",94,106,48,106,200,200,142,258,246,154,0.615,0.6619718309859155,0.47,0.76,0.24,0.53,0.5497076023391813
0.707,400,"[[94, 48], [106, 152]]",94,106,48,106,200,200,142,258,246,154,0.615,0.6619718309859155,0.47,0.76,0.24,0.53,0.5497076023391813
0.708,400,"[[94, 48], [106, 152]]",94,106,48,106,200,200,142,258,246,154,0.615,0.6619718309859155,0.47,0.76,0.24,0.53,0.5497076023391813
0.709,400,"[[94, 48], [106, 152]]",94,106,48,106,200,200,142,258,246,154,0.615,0.6619718309859155,0.47,0.76,0.24,0.53,0.5497076023391813
0.71,400,"[[94, 48], [106, 152]]",94,106,48,106,200,200,142,258,246,154,0.615,0.6619718309859155,0.47,0.76,0.24,0.53,0.5497076023391813
0.711,400,"[[94, 48], [106, 152]]",94,106,48,106,200,200,142,258,246,154,0.615,0.6619718309859155,0.47,0.76,0.24,0.53,0.5497076023391813
0.712,400,"[[94, 48], [106, 152]]",94,106,48,106,200,200,142,258,246,154,0.615,0.6619718309859155,0.47,0.76,0.24,0.53,0.5497076023391813
0.713,400,"[[94, 48], [106, 152]]",94,106,48,106,200,200,142,258,246,154,0.615,0.6619718309859155,0.47,0.76,0.24,0.53,0.5497076023391813
0.714,400,"[[94, 48], [106, 152]]",94,106,48,106,200,200,142,258,246,154,0.615,0.6619718309859155,0.47,0.76,0.24,0.53,0.5497076023391813
0.715,400,"[[94, 48], [106, 152]]",94,106,48,106,200,200,142,258,246,154,0.615,0.6619718309859155,0.47,0.76,0.24,0.53,0.5497076023391813
0.716,400,"[[94, 48], [106, 152]]",94,106,48,106,200,200,142,258,246,154,0.615,0.6619718309859155,0.47,0.76,0.24,0.53,0.5497076023391813
0.717,400,"[[94, 48], [106, 152]]",94,106,48,106,200,200,142,258,246,154,0.615,0.6619718309859155,0.47,0.76,0.24,0.53,0.5497076023391813
0.718,400,"[[94, 48], [106, 152]]",94,106,48,106,200,200,142,258,246,154,0.615,0.6619718309859155,0.47,0.76,0.24,0.53,0.5497076023391813
0.719,400,"[[94, 48], [106, 152]]",94,106,48,106,200,200,142,258,246,154,0.615,0.6619718309859155,0.47,0.76,0.24,0.53,0.5497076023391813
0.72,400,"[[94, 47], [106, 153]]",94,106,47,106,200,200,141,259,247,153,0.6175,0.6666666666666666,0.47,0.765,0.235,0.53,0.5513196480938416
0.721,400,"[[94, 47], [106, 153]]",94,106,47,106,200,200,141,259,247,153,0.6175,0.6666666666666666,0.47,0.765,0.235,0.53,0.5513196480938416
0.722,400,"[[94, 45], [106, 155]]",94,106,45,106,200,200,139,261,249,151,0.6225,0.6762589928057554,0.47,0.775,0.225,0.53,0.5545722713864306
0.723,400,"[[94, 45], [106, 155]]",94,106,45,106,200,200,139,261,249,151,0.6225,0.6762589928057554,0.47,0.775,0.225,0.53,0.5545722713864306
0.724,400,"[[94, 45], [106, 155]]",94,106,45,106,200,200,139,261,249,151,0.6225,0.6762589928057554,0.47,0.775,0.225,0.53,0.5545722713864306
0.725,400,"[[94, 45], [106, 155]]",94,106,45,106,200,200,139,261,249,151,0.6225,0.6762589928057554,0.47,0.775,0.225,0.53,0.5545722713864306
0.726,400,"[[94, 45], [106, 155]]",94,106,45,106,200,200,139,261,249,151,0.6225,0.6762589928057554,0.47,0.775,0.225,0.53,0.5545722713864306
0.727,400,"[[94, 45], [106, 155]]",94,106,45,106,200,200,139,261,249,151,0.6225,0.6762589928057554,0.47,0.775,0.225,0.53,0.5545722713864306
0.728,400,"[[94, 45], [106, 155]]",94,106,45,106,200,200,139,261,249,151,0.6225,0.6762589928057554,0.47,0.775,0.225,0.53,0.5545722713864306
0.729,400,"[[94, 45], [106, 155]]",94,106,45,106,200,200,139,261,249,151,0.6225,0.6762589928057554,0.47,0.775,0.225,0.53,0.5545722713864306
0.73,400,"[[93, 45], [107, 155]]",93,107,45,107,200,200,138,262,248,152,0.62,0.6739130434782609,0.465,0.775,0.225,0.535,0.5502958579881657
0.731,400,"[[92, 45], [108, 155]]",92,108,45,108,200,200,137,263,247,153,0.6175,0.6715328467153284,0.46,0.775,0.225,0.54,0.5459940652818991
0.732,400,"[[90, 45], [110, 155]]",90,110,45,110,200,200,135,265,245,155,0.6125,0.6666666666666666,0.45,0.775,0.225,0.55,0.5373134328358209
0.733,400,"[[90, 45], [110, 155]]",90,110,45,110,200,200,135,265,245,155,0.6125,0.6666666666666666,0.45,0.775,0.225,0.55,0.5373134328358209
0.734,400,"[[90, 45], [110, 155]]",90,110,45,110,200,200,135,265,245,155,0.6125,0.6666666666666666,0.45,0.775,0.225,0.55,0.5373134328358209
0.735,400,"[[89, 45], [111, 155]]",89,111,45,111,200,200,134,266,244,156,0.61,0.664179104477612,0.445,0.775,0.225,0.555,0.5329341317365269
0.736,400,"[[89, 45], [111, 155]]",89,111,45,111,200,200,134,266,244,156,0.61,0.664179104477612,0.445,0.775,0.225,0.555,0.5329341317365269
0.737,400,"[[89, 45], [111, 155]]",89,111,45,111,200,200,134,266,244,156,0.61,0.664179104477612,0.445,0.775,0.225,0.555,0.5329341317365269
0.738,400,"[[89, 45], [111, 155]]",89,111,45,111,200,200,134,266,244,156,0.61,0.664179104477612,0.445,0.775,0.225,0.555,0.5329341317365269
0.739,400,"[[89, 45], [111, 155]]",89,111,45,111,200,200,134,266,244,156,0.61,0.664179104477612,0.445,0.775,0.225,0.555,0.5329341317365269
0.74,400,"[[89, 45], [111, 155]]",89,111,45,111,200,200,134,266,244,156,0.61,0.664179104477612,0.445,0.775,0.225,0.555,0.5329341317365269
0.741,400,"[[89, 45], [111, 155]]",89,111,45,111,200,200,134,266,244,156,0.61,0.664179104477612,0.445,0.775,0.225,0.555,0.5329341317365269
0.742,400,"[[89, 45], [111, 155]]",89,111,45,111,200,200,134,266,244,156,0.61,0.664179104477612,0.445,0.775,0.225,0.555,0.5329341317365269
0.743,400,"[[88, 45], [112, 155]]",88,112,45,112,200,200,133,267,243,157,0.6075,0.6616541353383458,0.44,0.775,0.225,0.56,0.5285285285285286
0.744,400,"[[88, 45], [112, 155]]",88,112,45,112,200,200,133,267,243,157,0.6075,0.6616541353383458,0.44,0.775,0.225,0.56,0.5285285285285286
0.745,400,"[[88, 45], [112, 155]]",88,112,45,112,200,200,133,267,243,157,0.6075,0.6616541353383458,0.44,0.775,0.225,0.56,0.5285285285285286
0.746,400,"[[88, 45], [112, 155]]",88,112,45,112,200,200,133,267,243,157,0.6075,0.6616541353383458,0.44,0.775,0.225,0.56,0.5285285285285286
0.747,400,"[[88, 45], [112, 155]]",88,112,45,112,200,200,133,267,243,157,0.6075,0.6616541353383458,0.44,0.775,0.225,0.56,0.5285285285285286
0.748,400,"[[88, 45], [112, 155]]",88,112,45,112,200,200,133,267,243,157,0.6075,0.6616541353383458,0.44,0.775,0.225,0.56,0.5285285285285286
0.749,400,"[[88, 45], [112, 155]]",88,112,45,112,200,200,133,267,243,157,0.6075,0.6616541353383458,0.44,0.775,0.225,0.56,0.5285285285285286
0.75,400,"[[88, 45], [112, 155]]",88,112,45,112,200,200,133,267,243,157,0.6075,0.6616541353383458,0.44,0.775,0.225,0.56,0.5285285285285286
0.751,400,"[[88, 45], [112, 155]]",88,112,45,112,200,200,133,267,243,157,0.6075,0.6616541353383458,0.44,0.775,0.225,0.56,0.5285285285285286
0.752,400,"[[88, 45], [112, 155]]",88,112,45,112,200,200,133,267,243,157,0.6075,0.6616541353383458,0.44,0.775,0.225,0.56,0.5285285285285286
0.753,400,"[[87, 45], [113, 155]]",87,113,45,113,200,200,132,268,242,158,0.605,0.6590909090909091,0.435,0.775,0.225,0.565,0.5240963855421686
0.754,400,"[[87, 45], [113, 155]]",87,113,45,113,200,200,132,268,242,158,0.605,0.6590909090909091,0.435,0.775,0.225,0.565,0.5240963855421686
0.755,400,"[[87, 45], [113, 155]]",87,113,45,113,200,200,132,268,242,158,0.605,0.6590909090909091,0.435,0.775,0.225,0.565,0.5240963855421686
0.756,400,"[[87, 45], [113, 155]]",87,113,45,113,200,200,132,268,242,158,0.605,0.6590909090909091,0.435,0.775,0.225,0.565,0.5240963855421686
0.757,400,"[[87, 45], [113, 155]]",87,113,45,113,200,200,132,268,242,158,0.605,0.6590909090909091,0.435,0.775,0.225,0.565,0.5240963855421686
0.758,400,"[[87, 45], [113, 155]]",87,113,45,113,200,200,132,268,242,158,0.605,0.6590909090909091,0.435,0.775,0.225,0.565,0.5240963855421686
0.759,400,"[[87, 45], [113, 155]]",87,113,45,113,200,200,132,268,242,158,0.605,0.6590909090909091,0.435,0.775,0.225,0.565,0.5240963855421686
0.76,400,"[[87, 45], [113, 155]]",87,113,45,113,200,200,132,268,242,158,0.605,0.6590909090909091,0.435,0.775,0.225,0.565,0.5240963855421686
0.761,400,"[[87, 45], [113, 155]]",87,113,45,113,200,200,132,268,242,158,0.605,0.6590909090909091,0.435,0.775,0.225,0.565,0.5240963855421686
0.762,400,"[[86, 45], [114, 155]]",86,114,45,114,200,200,131,269,241,159,0.6025,0.6564885496183206,0.43,0.775,0.225,0.57,0.5196374622356495
0.763,400,"[[86, 45], [114, 155]]",86,114,45,114,200,200,131,269,241,159,0.6025,0.6564885496183206,0.43,0.775,0.225,0.57,0.5196374622356495
0.764,400,"[[85, 45], [115, 155]]",85,115,45,115,200,200,130,270,240,160,0.6,0.6538461538461539,0.425,0.775,0.225,0.575,0.5151515151515152
0.765,400,"[[85, 45], [115, 155]]",85,115,45,115,200,200,130,270,240,160,0.6,0.6538461538461539,0.425,0.775,0.225,0.575,0.5151515151515152
0.766,400,"[[85, 45], [115, 155]]",85,115,45,115,200,200,130,270,240,160,0.6,0.6538461538461539,0.425,0.775,0.225,0.575,0.5151515151515152
0.767,400,"[[85, 45], [115, 155]]",85,115,45,115,200,200,130,270,240,160,0.6,0.6538461538461539,0.425,0.775,0.225,0.575,0.5151515151515152
0.768,400,"[[84, 45], [116, 155]]",84,116,45,116,200,200,129,271,239,161,0.5975,0.6511627906976745,0.42,0.775,0.225,0.58,0.5106382978723405
0.769,400,"[[84, 45], [116, 155]]",84,116,45,116,200,200,129,271,239,161,0.5975,0.6511627906976745,0.42,0.775,0.225,0.58,0.5106382978723405
0.77,400,"[[84, 45], [116, 155]]",84,116,45,116,200,200,129,271,239,161,0.5975,0.6511627906976745,0.42,0.775,0.225,0.58,0.5106382978723405
0.771,400,"[[84, 45], [116, 155]]",84,116,45,116,200,200,129,271,239,161,0.5975,0.6511627906976745,0.42,0.775,0.225,0.58,0.5106382978723405
0.772,400,"[[83, 45], [117, 155]]",83,117,45,117,200,200,128,272,238,162,0.595,0.6484375,0.415,0.775,0.225,0.585,0.5060975609756098
0.773,400,"[[83, 45], [117, 155]]",83,117,45,117,200,200,128,272,238,162,0.595,0.6484375,0.415,0.775,0.225,0.585,0.5060975609756098
0.774,400,"[[83, 45], [117, 155]]",83,117,45,117,200,200,128,272,238,162,0.595,0.6484375,0.415,0.775,0.225,0.585,0.5060975609756098
0.775,400,"[[83, 45], [117, 155]]",83,117,45,117,200,200,128,272,238,162,0.595,0.6484375,0.415,0.775,0.225,0.585,0.5060975609756098
0.776,400,"[[83, 45], [117, 155]]",83,117,45,117,200,200,128,272,238,162,0.595,0.6484375,0.415,0.775,0.225,0.585,0.5060975609756098
0.777,400,"[[83, 45], [117, 155]]",83,117,45,117,200,200,128,272,238,162,0.595,0.6484375,0.415,0.775,0.225,0.585,0.5060975609756098
0.778,400,"[[83, 44], [117, 156]]",83,117,44,117,200,200,127,273,239,161,0.5975,0.6535433070866141,0.415,0.78,0.22,0.585,0.5076452599388378
0.779,400,"[[82, 44], [118, 156]]",82,118,44,118,200,200,126,274,238,162,0.595,0.6507936507936508,0.41,0.78,0.22,0.59,0.5030674846625766
0.78,400,"[[82, 44], [118, 156]]",82,118,44,118,200,200,126,274,238,162,0.595,0.6507936507936508,0.41,0.78,0.22,0.59,0.5030674846625766
0.781,400,"[[82, 44], [118, 156]]",82,118,44,118,200,200,126,274,238,162,0.595,0.6507936507936508,0.41,0.78,0.22,0.59,0.5030674846625766
0.782,400,"[[82, 44], [118, 156]]",82,118,44,118,200,200,126,274,238,162,0.595,0.6507936507936508,0.41,0.78,0.22,0.59,0.5030674846625766
0.783,400,"[[82, 44], [118, 156]]",82,118,44,118,200,200,126,274,238,162,0.595,0.6507936507936508,0.41,0.78,0.22,0.59,0.5030674846625766
0.784,400,"[[82, 43], [118, 157]]",82,118,43,118,200,200,125,275,239,161,0.5975,0.656,0.41,0.785,0.215,0.59,0.5046153846153846
0.785,400,"[[82, 43], [118, 157]]",82,118,43,118,200,200,125,275,239,161,0.5975,0.656,0.41,0.785,0.215,0.59,0.5046153846153846
0.786,400,"[[82, 43], [118, 157]]",82,118,43,118,200,200,125,275,239,161,0.5975,0.656,0.41,0.785,0.215,0.59,0.5046153846153846
0.787,400,"[[82, 43], [118, 157]]",82,118,43,118,200,200,125,275,239,161,0.5975,0.656,0.41,0.785,0.215,0.59,0.5046153846153846
0.788,400,"[[82, 43], [118, 157]]",82,118,43,118,200,200,125,275,239,161,0.5975,0.656,0.41,0.785,0.215,0.59,0.5046153846153846
0.789,400,"[[82, 43], [118, 157]]",82,118,43,118,200,200,125,275,239,161,0.5975,0.656,0.41,0.785,0.215,0.59,0.5046153846153846
0.79,400,"[[82, 43], [118, 157]]",82,118,43,118,200,200,125,275,239,161,0.5975,0.656,0.41,0.785,0.215,0.59,0.5046153846153846
0.791,400,"[[82, 43], [118, 157]]",82,118,43,118,200,200,125,275,239,161,0.5975,0.656,0.41,0.785,0.215,0.59,0.5046153846153846
0.792,400,"[[82, 43], [118, 157]]",82,118,43,118,200,200,125,275,239,161,0.5975,0.656,0.41,0.785,0.215,0.59,0.5046153846153846
0.793,400,"[[82, 43], [118, 157]]",82,118,43,118,200,200,125,275,239,161,0.5975,0.656,0.41,0.785,0.215,0.59,0.5046153846153846
0.794,400,"[[82, 43], [118, 157]]",82,118,43,118,200,200,125,275,239,161,0.5975,0.656,0.41,0.785,0.215,0.59,0.5046153846153846
0.795,400,"[[82, 43], [118, 157]]",82,118,43,118,200,200,125,275,239,161,0.5975,0.656,0.41,0.785,0.215,0.59,0.5046153846153846
0.796,400,"[[82, 43], [118, 157]]",82,118,43,118,200,200,125,275,239,161,0.5975,0.656,0.41,0.785,0.215,0.59,0.5046153846153846
0.797,400,"[[82, 42], [118, 158]]",82,118,42,118,200,200,124,276,240,160,0.6,0.6612903225806451,0.41,0.79,0.21,0.59,0.5061728395061729
0.798,400,"[[82, 42], [118, 158]]",82,118,42,118,200,200,124,276,240,160,0.6,0.6612903225806451,0.41,0.79,0.21,0.59,0.5061728395061729
0.799,400,"[[82, 42], [118, 158]]",82,118,42,118,200,200,124,276,240,160,0.6,0.6612903225806451,0.41,0.79,0.21,0.59,0.5061728395061729
0.8,400,"[[82, 42], [118, 158]]",82,118,42,118,200,200,124,276,240,160,0.6,0.6612903225806451,0.41,0.79,0.21,0.59,0.5061728395061729
0.801,400,"[[82, 42], [118, 158]]",82,118,42,118,200,200,124,276,240,160,0.6,0.6612903225806451,0.41,0.79,0.21,0.59,0.5061728395061729
0.802,400,"[[82, 42], [118, 158]]",82,118,42,118,200,200,124,276,240,160,0.6,0.6612903225806451,0.41,0.79,0.21,0.59,0.5061728395061729
0.803,400,"[[82, 42], [118, 158]]",82,118,42,118,200,200,124,276,240,160,0.6,0.6612903225806451,0.41,0.79,0.21,0.59,0.5061728395061729
0.804,400,"[[82, 41], [118, 159]]",82,118,41,118,200,200,123,277,241,159,0.6025,0.6666666666666666,0.41,0.795,0.205,0.59,0.5077399380804953
0.805,400,"[[81, 41], [119, 159]]",81,119,41,119,200,200,122,278,240,160,0.6,0.6639344262295082,0.405,0.795,0.205,0.595,0.5031055900621119
0.806,400,"[[81, 41], [119, 159]]",81,119,41,119,200,200,122,278,240,160,0.6,0.6639344262295082,0.405,0.795,0.205,0.595,0.5031055900621119
0.807,400,"[[81, 41], [119, 159]]",81,119,41,119,200,200,122,278,240,160,0.6,0.6639344262295082,0.405,0.795,0.205,0.595,0.5031055900621119
0.808,400,"[[81, 41], [119, 159]]",81,119,41,119,200,200,122,278,240,160,0.6,0.6639344262295082,0.405,0.795,0.205,0.595,0.5031055900621119
0.809,400,"[[81, 41], [119, 159]]",81,119,41,119,200,200,122,278,240,160,0.6,0.6639344262295082,0.405,0.795,0.205,0.595,0.5031055900621119
0.81,400,"[[81, 41], [119, 159]]",81,119,41,119,200,200,122,278,240,160,0.6,0.6639344262295082,0.405,0.795,0.205,0.595,0.5031055900621119
0.811,400,"[[81, 41], [119, 159]]",81,119,41,119,200,200,122,278,240,160,0.6,0.6639344262295082,0.405,0.795,0.205,0.595,0.5031055900621119
0.812,400,"[[81, 41], [119, 159]]",81,119,41,119,200,200,122,278,240,160,0.6,0.6639344262295082,0.405,0.795,0.205,0.595,0.5031055900621119
0.813,400,"[[81, 41], [119, 159]]",81,119,41,119,200,200,122,278,240,160,0.6,0.6639344262295082,0.405,0.795,0.205,0.595,0.5031055900621119
0.814,400,"[[81, 41], [119, 159]]",81,119,41,119,200,200,122,278,240,160,0.6,0.6639344262295082,0.405,0.795,0.205,0.595,0.5031055900621119
0.815,400,"[[81, 41], [119, 159]]",81,119,41,119,200,200,122,278,240,160,0.6,0.6639344262295082,0.405,0.795,0.205,0.595,0.5031055900621119
0.816,400,"[[81, 40], [119, 160]]",81,119,40,119,200,200,121,279,241,159,0.6025,0.6694214876033058,0.405,0.8,0.2,0.595,0.5046728971962617
0.817,400,"[[81, 40], [119, 160]]",81,119,40,119,200,200,121,279,241,159,0.6025,0.6694214876033058,0.405,0.8,0.2,0.595,0.5046728971962617
0.818,400,"[[81, 40], [119, 160]]",81,119,40,119,200,200,121,279,241,159,0.6025,0.6694214876033058,0.405,0.8,0.2,0.595,0.5046728971962617
0.819,400,"[[81, 40], [119, 160]]",81,119,40,119,200,200,121,279,241,159,0.6025,0.6694214876033058,0.405,0.8,0.2,0.595,0.5046728971962617
0.82,400,"[[81, 40], [119, 160]]",81,119,40,119,200,200,121,279,241,159,0.6025,0.6694214876033058,0.405,0.8,0.2,0.595,0.5046728971962617
0.821,400,"[[81, 40], [119, 160]]",81,119,40,119,200,200,121,279,241,159,0.6025,0.6694214876033058,0.405,0.8,0.2,0.595,0.5046728971962617
0.822,400,"[[81, 39], [119, 161]]",81,119,39,119,200,200,120,280,242,158,0.605,0.675,0.405,0.805,0.195,0.595,0.50625
0.823,400,"[[81, 39], [119, 161]]",81,119,39,119,200,200,120,280,242,158,0.605,0.675,0.405,0.805,0.195,0.595,0.50625
0.824,400,"[[81, 39], [119, 161]]",81,119,39,119,200,200,120,280,242,158,0.605,0.675,0.405,0.805,0.195,0.595,0.50625
0.825,400,"[[81, 39], [119, 161]]",81,119,39,119,200,200,120,280,242,158,0.605,0.675,0.405,0.805,0.195,0.595,0.50625
0.826,400,"[[81, 39], [119, 161]]",81,119,39,119,200,200,120,280,242,158,0.605,0.675,0.405,0.805,0.195,0.595,0.50625
0.827,400,"[[81, 39], [119, 161]]",81,119,39,119,200,200,120,280,242,158,0.605,0.675,0.405,0.805,0.195,0.595,0.50625
0.828,400,"[[81, 39], [119, 161]]",81,119,39,119,200,200,120,280,242,158,0.605,0.675,0.405,0.805,0.195,0.595,0.50625
0.829,400,"[[81, 39], [119, 161]]",81,119,39,119,200,200,120,280,242,158,0.605,0.675,0.405,0.805,0.195,0.595,0.50625
0.83,400,"[[81, 39], [119, 161]]",81,119,39,119,200,200,120,280,242,158,0.605,0.675,0.405,0.805,0.195,0.595,0.50625
0.831,400,"[[81, 38], [119, 162]]",81,119,38,119,200,200,119,281,243,157,0.6075,0.680672268907563,0.405,0.81,0.19,0.595,0.5078369905956114
0.832,400,"[[81, 38], [119, 162]]",81,119,38,119,200,200,119,281,243,157,0.6075,0.680672268907563,0.405,0.81,0.19,0.595,0.5078369905956114
0.833,400,"[[81, 37], [119, 163]]",81,119,37,119,200,200,118,282,244,156,0.61,0.6864406779661016,0.405,0.815,0.185,0.595,0.5094339622641509
0.834,400,"[[81, 37], [119, 163]]",81,119,37,119,200,200,118,282,244,156,0.61,0.6864406779661016,0.405,0.815,0.185,0.595,0.5094339622641509
0.835,400,"[[81, 37], [119, 163]]",81,119,37,119,200,200,118,282,244,156,0.61,0.6864406779661016,0.405,0.815,0.185,0.595,0.5094339622641509
0.836,400,"[[81, 37], [119, 163]]",81,119,37,119,200,200,118,282,244,156,0.61,0.6864406779661016,0.405,0.815,0.185,0.595,0.5094339622641509
0.837,400,"[[81, 37], [119, 163]]",81,119,37,119,200,200,118,282,244,156,0.61,0.6864406779661016,0.405,0.815,0.185,0.595,0.5094339622641509
0.838,400,"[[81, 37], [119, 163]]",81,119,37,119,200,200,118,282,244,156,0.61,0.6864406779661016,0.405,0.815,0.185,0.595,0.5094339622641509
0.839,400,"[[81, 37], [119, 163]]",81,119,37,119,200,200,118,282,244,156,0.61,0.6864406779661016,0.405,0.815,0.185,0.595,0.5094339622641509
0.84,400,"[[81, 37], [119, 163]]",81,119,37,119,200,200,118,282,244,156,0.61,0.6864406779661016,0.405,0.815,0.185,0.595,0.5094339622641509
0.841,400,"[[81, 37], [119, 163]]",81,119,37,119,200,200,118,282,244,156,0.61,0.6864406779661016,0.405,0.815,0.185,0.595,0.5094339622641509
0.842,400,"[[81, 37], [119, 163]]",81,119,37,119,200,200,118,282,244,156,0.61,0.6864406779661016,0.405,0.815,0.185,0.595,0.5094339622641509
0.843,400,"[[81, 37], [119, 163]]",81,119,37,119,200,200,118,282,244,156,0.61,0.6864406779661016,0.405,0.815,0.185,0.595,0.5094339622641509
0.844,400,"[[81, 37], [119, 163]]",81,119,37,119,200,200,118,282,244,156,0.61,0.6864406779661016,0.405,0.815,0.185,0.595,0.5094339622641509
0.845,400,"[[81, 36], [119, 164]]",81,119,36,119,200,200,117,283,245,155,0.6125,0.6923076923076923,0.405,0.82,0.18,0.595,0.5110410094637224
0.846,400,"[[81, 36], [119, 164]]",81,119,36,119,200,200,117,283,245,155,0.6125,0.6923076923076923,0.405,0.82,0.18,0.595,0.5110410094637224
0.847,400,"[[81, 36], [119, 164]]",81,119,36,119,200,200,117,283,245,155,0.6125,0.6923076923076923,0.405,0.82,0.18,0.595,0.5110410094637224
0.848,400,"[[81, 36], [119, 164]]",81,119,36,119,200,200,117,283,245,155,0.6125,0.6923076923076923,0.405,0.82,0.18,0.595,0.5110410094637224
0.849,400,"[[81, 36], [119, 164]]",81,119,36,119,200,200,117,283,245,155,0.6125,0.6923076923076923,0.405,0.82,0.18,0.595,0.5110410094637224
0.85,400,"[[81, 36], [119, 164]]",81,119,36,119,200,200,117,283,245,155,0.6125,0.6923076923076923,0.405,0.82,0.18,0.595,0.5110410094637224
0.851,400,"[[81, 36], [119, 164]]",81,119,36,119,200,200,117,283,245,155,0.6125,0.6923076923076923,0.405,0.82,0.18,0.595,0.5110410094637224
0.852,400,"[[81, 36], [119, 164]]",81,119,36,119,200,200,117,283,245,155,0.6125,0.6923076923076923,0.405,0.82,0.18,0.595,0.5110410094637224
0.853,400,"[[81, 36], [119, 164]]",81,119,36,119,200,200,117,283,245,155,0.6125,0.6923076923076923,0.405,0.82,0.18,0.595,0.5110410094637224
0.854,400,"[[81, 36], [119, 164]]",81,119,36,119,200,200,117,283,245,155,0.6125,0.6923076923076923,0.405,0.82,0.18,0.595,0.5110410094637224
0.855,400,"[[81, 36], [119, 164]]",81,119,36,119,200,200,117,283,245,155,0.6125,0.6923076923076923,0.405,0.82,0.18,0.595,0.5110410094637224
0.856,400,"[[81, 36], [119, 164]]",81,119,36,119,200,200,117,283,245,155,0.6125,0.6923076923076923,0.405,0.82,0.18,0.595,0.5110410094637224
0.857,400,"[[81, 36], [119, 164]]",81,119,36,119,200,200,117,283,245,155,0.6125,0.6923076923076923,0.405,0.82,0.18,0.595,0.5110410094637224
0.858,400,"[[81, 36], [119, 164]]",81,119,36,119,200,200,117,283,245,155,0.6125,0.6923076923076923,0.405,0.82,0.18,0.595,0.5110410094637224
0.859,400,"[[81, 36], [119, 164]]",81,119,36,119,200,200,117,283,245,155,0.6125,0.6923076923076923,0.405,0.82,0.18,0.595,0.5110410094637224
0.86,400,"[[81, 36], [119, 164]]",81,119,36,119,200,200,117,283,245,155,0.6125,0.6923076923076923,0.405,0.82,0.18,0.595,0.5110410094637224
0.861,400,"[[79, 36], [121, 164]]",79,121,36,121,200,200,115,285,243,157,0.6075,0.6869565217391305,0.395,0.82,0.18,0.605,0.5015873015873017
0.862,400,"[[79, 36], [121, 164]]",79,121,36,121,200,200,115,285,243,157,0.6075,0.6869565217391305,0.395,0.82,0.18,0.605,0.5015873015873017
0.863,400,"[[79, 36], [121, 164]]",79,121,36,121,200,200,115,285,243,157,0.6075,0.6869565217391305,0.395,0.82,0.18,0.605,0.5015873015873017
0.864,400,"[[79, 36], [121, 164]]",79,121,36,121,200,200,115,285,243,157,0.6075,0.6869565217391305,0.395,0.82,0.18,0.605,0.5015873015873017
0.865,400,"[[79, 36], [121, 164]]",79,121,36,121,200,200,115,285,243,157,0.6075,0.6869565217391305,0.395,0.82,0.18,0.605,0.5015873015873017
0.866,400,"[[79, 35], [121, 165]]",79,121,35,121,200,200,114,286,244,156,0.61,0.6929824561403509,0.395,0.825,0.175,0.605,0.5031847133757962
0.867,400,"[[79, 35], [121, 165]]",79,121,35,121,200,200,114,286,244,156,0.61,0.6929824561403509,0.395,0.825,0.175,0.605,0.5031847133757962
0.868,400,"[[79, 35], [121, 165]]",79,121,35,121,200,200,114,286,244,156,0.61,0.6929824561403509,0.395,0.825,0.175,0.605,0.5031847133757962
0.869,400,"[[78, 35], [122, 165]]",78,122,35,122,200,200,113,287,243,157,0.6075,0.6902654867256637,0.39,0.825,0.175,0.61,0.4984025559105431
0.87,400,"[[77, 35], [123, 165]]",77,123,35,123,200,200,112,288,242,158,0.605,0.6875,0.385,0.825,0.175,0.615,0.4935897435897436
0.871,400,"[[77, 34], [123, 166]]",77,123,34,123,200,200,111,289,243,157,0.6075,0.6936936936936937,0.385,0.83,0.17,0.615,0.49517684887459806
0.872,400,"[[77, 34], [123, 166]]",77,123,34,123,200,200,111,289,243,157,0.6075,0.6936936936936937,0.385,0.83,0.17,0.615,0.49517684887459806
0.873,400,"[[77, 34], [123, 166]]",77,123,34,123,200,200,111,289,243,157,0.6075,0.6936936936936937,0.385,0.83,0.17,0.615,0.49517684887459806
0.874,400,"[[77, 34], [123, 166]]",77,123,34,123,200,200,111,289,243,157,0.6075,0.6936936936936937,0.385,0.83,0.17,0.615,0.49517684887459806
0.875,400,"[[76, 34], [124, 166]]",76,124,34,124,200,200,110,290,242,158,0.605,0.6909090909090909,0.38,0.83,0.17,0.62,0.4903225806451613
0.876,400,"[[76, 34], [124, 166]]",76,124,34,124,200,200,110,290,242,158,0.605,0.6909090909090909,0.38,0.83,0.17,0.62,0.4903225806451613
0.877,400,"[[76, 34], [124, 166]]",76,124,34,124,200,200,110,290,242,158,0.605,0.6909090909090909,0.38,0.83,0.17,0.62,0.4903225806451613
0.878,400,"[[76, 33], [124, 167]]",76,124,33,124,200,200,109,291,243,157,0.6075,0.6972477064220184,0.38,0.835,0.165,0.62,0.49190938511326854
0.879,400,"[[76, 33], [124, 167]]",76,124,33,124,200,200,109,291,243,157,0.6075,0.6972477064220184,0.38,0.835,0.165,0.62,0.49190938511326854
0.88,400,"[[76, 33], [124, 167]]",76,124,33,124,200,200,109,291,243,157,0.6075,0.6972477064220184,0.38,0.835,0.165,0.62,0.49190938511326854
0.881,400,"[[76, 33], [124, 167]]",76,124,33,124,200,200,109,291,243,157,0.6075,0.6972477064220184,0.38,0.835,0.165,0.62,0.49190938511326854
0.882,400,"[[76, 33], [124, 167]]",76,124,33,124,200,200,109,291,243,157,0.6075,0.6972477064220184,0.38,0.835,0.165,0.62,0.49190938511326854
0.883,400,"[[76, 33], [124, 167]]",76,124,33,124,200,200,109,291,243,157,0.6075,0.6972477064220184,0.38,0.835,0.165,0.62,0.49190938511326854
0.884,400,"[[76, 33], [124, 167]]",76,124,33,124,200,200,109,291,243,157,0.6075,0.6972477064220184,0.38,0.835,0.165,0.62,0.49190938511326854
0.885,400,"[[76, 33], [124, 167]]",76,124,33,124,200,200,109,291,243,157,0.6075,0.6972477064220184,0.38,0.835,0.165,0.62,0.49190938511326854
0.886,400,"[[76, 33], [124, 167]]",76,124,33,124,200,200,109,291,243,157,0.6075,0.6972477064220184,0.38,0.835,0.165,0.62,0.49190938511326854
0.887,400,"[[76, 33], [124, 167]]",76,124,33,124,200,200,109,291,243,157,0.6075,0.6972477064220184,0.38,0.835,0.165,0.62,0.49190938511326854
0.888,400,"[[75, 33], [125, 167]]",75,125,33,125,200,200,108,292,242,158,0.605,0.6944444444444444,0.375,0.835,0.165,0.625,0.48701298701298695
0.889,400,"[[74, 33], [126, 167]]",74,126,33,126,200,200,107,293,241,159,0.6025,0.6915887850467289,0.37,0.835,0.165,0.63,0.48208469055374586
0.89,400,"[[74, 32], [126, 168]]",74,126,32,126,200,200,106,294,242,158,0.605,0.6981132075471698,0.37,0.84,0.16,0.63,0.48366013071895425
0.891,400,"[[74, 32], [126, 168]]",74,126,32,126,200,200,106,294,242,158,0.605,0.6981132075471698,0.37,0.84,0.16,0.63,0.48366013071895425
0.892,400,"[[72, 31], [128, 169]]",72,128,31,128,200,200,103,297,241,159,0.6025,0.6990291262135923,0.36,0.845,0.155,0.64,0.4752475247524753
0.893,400,"[[72, 31], [128, 169]]",72,128,31,128,200,200,103,297,241,159,0.6025,0.6990291262135923,0.36,0.845,0.155,0.64,0.4752475247524753
0.894,400,"[[72, 31], [128, 169]]",72,128,31,128,200,200,103,297,241,159,0.6025,0.6990291262135923,0.36,0.845,0.155,0.64,0.4752475247524753
0.895,400,"[[72, 31], [128, 169]]",72,128,31,128,200,200,103,297,241,159,0.6025,0.6990291262135923,0.36,0.845,0.155,0.64,0.4752475247524753
0.896,400,"[[72, 31], [128, 169]]",72,128,31,128,200,200,103,297,241,159,0.6025,0.6990291262135923,0.36,0.845,0.155,0.64,0.4752475247524753
0.897,400,"[[71, 31], [129, 169]]",71,129,31,129,200,200,102,298,240,160,0.6,0.696078431372549,0.355,0.845,0.155,0.645,0.4701986754966887
0.898,400,"[[71, 31], [129, 169]]",71,129,31,129,200,200,102,298,240,160,0.6,0.696078431372549,0.355,0.845,0.155,0.645,0.4701986754966887
0.899,400,"[[71, 31], [129, 169]]",71,129,31,129,200,200,102,298,240,160,0.6,0.696078431372549,0.355,0.845,0.155,0.645,0.4701986754966887
0.9,400,"[[71, 31], [129, 169]]",71,129,31,129,200,200,102,298,240,160,0.6,0.696078431372549,0.355,0.845,0.155,0.645,0.4701986754966887
0.901,400,"[[71, 31], [129, 169]]",71,129,31,129,200,200,102,298,240,160,0.6,0.696078431372549,0.355,0.845,0.155,0.645,0.4701986754966887
0.902,400,"[[71, 31], [129, 169]]",71,129,31,129,200,200,102,298,240,160,0.6,0.696078431372549,0.355,0.845,0.155,0.645,0.4701986754966887
0.903,400,"[[71, 31], [129, 169]]",71,129,31,129,200,200,102,298,240,160,0.6,0.696078431372549,0.355,0.845,0.155,0.645,0.4701986754966887
0.904,400,"[[71, 30], [129, 170]]",71,129,30,129,200,200,101,299,241,159,0.6025,0.7029702970297029,0.355,0.85,0.15,0.645,0.4717607973421927
0.905,400,"[[71, 30], [129, 170]]",71,129,30,129,200,200,101,299,241,159,0.6025,0.7029702970297029,0.355,0.85,0.15,0.645,0.4717607973421927
0.906,400,"[[71, 30], [129, 170]]",71,129,30,129,200,200,101,299,241,159,0.6025,0.7029702970297029,0.355,0.85,0.15,0.645,0.4717607973421927
0.907,400,"[[71, 30], [129, 170]]",71,129,30,129,200,200,101,299,241,159,0.6025,0.7029702970297029,0.355,0.85,0.15,0.645,0.4717607973421927
0.908,400,"[[71, 30], [129, 170]]",71,129,30,129,200,200,101,299,241,159,0.6025,0.7029702970297029,0.355,0.85,0.15,0.645,0.4717607973421927
0.909,400,"[[70, 30], [130, 170]]",70,130,30,130,200,200,100,300,240,160,0.6,0.7,0.35,0.85,0.15,0.65,0.4666666666666667
0.91,400,"[[70, 30], [130, 170]]",70,130,30,130,200,200,100,300,240,160,0.6,0.7,0.35,0.85,0.15,0.65,0.4666666666666667
0.911,400,"[[70, 30], [130, 170]]",70,130,30,130,200,200,100,300,240,160,0.6,0.7,0.35,0.85,0.15,0.65,0.4666666666666667
0.912,400,"[[70, 30], [130, 170]]",70,130,30,130,200,200,100,300,240,160,0.6,0.7,0.35,0.85,0.15,0.65,0.4666666666666667
0.913,400,"[[70, 30], [130, 170]]",70,130,30,130,200,200,100,300,240,160,0.6,0.7,0.35,0.85,0.15,0.65,0.4666666666666667
0.914,400,"[[70, 29], [130, 171]]",70,130,29,130,200,200,99,301,241,159,0.6025,0.7070707070707071,0.35,0.855,0.145,0.65,0.46822742474916385
0.915,400,"[[69, 29], [131, 171]]",69,131,29,131,200,200,98,302,240,160,0.6,0.7040816326530612,0.345,0.855,0.145,0.655,0.4630872483221476
0.916,400,"[[67, 29], [133, 171]]",67,133,29,133,200,200,96,304,238,162,0.595,0.6979166666666666,0.335,0.855,0.145,0.665,0.4527027027027027
0.917,400,"[[64, 29], [136, 171]]",64,136,29,136,200,200,93,307,235,165,0.5875,0.6881720430107527,0.32,0.855,0.145,0.68,0.43686006825938567
0.918,400,"[[64, 29], [136, 171]]",64,136,29,136,200,200,93,307,235,165,0.5875,0.6881720430107527,0.32,0.855,0.145,0.68,0.43686006825938567
0.919,400,"[[63, 29], [137, 171]]",63,137,29,137,200,200,92,308,234,166,0.585,0.6847826086956522,0.315,0.855,0.145,0.685,0.4315068493150685
0.92,400,"[[63, 29], [137, 171]]",63,137,29,137,200,200,92,308,234,166,0.585,0.6847826086956522,0.315,0.855,0.145,0.685,0.4315068493150685
0.921,400,"[[63, 29], [137, 171]]",63,137,29,137,200,200,92,308,234,166,0.585,0.6847826086956522,0.315,0.855,0.145,0.685,0.4315068493150685
0.922,400,"[[62, 29], [138, 171]]",62,138,29,138,200,200,91,309,233,167,0.5825,0.6813186813186813,0.31,0.855,0.145,0.69,0.4261168384879725
0.923,400,"[[62, 29], [138, 171]]",62,138,29,138,200,200,91,309,233,167,0.5825,0.6813186813186813,0.31,0.855,0.145,0.69,0.4261168384879725
0.924,400,"[[62, 29], [138, 171]]",62,138,29,138,200,200,91,309,233,167,0.5825,0.6813186813186813,0.31,0.855,0.145,0.69,0.4261168384879725
0.925,400,"[[60, 29], [140, 171]]",60,140,29,140,200,200,89,311,231,169,0.5775,0.6741573033707865,0.3,0.855,0.145,0.7,0.4152249134948097
0.926,400,"[[60, 29], [140, 171]]",60,140,29,140,200,200,89,311,231,169,0.5775,0.6741573033707865,0.3,0.855,0.145,0.7,0.4152249134948097
0.927,400,"[[57, 29], [143, 171]]",57,143,29,143,200,200,86,314,228,172,0.57,0.6627906976744186,0.285,0.855,0.145,0.715,0.39860139860139854
0.928,400,"[[57, 29], [143, 171]]",57,143,29,143,200,200,86,314,228,172,0.57,0.6627906976744186,0.285,0.855,0.145,0.715,0.39860139860139854
0.929,400,"[[57, 28], [143, 172]]",57,143,28,143,200,200,85,315,229,171,0.5725,0.6705882352941176,0.285,0.86,0.14,0.715,0.39999999999999997
0.93,400,"[[57, 28], [143, 172]]",57,143,28,143,200,200,85,315,229,171,0.5725,0.6705882352941176,0.285,0.86,0.14,0.715,0.39999999999999997
0.931,400,"[[57, 28], [143, 172]]",57,143,28,143,200,200,85,315,229,171,0.5725,0.6705882352941176,0.285,0.86,0.14,0.715,0.39999999999999997
0.932,400,"[[57, 28], [143, 172]]",57,143,28,143,200,200,85,315,229,171,0.5725,0.6705882352941176,0.285,0.86,0.14,0.715,0.39999999999999997
0.933,400,"[[56, 28], [144, 172]]",56,144,28,144,200,200,84,316,228,172,0.57,0.6666666666666666,0.28,0.86,0.14,0.72,0.3943661971830986
0.934,400,"[[56, 28], [144, 172]]",56,144,28,144,200,200,84,316,228,172,0.57,0.6666666666666666,0.28,0.86,0.14,0.72,0.3943661971830986
0.935,400,"[[56, 28], [144, 172]]",56,144,28,144,200,200,84,316,228,172,0.57,0.6666666666666666,0.28,0.86,0.14,0.72,0.3943661971830986
0.936,400,"[[56, 28], [144, 172]]",56,144,28,144,200,200,84,316,228,172,0.57,0.6666666666666666,0.28,0.86,0.14,0.72,0.3943661971830986
0.937,400,"[[56, 28], [144, 172]]",56,144,28,144,200,200,84,316,228,172,0.57,0.6666666666666666,0.28,0.86,0.14,0.72,0.3943661971830986
0.938,400,"[[55, 28], [145, 172]]",55,145,28,145,200,200,83,317,227,173,0.5675,0.6626506024096386,0.275,0.86,0.14,0.725,0.3886925795053004
0.939,400,"[[55, 28], [145, 172]]",55,145,28,145,200,200,83,317,227,173,0.5675,0.6626506024096386,0.275,0.86,0.14,0.725,0.3886925795053004
0.94,400,"[[55, 28], [145, 172]]",55,145,28,145,200,200,83,317,227,173,0.5675,0.6626506024096386,0.275,0.86,0.14,0.725,0.3886925795053004
0.941,400,"[[55, 28], [145, 172]]",55,145,28,145,200,200,83,317,227,173,0.5675,0.6626506024096386,0.275,0.86,0.14,0.725,0.3886925795053004
0.942,400,"[[54, 28], [146, 172]]",54,146,28,146,200,200,82,318,226,174,0.565,0.6585365853658537,0.27,0.86,0.14,0.73,0.3829787234042553
0.943,400,"[[53, 28], [147, 172]]",53,147,28,147,200,200,81,319,225,175,0.5625,0.654320987654321,0.265,0.86,0.14,0.735,0.37722419928825623
0.944,400,"[[53, 28], [147, 172]]",53,147,28,147,200,200,81,319,225,175,0.5625,0.654320987654321,0.265,0.86,0.14,0.735,0.37722419928825623
0.945,400,"[[51, 28], [149, 172]]",51,149,28,149,200,200,79,321,223,177,0.5575,0.6455696202531646,0.255,0.86,0.14,0.745,0.3655913978494624
0.946,400,"[[51, 28], [149, 172]]",51,149,28,149,200,200,79,321,223,177,0.5575,0.6455696202531646,0.255,0.86,0.14,0.745,0.3655913978494624
0.947,400,"[[51, 28], [149, 172]]",51,149,28,149,200,200,79,321,223,177,0.5575,0.6455696202531646,0.255,0.86,0.14,0.745,0.3655913978494624
0.948,400,"[[51, 28], [149, 172]]",51,149,28,149,200,200,79,321,223,177,0.5575,0.6455696202531646,0.255,0.86,0.14,0.745,0.3655913978494624
0.949,400,"[[51, 28], [149, 172]]",51,149,28,149,200,200,79,321,223,177,0.5575,0.6455696202531646,0.255,0.86,0.14,0.745,0.3655913978494624
0.95,400,"[[51, 28], [149, 172]]",51,149,28,149,200,200,79,321,223,177,0.5575,0.6455696202531646,0.255,0.86,0.14,0.745,0.3655913978494624
0.951,400,"[[51, 28], [149, 172]]",51,149,28,149,200,200,79,321,223,177,0.5575,0.6455696202531646,0.255,0.86,0.14,0.745,0.3655913978494624
0.952,400,"[[51, 28], [149, 172]]",51,149,28,149,200,200,79,321,223,177,0.5575,0.6455696202531646,0.255,0.86,0.14,0.745,0.3655913978494624
0.953,400,"[[51, 28], [149, 172]]",51,149,28,149,200,200,79,321,223,177,0.5575,0.6455696202531646,0.255,0.86,0.14,0.745,0.3655913978494624
0.954,400,"[[51, 28], [149, 172]]",51,149,28,149,200,200,79,321,223,177,0.5575,0.6455696202531646,0.255,0.86,0.14,0.745,0.3655913978494624
0.955,400,"[[51, 28], [149, 172]]",51,149,28,149,200,200,79,321,223,177,0.5575,0.6455696202531646,0.255,0.86,0.14,0.745,0.3655913978494624
0.956,400,"[[51, 27], [149, 173]]",51,149,27,149,200,200,78,322,224,176,0.56,0.6538461538461539,0.255,0.865,0.135,0.745,0.3669064748201439
0.957,400,"[[51, 27], [149, 173]]",51,149,27,149,200,200,78,322,224,176,0.56,0.6538461538461539,0.255,0.865,0.135,0.745,0.3669064748201439
0.958,400,"[[51, 27], [149, 173]]",51,149,27,149,200,200,78,322,224,176,0.56,0.6538461538461539,0.255,0.865,0.135,0.745,0.3669064748201439
0.959,400,"[[51, 27], [149, 173]]",51,149,27,149,200,200,78,322,224,176,0.56,0.6538461538461539,0.255,0.865,0.135,0.745,0.3669064748201439
0.96,400,"[[51, 27], [149, 173]]",51,149,27,149,200,200,78,322,224,176,0.56,0.6538461538461539,0.255,0.865,0.135,0.745,0.3669064748201439
0.961,400,"[[51, 27], [149, 173]]",51,149,27,149,200,200,78,322,224,176,0.56,0.6538461538461539,0.255,0.865,0.135,0.745,0.3669064748201439
0.962,400,"[[50, 27], [150, 173]]",50,150,27,150,200,200,77,323,223,177,0.5575,0.6493506493506493,0.25,0.865,0.135,0.75,0.36101083032490977
0.963,400,"[[50, 26], [150, 174]]",50,150,26,150,200,200,76,324,224,176,0.56,0.6578947368421053,0.25,0.87,0.13,0.75,0.36231884057971014
0.964,400,"[[50, 26], [150, 174]]",50,150,26,150,200,200,76,324,224,176,0.56,0.6578947368421053,0.25,0.87,0.13,0.75,0.36231884057971014
0.965,400,"[[50, 26], [150, 174]]",50,150,26,150,200,200,76,324,224,176,0.56,0.6578947368421053,0.25,0.87,0.13,0.75,0.36231884057971014
0.966,400,"[[49, 25], [151, 175]]",49,151,25,151,200,200,74,326,224,176,0.56,0.6621621621621622,0.245,0.875,0.125,0.755,0.35766423357664234
0.967,400,"[[49, 25], [151, 175]]",49,151,25,151,200,200,74,326,224,176,0.56,0.6621621621621622,0.245,0.875,0.125,0.755,0.35766423357664234
0.968,400,"[[48, 25], [152, 175]]",48,152,25,152,200,200,73,327,223,177,0.5575,0.6575342465753424,0.24,0.875,0.125,0.76,0.3516483516483517
0.969,400,"[[48, 25], [152, 175]]",48,152,25,152,200,200,73,327,223,177,0.5575,0.6575342465753424,0.24,0.875,0.125,0.76,0.3516483516483517
0.97,400,"[[48, 25], [152, 175]]",48,152,25,152,200,200,73,327,223,177,0.5575,0.6575342465753424,0.24,0.875,0.125,0.76,0.3516483516483517
0.971,400,"[[47, 24], [153, 176]]",47,153,24,153,200,200,71,329,223,177,0.5575,0.6619718309859155,0.235,0.88,0.12,0.765,0.34686346863468637
0.972,400,"[[47, 24], [153, 176]]",47,153,24,153,200,200,71,329,223,177,0.5575,0.6619718309859155,0.235,0.88,0.12,0.765,0.34686346863468637
0.973,400,"[[46, 24], [154, 176]]",46,154,24,154,200,200,70,330,222,178,0.555,0.6571428571428571,0.23,0.88,0.12,0.77,0.3407407407407408
0.974,400,"[[44, 24], [156, 176]]",44,156,24,156,200,200,68,332,220,180,0.55,0.6470588235294118,0.22,0.88,0.12,0.78,0.3283582089552239
0.975,400,"[[42, 23], [158, 177]]",42,158,23,158,200,200,65,335,219,181,0.5475,0.6461538461538462,0.21,0.885,0.115,0.79,0.3169811320754717
0.976,400,"[[41, 21], [159, 179]]",41,159,21,159,200,200,62,338,220,180,0.55,0.6612903225806451,0.205,0.895,0.105,0.795,0.31297709923664124
0.977,400,"[[41, 21], [159, 179]]",41,159,21,159,200,200,62,338,220,180,0.55,0.6612903225806451,0.205,0.895,0.105,0.795,0.31297709923664124
0.978,400,"[[41, 20], [159, 180]]",41,159,20,159,200,200,61,339,221,179,0.5525,0.6721311475409836,0.205,0.9,0.1,0.795,0.31417624521072796
0.979,400,"[[41, 20], [159, 180]]",41,159,20,159,200,200,61,339,221,179,0.5525,0.6721311475409836,0.205,0.9,0.1,0.795,0.31417624521072796
0.98,400,"[[40, 20], [160, 180]]",40,160,20,160,200,200,60,340,220,180,0.55,0.6666666666666666,0.2,0.9,0.1,0.8,0.30769230769230765
0.981,400,"[[40, 19], [160, 181]]",40,160,19,160,200,200,59,341,221,179,0.5525,0.6779661016949152,0.2,0.905,0.095,0.8,0.30888030888030893
0.982,400,"[[40, 18], [160, 182]]",40,160,18,160,200,200,58,342,222,178,0.555,0.6896551724137931,0.2,0.91,0.09,0.8,0.310077519379845
0.983,400,"[[40, 18], [160, 182]]",40,160,18,160,200,200,58,342,222,178,0.555,0.6896551724137931,0.2,0.91,0.09,0.8,0.310077519379845
0.984,400,"[[40, 18], [160, 182]]",40,160,18,160,200,200,58,342,222,178,0.555,0.6896551724137931,0.2,0.91,0.09,0.8,0.310077519379845
0.985,400,"[[38, 17], [162, 183]]",38,162,17,162,200,200,55,345,221,179,0.5525,0.6909090909090909,0.19,0.915,0.085,0.81,0.2980392156862745
0.986,400,"[[35, 16], [165, 184]]",35,165,16,165,200,200,51,349,219,181,0.5475,0.6862745098039216,0.175,0.92,0.08,0.825,0.2788844621513944
0.987,400,"[[33, 16], [167, 184]]",33,167,16,167,200,200,49,351,217,183,0.5425,0.673469387755102,0.165,0.92,0.08,0.835,0.26506024096385544
0.988,400,"[[33, 15], [167, 185]]",33,167,15,167,200,200,48,352,218,182,0.545,0.6875,0.165,0.925,0.075,0.835,0.26612903225806456
0.989,400,"[[30, 13], [170, 187]]",30,170,13,170,200,200,43,357,217,183,0.5425,0.6976744186046512,0.15,0.935,0.065,0.85,0.2469135802469136
0.99,400,"[[30, 11], [170, 189]]",30,170,11,170,200,200,41,359,219,181,0.5475,0.7317073170731707,0.15,0.945,0.055,0.85,0.24896265560165975
0.991,400,"[[28, 10], [172, 190]]",28,172,10,172,200,200,38,362,218,182,0.545,0.7368421052631579,0.14,0.95,0.05,0.86,0.23529411764705885
0.992,400,"[[28, 10], [172, 190]]",28,172,10,172,200,200,38,362,218,182,0.545,0.7368421052631579,0.14,0.95,0.05,0.86,0.23529411764705885
0.993,400,"[[28, 10], [172, 190]]",28,172,10,172,200,200,38,362,218,182,0.545,0.7368421052631579,0.14,0.95,0.05,0.86,0.23529411764705885
0.994,400,"[[25, 9], [175, 191]]",25,175,9,175,200,200,34,366,216,184,0.54,0.7352941176470589,0.125,0.955,0.045,0.875,0.21367521367521367
0.995,400,"[[24, 9], [176, 191]]",24,176,9,176,200,200,33,367,215,185,0.5375,0.7272727272727273,0.12,0.955,0.045,0.88,0.2060085836909871
0.996,400,"[[23, 8], [177, 192]]",23,177,8,177,200,200,31,369,215,185,0.5375,0.7419354838709677,0.115,0.96,0.04,0.885,0.19913419913419914
0.997,400,"[[20, 6], [180, 194]]",20,180,6,180,200,200,26,374,214,186,0.535,0.7692307692307693,0.1,0.97,0.03,0.9,0.17699115044247787
0.998,400,"[[17, 6], [183, 194]]",17,183,6,183,200,200,23,377,211,189,0.5275,0.7391304347826086,0.085,0.97,0.03,0.915,0.1524663677130045
0.999,400,"[[13, 2], [187, 198]]",13,187,2,187,200,200,15,385,211,189,0.5275,0.8666666666666667,0.065,0.99,0.01,0.935,0.12093023255813955
1.0,400,"[[0, 0], [200, 200]]",0,200,0,200,200,200,0,400,200,200,0.5,,0.0,1.0,0.0,1.0,
1.001,400,"[[0, 0], [200, 200]]",0,200,0,200,200,200,0,400,200,200,0.5,,0.0,1.0,0.0,1.0,
