Score Threshold,Measurements (M),Confusion Matrix (cm),True Pos.s (TP),True Neg.s (TN),False Pos.s (FP),*False Neg.s* (FN),Positives (P),Negatives (N),Meas.Pos.s (MP),Meas.Neg.s (MN),Correct Meas.s (CM),Incorrect Meas.s (IM),Accuracy (ACC),Precision (PPV),Recall/Sensitivity (TPR),Specificity/Selectivity (TNR),Fallout (FPR),Miss Rate (FNR),F1 Score (F1)
0.0,2910,"[[887, 2023], [0, 0]]",887,0,2023,0,887,2023,2910,0,887,2023,0.3048109965635739,0.3048109965635739,1.0,0.0,1.0,0.0,0.4672109560179089
0.001,2910,"[[826, 1809], [61, 214]]",826,61,1809,61,887,2023,2635,275,1040,1870,0.35738831615120276,0.31347248576850095,0.9312288613303269,0.10578348986653485,0.8942165101334651,0.06877113866967305,0.4690516751845542
0.002,2910,"[[809, 1737], [78, 286]]",809,78,1737,78,887,2023,2546,364,1095,1815,0.37628865979381443,0.31775333857030635,0.9120631341600902,0.14137419673751853,0.8586258032624815,0.08793686583990981,0.4713078939702884
0.003,2910,"[[787, 1690], [100, 333]]",787,100,1690,100,887,2023,2477,433,1120,1790,0.3848797250859107,0.317723052079128,0.887260428410372,0.16460701927829954,0.8353929807217004,0.11273957158962795,0.4678953626634958
0.004,2910,"[[774, 1656], [113, 367]]",774,113,1656,113,887,2023,2430,480,1141,1769,0.3920962199312715,0.31851851851851853,0.8726042841037204,0.1814137419673752,0.8185862580326249,0.1273957158962796,0.46668676514923124
0.005,2910,"[[764, 1632], [123, 391]]",764,123,1632,123,887,2023,2396,514,1155,1755,0.39690721649484534,0.31886477462437396,0.8613303269447576,0.19327731092436976,0.8067226890756303,0.1386696730552424,0.4654279622296679
0.006,2910,"[[759, 1613], [128, 410]]",759,128,1613,128,887,2023,2372,538,1169,1741,0.40171821305841926,0.3199831365935919,0.8556933483652762,0.20266930301532377,0.7973306969846762,0.14430665163472378,0.4657870512427125
0.007,2910,"[[749, 1591], [138, 432]]",749,138,1591,138,887,2023,2340,570,1181,1729,0.40584192439862543,0.32008547008547006,0.8444193912063134,0.21354424122590213,0.7864557587740979,0.1555806087936866,0.4642082429501084
0.008,2910,"[[738, 1563], [149, 460]]",738,149,1563,149,887,2023,2301,609,1198,1712,0.41168384879725084,0.32073011734028684,0.8320180383314544,0.2273850716757291,0.7726149283242709,0.16798196166854565,0.4629861982434128
0.009,2910,"[[735, 1543], [152, 480]]",735,152,1543,152,887,2023,2278,632,1215,1695,0.4175257731958763,0.3226514486391572,0.8286358511837655,0.23727137913989124,0.7627286208601087,0.1713641488162345,0.4644549763033175
0.01,2910,"[[724, 1529], [163, 494]]",724,163,1529,163,887,2023,2253,657,1218,1692,0.41855670103092785,0.32134931202840655,0.8162344983089064,0.24419179436480473,0.7558082056351952,0.18376550169109357,0.4611464968152866
0.011,2910,"[[718, 1516], [169, 507]]",718,169,1516,169,887,2023,2234,676,1225,1685,0.4209621993127148,0.3213965980304387,0.8094701240135288,0.25061789421651015,0.7493821057834898,0.19052987598647125,0.4601089394424865
0.012,2910,"[[716, 1502], [171, 521]]",716,171,1502,171,887,2023,2218,692,1237,1673,0.42508591065292095,0.32281334535617673,0.8072153325817362,0.25753830944142364,0.7424616905585764,0.1927846674182638,0.4611916264090177
0.013,2910,"[[712, 1487], [175, 536]]",712,175,1487,175,887,2023,2199,711,1248,1662,0.4288659793814433,0.32378353797180537,0.8027057497181511,0.26495304003954523,0.7350469599604548,0.19729425028184894,0.4614387556707712
0.014,2910,"[[711, 1479], [176, 544]]",711,176,1479,176,887,2023,2190,720,1255,1655,0.43127147766323026,0.32465753424657534,0.8015783540022547,0.2689075630252101,0.7310924369747899,0.1984216459977452,0.4621384465388365
0.015,2910,"[[708, 1467], [179, 556]]",708,179,1467,179,887,2023,2175,735,1264,1646,0.4343642611683849,0.3255172413793103,0.798196166854566,0.27483934750370737,0.7251606524962926,0.20180383314543404,0.4624428478118876
0.016,2910,"[[707, 1457], [180, 566]]",707,180,1457,180,887,2023,2164,746,1273,1637,0.4374570446735395,0.3267097966728281,0.7970687711386697,0.2797825012357884,0.7202174987642116,0.20293122886133033,0.46345460504752545
0.017,2910,"[[703, 1443], [184, 580]]",703,184,1443,184,887,2023,2146,764,1283,1627,0.440893470790378,0.3275862068965517,0.7925591882750845,0.28670291646070195,0.7132970835392981,0.20744081172491544,0.4635674249917573
0.018,2910,"[[699, 1430], [188, 593]]",699,188,1430,188,887,2023,2129,781,1292,1618,0.4439862542955326,0.32832315641146076,0.7880496054114995,0.29312901631240734,0.7068709836875927,0.21195039458850057,0.4635278514588859
0.019,2910,"[[693, 1426], [194, 597]]",693,194,1426,194,887,2023,2119,791,1290,1620,0.44329896907216493,0.3270410571024068,0.7812852311161218,0.29510627780523974,0.7048937221947602,0.21871476888387825,0.4610778443113772
0.02,2910,"[[688, 1418], [199, 605]]",688,199,1418,199,887,2023,2106,804,1293,1617,0.44432989690721647,0.32668566001899335,0.7756482525366404,0.2990608007909046,0.7009391992090954,0.22435174746335965,0.4597393919144671
0.021,2910,"[[687, 1412], [200, 611]]",687,200,1412,200,887,2023,2099,811,1298,1612,0.44604810996563576,0.3272987136731777,0.7745208568207441,0.3020266930301532,0.6979733069698467,0.2254791431792559,0.46014735432016074
0.022,2910,"[[681, 1408], [206, 615]]",681,206,1408,206,887,2023,2089,821,1296,1614,0.44536082474226807,0.3259932982288176,0.7677564825253664,0.3040039545229857,0.6959960454770143,0.2322435174746336,0.4576612903225807
0.023,2910,"[[678, 1403], [209, 620]]",678,209,1403,209,887,2023,2081,829,1298,1612,0.44604810996563576,0.32580490148966845,0.7643742953776775,0.3064755313890262,0.6935244686109738,0.23562570462232243,0.4568733153638814
0.024,2910,"[[676, 1394], [211, 629]]",676,211,1394,211,887,2023,2070,840,1305,1605,0.4484536082474227,0.32657004830917874,0.762119503945885,0.31092436974789917,0.6890756302521008,0.237880496054115,0.45722015556307066
0.025,2910,"[[675, 1384], [212, 639]]",675,212,1384,212,887,2023,2059,851,1314,1596,0.4515463917525773,0.32782904322486645,0.7609921082299888,0.3158675234799802,0.6841324765200197,0.23900789177001128,0.4582484725050917
0.026,2910,"[[673, 1379], [214, 644]]",673,214,1379,214,887,2023,2052,858,1317,1593,0.45257731958762887,0.3279727095516569,0.7587373167981961,0.31833910034602075,0.6816608996539792,0.24126268320180383,0.45797890438924804
0.027,2910,"[[667, 1370], [220, 653]]",667,220,1370,220,887,2023,2037,873,1320,1590,0.4536082474226804,0.3274423171330388,0.7519729425028185,0.3227879387048937,0.6772120612951062,0.2480270574971815,0.4562243502051984
0.028,2910,"[[664, 1364], [223, 659]]",664,223,1364,223,887,2023,2028,882,1323,1587,0.45463917525773195,0.32741617357001973,0.7485907553551296,0.32575383094414234,0.6742461690558577,0.25140924464487036,0.45557461406518013
0.029,2910,"[[661, 1358], [226, 665]]",661,226,1358,226,887,2023,2019,891,1326,1584,0.4556701030927835,0.32738979692917286,0.7452085682074409,0.328719723183391,0.671280276816609,0.2547914317925592,0.45492085340674465
0.03,2910,"[[661, 1352], [226, 671]]",661,226,1352,226,887,2023,2013,897,1332,1578,0.4577319587628866,0.3283656234475907,0.7452085682074409,0.33168561542263963,0.6683143845773604,0.2547914317925592,0.4558620689655172
0.031,2910,"[[658, 1346], [229, 677]]",658,229,1346,229,887,2023,2004,906,1335,1575,0.4587628865979381,0.3283433133732535,0.741826381059752,0.3346515076618883,0.6653484923381117,0.25817361894024804,0.45520581113801456
0.032,2910,"[[657, 1344], [230, 679]]",657,230,1344,230,887,2023,2001,909,1336,1574,0.45910652920962197,0.328335832083958,0.7406989853438557,0.3356401384083045,0.6643598615916955,0.2593010146561443,0.4549861495844875
0.033,2910,"[[657, 1336], [230, 687]]",657,230,1336,230,887,2023,1993,917,1344,1566,0.4618556701030928,0.3296537882589062,0.7406989853438557,0.3395946613939694,0.6604053386060307,0.2593010146561443,0.45625000000000004
0.034,2910,"[[656, 1329], [231, 694]]",656,231,1329,231,887,2023,1985,925,1350,1560,0.4639175257731959,0.3304785894206549,0.7395715896279594,0.3430548690064261,0.6569451309935739,0.26042841037204056,0.4568245125348189
0.035,2910,"[[654, 1322], [233, 701]]",654,233,1322,233,887,2023,1976,934,1355,1555,0.46563573883161513,0.3309716599190283,0.7373167981961668,0.34651507661888287,0.6534849233811172,0.26268320180383314,0.4568634299685645
0.036,2910,"[[653, 1319], [234, 704]]",653,234,1319,234,887,2023,1972,938,1357,1553,0.4663230240549828,0.33113590263691683,0.7361894024802705,0.34799802273850716,0.6520019772614928,0.2638105975197294,0.4568030779993004
0.037,2910,"[[652, 1314], [235, 709]]",652,235,1314,235,887,2023,1966,944,1361,1549,0.4676975945017182,0.3316378433367243,0.7350620067643743,0.3504695996045477,0.6495304003954523,0.2649379932356257,0.45706274097441285
0.038,2910,"[[650, 1307], [237, 716]]",650,237,1307,237,887,2023,1957,953,1366,1544,0.46941580756013745,0.3321410321921308,0.7328072153325818,0.35392980721700446,0.6460701927829956,0.26719278466741825,0.45710267229254575
0.039,2910,"[[647, 1306], [240, 717]]",647,240,1306,240,887,2023,1953,957,1364,1546,0.46872852233676976,0.33128520225294417,0.7294250281848929,0.35442412259021255,0.6455758774097874,0.2705749718151071,0.45563380281690136
0.04,2910,"[[645, 1302], [242, 721]]",645,242,1302,242,887,2023,1947,963,1366,1544,0.46941580756013745,0.3312788906009245,0.7271702367531003,0.356401384083045,0.643598615916955,0.27282976324689967,0.45518701482004237
0.041,2910,"[[644, 1298], [243, 725]]",644,243,1298,243,887,2023,1942,968,1369,1541,0.470446735395189,0.33161688980432547,0.7260428410372041,0.3583786455758774,0.6416213544241226,0.27395715896279593,0.45528455284552843
0.042,2910,"[[642, 1292], [245, 731]]",642,245,1292,245,887,2023,1934,976,1373,1537,0.4718213058419244,0.33195449844881075,0.7237880496054115,0.36134453781512604,0.6386554621848739,0.2762119503945885,0.4551577454803261
0.043,2910,"[[637, 1288], [250, 735]]",637,250,1288,250,887,2023,1925,985,1372,1538,0.47147766323024054,0.33090909090909093,0.7181510710259301,0.3633217993079585,0.6366782006920415,0.2818489289740699,0.45305832147937414
0.044,2910,"[[637, 1284], [250, 739]]",637,250,1284,250,887,2023,1921,989,1376,1534,0.47285223367697593,0.33159812597605415,0.7181510710259301,0.3652990608007909,0.6347009391992091,0.2818489289740699,0.4537037037037037
0.045,2910,"[[635, 1283], [252, 740]]",635,252,1283,252,887,2023,1918,992,1375,1535,0.4725085910652921,0.3310740354535975,0.7158962795941376,0.365793376173999,0.634206623826001,0.28410372040586246,0.4527629233511587
0.046,2910,"[[632, 1279], [255, 744]]",632,255,1279,255,887,2023,1911,999,1376,1534,0.47285223367697593,0.33071690214547356,0.7125140924464487,0.36777063766683143,0.6322293623331685,0.2874859075535513,0.4517512508934953
0.047,2910,"[[629, 1274], [258, 749]]",629,258,1274,258,887,2023,1903,1007,1378,1532,0.4735395189003436,0.3305307409353652,0.7091319052987599,0.370242214532872,0.629757785467128,0.29086809470124014,0.45089605734767024
0.048,2910,"[[624, 1266], [263, 757]]",624,263,1266,263,887,2023,1890,1020,1381,1529,0.47457044673539517,0.33015873015873015,0.7034949267192785,0.3741967375185368,0.6258032624814631,0.2965050732807215,0.44940583363341735
0.049,2910,"[[624, 1264], [263, 759]]",624,263,1264,263,887,2023,1888,1022,1383,1527,0.47525773195876286,0.3305084745762712,0.7034949267192785,0.375185368264953,0.6248146317350469,0.2965050732807215,0.44972972972972974
0.05,2910,"[[624, 1261], [263, 762]]",624,263,1261,263,887,2023,1885,1025,1386,1524,0.4762886597938144,0.3310344827586207,0.7034949267192785,0.3766683143845774,0.6233316856154226,0.2965050732807215,0.45021645021645024
0.051,2910,"[[624, 1259], [263, 764]]",624,263,1259,263,887,2023,1883,1027,1388,1522,0.47697594501718216,0.3313860860329262,0.7034949267192785,0.37765694513099357,0.6223430548690064,0.2965050732807215,0.45054151624548744
0.052,2910,"[[620, 1259], [267, 764]]",620,267,1259,267,887,2023,1879,1031,1384,1526,0.4756013745704467,0.3299627461415647,0.6989853438556933,0.37765694513099357,0.6223430548690064,0.30101465614430667,0.4483007953723789
0.053,2910,"[[620, 1254], [267, 769]]",620,267,1254,267,887,2023,1874,1036,1389,1521,0.477319587628866,0.33084311632870866,0.6989853438556933,0.3801285219970341,0.6198714780029659,0.30101465614430667,0.44911264034770015
0.054,2910,"[[619, 1249], [268, 774]]",619,268,1249,268,887,2023,1868,1042,1393,1517,0.4786941580756014,0.33137044967880086,0.6978579481397971,0.38260009886307467,0.6173999011369253,0.30214205186020293,0.44936479128856627
0.055,2910,"[[619, 1246], [268, 777]]",619,268,1246,268,887,2023,1865,1045,1396,1514,0.47972508591065294,0.3319034852546917,0.6978579481397971,0.38408304498269896,0.615916955017301,0.30214205186020293,0.44985465116279066
0.056,2910,"[[617, 1244], [270, 779]]",617,270,1244,270,887,2023,1861,1049,1396,1514,0.47972508591065294,0.3315421816227834,0.6956031567080045,0.38507167572911516,0.6149283242708848,0.3043968432919955,0.44905385735080056
0.057,2910,"[[616, 1241], [271, 782]]",616,271,1241,271,887,2023,1857,1053,1398,1512,0.48041237113402063,0.33171782444803444,0.6944757609921083,0.3865546218487395,0.6134453781512605,0.3055242390078918,0.4489795918367347
0.058,2910,"[[614, 1239], [273, 784]]",614,273,1239,273,887,2023,1853,1057,1398,1512,0.48041237113402063,0.33135456017269294,0.6922209695603156,0.3875432525951557,0.6124567474048442,0.30777903043968435,0.44817518248175175
0.059,2910,"[[611, 1234], [276, 789]]",611,276,1234,276,887,2023,1845,1065,1400,1510,0.48109965635738833,0.3311653116531165,0.6888387824126269,0.39001482946119626,0.6099851705388037,0.3111612175873732,0.4472913616398243
0.06,2910,"[[610, 1232], [277, 791]]",610,277,1232,277,887,2023,1842,1068,1401,1509,0.4814432989690722,0.3311617806731813,0.6877113866967306,0.39100346020761245,0.6089965397923875,0.31228861330326946,0.4470502015390253
0.061,2910,"[[608, 1230], [279, 793]]",608,279,1230,279,887,2023,1838,1072,1401,1509,0.4814432989690722,0.3307943416757345,0.685456595264938,0.39199209095402865,0.6080079090459714,0.314543404735062,0.4462385321100918
0.062,2910,"[[608, 1228], [279, 795]]",608,279,1228,279,887,2023,1836,1074,1403,1507,0.48213058419243987,0.3311546840958606,0.685456595264938,0.3929807217004449,0.6070192782995552,0.314543404735062,0.4465662871832537
0.063,2910,"[[605, 1226], [282, 797]]",605,282,1226,282,887,2023,1831,1079,1402,1508,0.481786941580756,0.3304205352266521,0.6820744081172492,0.3939693524468611,0.606030647553139,0.3179255918827508,0.4451802796173657
0.064,2910,"[[604, 1224], [283, 799]]",604,283,1224,283,887,2023,1828,1082,1403,1507,0.48213058419243987,0.3304157549234136,0.6809470124013529,0.3949579831932773,0.6050420168067226,0.31905298759864714,0.4449355432780847
0.065,2910,"[[603, 1220], [284, 803]]",603,284,1220,284,887,2023,1823,1087,1406,1504,0.4831615120274914,0.33077345035655514,0.6798196166854565,0.39693524468610974,0.6030647553138903,0.3201803833145434,0.4450184501845019
0.066,2910,"[[602, 1216], [285, 807]]",602,285,1216,285,887,2023,1818,1092,1409,1501,0.48419243986254296,0.3311331133113311,0.6786922209695603,0.39891250617894214,0.6010874938210579,0.32130777903043967,0.4451016635859519
0.067,2910,"[[602, 1211], [285, 812]]",602,285,1211,285,887,2023,1813,1097,1414,1496,0.4859106529209622,0.33204633204633205,0.6786922209695603,0.4013840830449827,0.5986159169550173,0.32130777903043967,0.44592592592592595
0.068,2910,"[[602, 1209], [285, 814]]",602,285,1209,285,887,2023,1811,1099,1416,1494,0.4865979381443299,0.3324130314743236,0.6786922209695603,0.40237271379139894,0.5976272862086011,0.32130777903043967,0.44625648628613784
0.069,2910,"[[601, 1206], [286, 817]]",601,286,1206,286,887,2023,1807,1103,1418,1492,0.4872852233676976,0.33259546209186497,0.677564825253664,0.40385565991102323,0.5961443400889768,0.322435174746336,0.4461766889383815
0.07,2910,"[[598, 1205], [289, 818]]",598,289,1205,289,887,2023,1803,1107,1416,1494,0.4865979381443299,0.331669439822518,0.6741826381059752,0.40434997528423133,0.5956500247157687,0.3258173618940248,0.44460966542750935
0.071,2910,"[[595, 1202], [292, 821]]",595,292,1202,292,887,2023,1797,1113,1416,1494,0.4865979381443299,0.3311074012242627,0.6708004509582863,0.4058329214038557,0.5941670785961444,0.32919954904171367,0.4433681073025335
0.072,2910,"[[595, 1199], [292, 824]]",595,292,1199,292,887,2023,1794,1116,1419,1491,0.48762886597938143,0.33166109253065773,0.6708004509582863,0.40731586752348,0.59268413247652,0.32919954904171367,0.44386422976501305
0.073,2910,"[[594, 1195], [293, 828]]",594,293,1195,293,887,2023,1789,1121,1422,1488,0.488659793814433,0.3320290665176076,0.6696730552423901,0.40929312901631243,0.5907068709836876,0.33032694475760993,0.4439461883408072
0.074,2910,"[[594, 1192], [293, 831]]",594,293,1192,293,887,2023,1786,1124,1425,1485,0.4896907216494845,0.3325867861142217,0.6696730552423901,0.4107760751359367,0.5892239248640633,0.33032694475760993,0.4444444444444444
0.075,2910,"[[593, 1191], [294, 832]]",593,294,1191,294,887,2023,1784,1126,1425,1485,0.4896907216494845,0.33239910313901344,0.6685456595264938,0.4112703905091448,0.5887296094908552,0.3314543404735062,0.4440284537626357
0.076,2910,"[[591, 1188], [296, 835]]",591,296,1188,296,887,2023,1779,1131,1426,1484,0.49003436426116836,0.33220910623946037,0.6662908680947013,0.4127533366287692,0.5872466633712309,0.3337091319052988,0.44336084021005256
0.077,2910,"[[591, 1187], [296, 836]]",591,296,1187,296,887,2023,1778,1132,1427,1483,0.4903780068728522,0.3323959505061867,0.6662908680947013,0.4132476520019773,0.5867523479980228,0.3337091319052988,0.44352720450281424
0.078,2910,"[[590, 1186], [297, 837]]",590,297,1186,297,887,2023,1776,1134,1427,1483,0.4903780068728522,0.3322072072072072,0.6651634723788049,0.41374196737518537,0.5862580326248147,0.33483652762119503,0.44310927525347354
0.079,2910,"[[589, 1182], [298, 841]]",589,298,1182,298,887,2023,1771,1139,1430,1480,0.49140893470790376,0.33258046301524563,0.6640360766629086,0.4157192288680178,0.5842807711319822,0.3359639233370913,0.44319036869826933
0.08,2910,"[[588, 1179], [299, 844]]",588,299,1179,299,887,2023,1767,1143,1432,1478,0.49209621993127145,0.33276740237691,0.6629086809470124,0.4172021749876421,0.5827978250123579,0.3370913190529876,0.44310474755086654
0.081,2910,"[[585, 1177], [302, 846]]",585,302,1177,302,887,2023,1762,1148,1431,1479,0.4917525773195876,0.33200908059023837,0.6595264937993236,0.4181908057340583,0.5818091942659417,0.34047350620067646,0.4416761041902605
0.082,2910,"[[584, 1172], [303, 851]]",584,303,1172,303,887,2023,1756,1154,1435,1475,0.49312714776632305,0.3325740318906606,0.6583990980834273,0.42066238260009886,0.5793376173999011,0.3416009019165727,0.44192205826712067
0.083,2910,"[[582, 1169], [305, 854]]",582,305,1169,305,887,2023,1751,1159,1436,1474,0.4934707903780069,0.33238149628783553,0.6561443066516347,0.42214532871972316,0.5778546712802768,0.3438556933483653,0.44124336618650495
0.084,2910,"[[582, 1166], [305, 857]]",582,305,1166,305,887,2023,1748,1162,1439,1471,0.49450171821305844,0.3329519450800915,0.6561443066516347,0.4236282748393475,0.5763717251606525,0.3438556933483653,0.4417457305502846
0.085,2910,"[[581, 1162], [306, 861]]",581,306,1162,306,887,2023,1743,1167,1442,1468,0.49553264604811,0.3333333333333333,0.6550169109357384,0.42560553633217996,0.5743944636678201,0.34498308906426156,0.4418250950570342
0.086,2910,"[[580, 1161], [307, 862]]",580,307,1161,307,887,2023,1741,1169,1442,1468,0.49553264604811,0.3331418724870764,0.6538895152198422,0.42609985170538806,0.573900148294612,0.3461104847801578,0.441400304414003
0.087,2910,"[[579, 1158], [308, 865]]",579,308,1158,308,887,2023,1737,1173,1444,1466,0.4962199312714777,0.3333333333333333,0.6527621195039459,0.42758279782501235,0.5724172021749876,0.34723788049605414,0.44131097560975613
0.088,2910,"[[578, 1154], [309, 869]]",578,309,1154,309,887,2023,1732,1178,1447,1463,0.4972508591065292,0.33371824480369516,0.6516347237880497,0.4295600593178448,0.5704399406821552,0.3483652762119504,0.4413898434516992
0.089,2910,"[[577, 1152], [310, 871]]",577,310,1152,310,887,2023,1729,1181,1448,1462,0.49759450171821307,0.33371891266628106,0.6505073280721533,0.430548690064261,0.569451309935739,0.34949267192784667,0.44113149847094796
0.09,2910,"[[576, 1149], [311, 874]]",576,311,1149,311,887,2023,1725,1185,1450,1460,0.49828178694158076,0.3339130434782609,0.649379932356257,0.4320316361838853,0.5679683638161147,0.3506200676437429,0.44104134762634
0.091,2910,"[[576, 1147], [311, 876]]",576,311,1147,311,887,2023,1723,1187,1452,1458,0.49896907216494846,0.3343006384213581,0.649379932356257,0.43302026693030155,0.5669797330696985,0.3506200676437429,0.4413793103448276
0.092,2910,"[[576, 1145], [311, 878]]",576,311,1145,311,887,2023,1721,1189,1454,1456,0.49965635738831615,0.3346891342242882,0.649379932356257,0.43400889767671774,0.5659911023232822,0.3506200676437429,0.44171779141104295
0.093,2910,"[[573, 1144], [314, 879]]",573,314,1144,314,887,2023,1717,1193,1452,1458,0.49896907216494846,0.3337216074548631,0.6459977452085682,0.43450321304992584,0.5654967869500741,0.35400225479143177,0.4400921658986175
0.094,2910,"[[572, 1138], [315, 885]]",572,315,1138,315,887,2023,1710,1200,1457,1453,0.5006872852233677,0.3345029239766082,0.644870349492672,0.4374691052891745,0.5625308947108255,0.3551296505073281,0.4405082787832114
0.095,2910,"[[572, 1135], [315, 888]]",572,315,1135,315,887,2023,1707,1203,1460,1450,0.5017182130584192,0.3350908025776216,0.644870349492672,0.43895205140879884,0.5610479485912012,0.3551296505073281,0.441017733230532
0.096,2910,"[[571, 1135], [316, 888]]",571,316,1135,316,887,2023,1706,1204,1459,1451,0.5013745704467354,0.3347010550996483,0.6437429537767756,0.43895205140879884,0.5610479485912012,0.35625704622322435,0.4404165059776321
0.097,2910,"[[571, 1133], [316, 890]]",571,316,1133,316,887,2023,1704,1206,1461,1449,0.5020618556701031,0.335093896713615,0.6437429537767756,0.43994068215521503,0.560059317844785,0.35625704622322435,0.4407564646854496
0.098,2910,"[[571, 1133], [316, 890]]",571,316,1133,316,887,2023,1704,1206,1461,1449,0.5020618556701031,0.335093896713615,0.6437429537767756,0.43994068215521503,0.560059317844785,0.35625704622322435,0.4407564646854496
0.099,2910,"[[570, 1131], [317, 892]]",570,317,1131,317,887,2023,1701,1209,1462,1448,0.5024054982817869,0.3350970017636684,0.6426155580608793,0.44092931290163123,0.5590706870983687,0.3573844419391206,0.44049459041731065
0.1,2910,"[[570, 1129], [317, 894]]",570,317,1129,317,887,2023,1699,1211,1464,1446,0.5030927835051546,0.33549146556798115,0.6426155580608793,0.44191794364804743,0.5580820563519525,0.3573844419391206,0.44083526682134566
0.101,2910,"[[570, 1127], [317, 896]]",570,317,1127,317,887,2023,1697,1213,1466,1444,0.5037800687285223,0.33588685916322925,0.6426155580608793,0.4429065743944637,0.5570934256055363,0.3573844419391206,0.4411764705882353
0.102,2910,"[[569, 1126], [318, 897]]",569,318,1126,318,887,2023,1695,1215,1466,1444,0.5037800687285223,0.335693215339233,0.6414881623449831,0.4434008897676718,0.5565991102323282,0.35851183765501693,0.4407436096049574
0.103,2910,"[[568, 1125], [319, 898]]",568,319,1125,319,887,2023,1693,1217,1466,1444,0.5037800687285223,0.33549911399881865,0.6403607666290868,0.4438952051408799,0.5561047948591201,0.3596392333709132,0.4403100775193798
0.104,2910,"[[567, 1122], [320, 901]]",567,320,1122,320,887,2023,1689,1221,1468,1442,0.50446735395189,0.33570159857904086,0.6392333709131905,0.44537815126050423,0.5546218487394958,0.36076662908680945,0.44021739130434784
0.105,2910,"[[567, 1120], [320, 903]]",567,320,1120,320,887,2023,1687,1223,1470,1440,0.5051546391752577,0.3360995850622407,0.6392333709131905,0.4463667820069204,0.5536332179930796,0.36076662908680945,0.4405594405594406
0.106,2910,"[[567, 1114], [320, 909]]",567,320,1114,320,887,2023,1681,1229,1476,1434,0.5072164948453608,0.3372992266508031,0.6392333709131905,0.4493326742461691,0.5506673257538309,0.36076662908680945,0.441588785046729
0.107,2910,"[[567, 1113], [320, 910]]",567,320,1113,320,887,2023,1680,1230,1477,1433,0.5075601374570446,0.3375,0.6392333709131905,0.44982698961937717,0.5501730103806228,0.36076662908680945,0.44176081028437864
0.108,2910,"[[566, 1111], [321, 912]]",566,321,1111,321,887,2023,1677,1233,1478,1432,0.5079037800687285,0.3375074537865236,0.6381059751972943,0.45081562036579337,0.5491843796342066,0.36189402480270577,0.44149765990639633
0.109,2910,"[[565, 1110], [322, 913]]",565,322,1110,322,887,2023,1675,1235,1478,1432,0.5079037800687285,0.3373134328358209,0.636978579481398,0.45130993573900147,0.5486900642609985,0.36302142051860203,0.4410616705698673
0.11,2910,"[[563, 1110], [324, 913]]",563,324,1110,324,887,2023,1673,1237,1476,1434,0.5072164948453608,0.33652121936640766,0.6347237880496054,0.45130993573900147,0.5486900642609985,0.3652762119503946,0.43984375000000003
0.111,2910,"[[562, 1108], [325, 915]]",562,325,1108,325,887,2023,1670,1240,1477,1433,0.5075601374570446,0.33652694610778444,0.6335963923337091,0.4522985664854177,0.5477014335145823,0.3664036076662909,0.4395776300351975
0.112,2910,"[[561, 1106], [326, 917]]",561,326,1106,326,887,2023,1667,1243,1478,1432,0.5079037800687285,0.33653269346130776,0.6324689966178129,0.4532871972318339,0.5467128027681661,0.36753100338218714,0.43931088488645265
0.113,2910,"[[559, 1103], [328, 920]]",559,328,1103,328,887,2023,1662,1248,1479,1431,0.5082474226804123,0.33634175691937424,0.6302142051860203,0.4547701433514582,0.5452298566485417,0.3697857948139797,0.43860337387210674
0.114,2910,"[[559, 1102], [328, 921]]",559,328,1102,328,887,2023,1661,1249,1480,1430,0.5085910652920962,0.33654425045153524,0.6302142051860203,0.4552644587246663,0.5447355412753336,0.3697857948139797,0.4387755102040817
0.115,2910,"[[559, 1101], [328, 922]]",559,328,1101,328,887,2023,1660,1250,1481,1429,0.50893470790378,0.33674698795180724,0.6302142051860203,0.45575877409787446,0.5442412259021255,0.3697857948139797,0.4389477817039655
0.116,2910,"[[556, 1098], [331, 925]]",556,331,1098,331,887,2023,1654,1256,1481,1429,0.50893470790378,0.33615477629987905,0.6268320180383314,0.45724172021749876,0.5427582797825012,0.37316798196166856,0.4376229830775285
0.117,2910,"[[554, 1098], [333, 925]]",554,333,1098,333,887,2023,1652,1258,1479,1431,0.5082474226804123,0.3353510895883777,0.6245772266065389,0.45724172021749876,0.5427582797825012,0.3754227733934611,0.4363922804253644
0.118,2910,"[[553, 1097], [334, 926]]",553,334,1097,334,887,2023,1650,1260,1479,1431,0.5082474226804123,0.33515151515151514,0.6234498308906427,0.45773603559070686,0.5422639644092931,0.3765501691093574,0.4359479700433583
0.119,2910,"[[553, 1095], [334, 928]]",553,334,1095,334,887,2023,1648,1262,1481,1429,0.50893470790378,0.33555825242718446,0.6234498308906427,0.4587246663371231,0.541275333662877,0.3765501691093574,0.4362919132149901
0.12,2910,"[[553, 1092], [334, 931]]",553,334,1092,334,887,2023,1645,1265,1484,1426,0.5099656357388316,0.33617021276595743,0.6234498308906427,0.4602076124567474,0.5397923875432526,0.3765501691093574,0.43680884676145343
0.121,2910,"[[552, 1091], [335, 932]]",552,335,1091,335,887,2023,1643,1267,1484,1426,0.5099656357388316,0.3359707851491175,0.6223224351747464,0.4607019278299555,0.5392980721700444,0.37767756482525366,0.43636363636363634
0.122,2910,"[[551, 1087], [336, 936]]",551,336,1087,336,887,2023,1638,1272,1487,1423,0.5109965635738831,0.3363858363858364,0.62119503945885,0.46267918932278795,0.537320810677212,0.3788049605411499,0.43643564356435643
0.123,2910,"[[550, 1087], [337, 936]]",550,337,1087,337,887,2023,1637,1273,1486,1424,0.5106529209621993,0.3359804520464264,0.6200676437429538,0.46267918932278795,0.537320810677212,0.37993235625704624,0.4358161648177496
0.124,2910,"[[549, 1086], [338, 937]]",549,338,1086,338,887,2023,1635,1275,1486,1424,0.5106529209621993,0.3357798165137615,0.6189402480270575,0.46317350469599605,0.536826495304004,0.3810597519729425,0.4353687549563839
0.125,2910,"[[548, 1084], [339, 939]]",548,339,1084,339,887,2023,1632,1278,1487,1423,0.5109965635738831,0.33578431372549017,0.6178128523111612,0.46416213544241225,0.5358378645575878,0.38218714768883877,0.4350932909884875
0.126,2910,"[[546, 1082], [341, 941]]",546,341,1082,341,887,2023,1628,1282,1487,1423,0.5109965635738831,0.3353808353808354,0.6155580608793687,0.46515076618882845,0.5348492338111716,0.38444193912063135,0.43419483101391654
0.127,2910,"[[543, 1081], [344, 942]]",543,344,1081,344,887,2023,1624,1286,1485,1425,0.5103092783505154,0.33435960591133007,0.6121758737316798,0.4656450815620366,0.5343549184379635,0.3878241262683202,0.4324970131421744
0.128,2910,"[[543, 1080], [344, 943]]",543,344,1080,344,887,2023,1623,1287,1486,1424,0.5106529209621993,0.3345656192236599,0.6121758737316798,0.4661393969352447,0.5338606030647554,0.3878241262683202,0.43266932270916336
0.129,2910,"[[543, 1077], [344, 946]]",543,344,1077,344,887,2023,1620,1290,1489,1421,0.5116838487972508,0.3351851851851852,0.6121758737316798,0.467622343054869,0.532377656945131,0.3878241262683202,0.4331870761866773
0.13,2910,"[[543, 1077], [344, 946]]",543,344,1077,344,887,2023,1620,1290,1489,1421,0.5116838487972508,0.3351851851851852,0.6121758737316798,0.467622343054869,0.532377656945131,0.3878241262683202,0.4331870761866773
0.131,2910,"[[543, 1077], [344, 946]]",543,344,1077,344,887,2023,1620,1290,1489,1421,0.5116838487972508,0.3351851851851852,0.6121758737316798,0.467622343054869,0.532377656945131,0.3878241262683202,0.4331870761866773
0.132,2910,"[[541, 1074], [346, 949]]",541,346,1074,346,887,2023,1615,1295,1490,1420,0.5120274914089347,0.334984520123839,0.6099210822998873,0.46910528917449335,0.5308947108255067,0.3900789177001127,0.4324540367705835
0.133,2910,"[[539, 1072], [348, 951]]",539,348,1072,348,887,2023,1611,1299,1490,1420,0.5120274914089347,0.3345747982619491,0.6076662908680946,0.47009391992090954,0.5299060800790905,0.3923337091319053,0.43154523618895113
0.134,2910,"[[539, 1069], [348, 954]]",539,348,1069,348,887,2023,1608,1302,1493,1417,0.5130584192439862,0.3351990049751244,0.6076662908680946,0.47157686604053384,0.5284231339594662,0.3923337091319053,0.432064128256513
0.135,2910,"[[538, 1068], [349, 955]]",538,349,1068,349,887,2023,1606,1304,1493,1417,0.5130584192439862,0.33499377334993774,0.6065388951521984,0.472071181413742,0.5279288185862581,0.39346110484780156,0.43160850381066984
0.136,2910,"[[538, 1068], [349, 955]]",538,349,1068,349,887,2023,1606,1304,1493,1417,0.5130584192439862,0.33499377334993774,0.6065388951521984,0.472071181413742,0.5279288185862581,0.39346110484780156,0.43160850381066984
0.137,2910,"[[538, 1066], [349, 957]]",538,349,1066,349,887,2023,1604,1306,1495,1415,0.5137457044673539,0.33541147132169574,0.6065388951521984,0.4730598121601582,0.5269401878398419,0.39346110484780156,0.43195503813729424
0.138,2910,"[[538, 1064], [349, 959]]",538,349,1064,349,887,2023,1602,1308,1497,1413,0.5144329896907216,0.3358302122347066,0.6065388951521984,0.4740484429065744,0.5259515570934256,0.39346110484780156,0.4323021293692246
0.139,2910,"[[537, 1064], [350, 959]]",537,350,1064,350,887,2023,1601,1309,1496,1414,0.5140893470790378,0.3354153653966271,0.6054114994363021,0.4740484429065744,0.5259515570934256,0.3945885005636979,0.43167202572347263
0.14,2910,"[[537, 1062], [350, 961]]",537,350,1062,350,887,2023,1599,1311,1498,1412,0.5147766323024054,0.33583489681050654,0.6054114994363021,0.4750370736529906,0.5249629263470094,0.3945885005636979,0.43201930812550277
0.141,2910,"[[537, 1062], [350, 961]]",537,350,1062,350,887,2023,1599,1311,1498,1412,0.5147766323024054,0.33583489681050654,0.6054114994363021,0.4750370736529906,0.5249629263470094,0.3945885005636979,0.43201930812550277
0.142,2910,"[[537, 1060], [350, 963]]",537,350,1060,350,887,2023,1597,1313,1500,1410,0.5154639175257731,0.33625547902316844,0.6054114994363021,0.47602570439940683,0.5239742956005932,0.3945885005636979,0.4323671497584541
0.143,2910,"[[536, 1060], [351, 963]]",536,351,1060,351,887,2023,1596,1314,1499,1411,0.5151202749140893,0.3358395989974937,0.6042841037204059,0.47602570439940683,0.5239742956005932,0.39571589627959414,0.4317358034635521
0.144,2910,"[[536, 1058], [351, 965]]",536,351,1058,351,887,2023,1594,1316,1501,1409,0.5158075601374571,0.33626097867001253,0.6042841037204059,0.47701433514582303,0.522985664854177,0.39571589627959414,0.4320838371624345
0.145,2910,"[[534, 1058], [353, 965]]",534,353,1058,353,887,2023,1592,1318,1499,1411,0.5151202749140893,0.33542713567839194,0.6020293122886133,0.47701433514582303,0.522985664854177,0.3979706877113867,0.43081887858007256
0.146,2910,"[[534, 1058], [353, 965]]",534,353,1058,353,887,2023,1592,1318,1499,1411,0.5151202749140893,0.33542713567839194,0.6020293122886133,0.47701433514582303,0.522985664854177,0.3979706877113867,0.43081887858007256
0.147,2910,"[[534, 1053], [353, 970]]",534,353,1053,353,887,2023,1587,1323,1504,1406,0.5168384879725086,0.33648393194706994,0.6020293122886133,0.4794859120118636,0.5205140879881365,0.3979706877113867,0.43168957154405824
0.148,2910,"[[534, 1051], [353, 972]]",534,353,1051,353,887,2023,1585,1325,1506,1404,0.5175257731958763,0.33690851735015775,0.6020293122886133,0.4804745427582798,0.5195254572417202,0.3979706877113867,0.4320388349514563
0.149,2910,"[[534, 1049], [353, 974]]",534,353,1049,353,887,2023,1583,1327,1508,1402,0.518213058419244,0.33733417561591916,0.6020293122886133,0.481463173504696,0.518536826495304,0.3979706877113867,0.4323886639676114
0.15,2910,"[[533, 1048], [354, 975]]",533,354,1048,354,887,2023,1581,1329,1508,1402,0.518213058419244,0.3371283997469956,0.6009019165727171,0.4819574888779041,0.5180425111220959,0.399098083427283,0.4319286871961102
0.151,2910,"[[530, 1046], [357, 977]]",530,357,1046,357,887,2023,1576,1334,1507,1403,0.5178694158075602,0.3362944162436548,0.5975197294250282,0.4829461196243203,0.5170538803756797,0.4024802705749718,0.4303694681282988
0.152,2910,"[[529, 1045], [358, 978]]",529,358,1045,358,887,2023,1574,1336,1507,1403,0.5178694158075602,0.3360864040660737,0.5963923337091319,0.4834404349975284,0.5165595650024716,0.4036076662908681,0.42990654205607476
0.153,2910,"[[528, 1044], [359, 979]]",528,359,1044,359,887,2023,1572,1338,1507,1403,0.5178694158075602,0.33587786259541985,0.5952649379932357,0.4839347503707365,0.5160652496292635,0.4047350620067644,0.42944286295241973
0.154,2910,"[[528, 1043], [359, 980]]",528,359,1043,359,887,2023,1571,1339,1508,1402,0.518213058419244,0.3360916613621897,0.5952649379932357,0.4844290657439446,0.5155709342560554,0.4047350620067644,0.42961757526444266
0.155,2910,"[[526, 1041], [361, 982]]",526,361,1041,361,887,2023,1567,1343,1508,1402,0.518213058419244,0.3356732610082961,0.593010146561443,0.4854176964903609,0.5145823035096392,0.4069898534385569,0.4286878565607172
0.156,2910,"[[526, 1041], [361, 982]]",526,361,1041,361,887,2023,1567,1343,1508,1402,0.518213058419244,0.3356732610082961,0.593010146561443,0.4854176964903609,0.5145823035096392,0.4069898534385569,0.4286878565607172
0.157,2910,"[[526, 1039], [361, 984]]",526,361,1039,361,887,2023,1565,1345,1510,1400,0.5189003436426117,0.33610223642172526,0.593010146561443,0.48640632723677707,0.513593672763223,0.4069898534385569,0.42903752039151716
0.158,2910,"[[525, 1038], [362, 985]]",525,362,1038,362,887,2023,1563,1347,1510,1400,0.5189003436426117,0.33589251439539347,0.5918827508455468,0.48690064260998517,0.5130993573900148,0.4081172491544532,0.42857142857142855
0.159,2910,"[[525, 1038], [362, 985]]",525,362,1038,362,887,2023,1563,1347,1510,1400,0.5189003436426117,0.33589251439539347,0.5918827508455468,0.48690064260998517,0.5130993573900148,0.4081172491544532,0.42857142857142855
0.16,2910,"[[524, 1037], [363, 986]]",524,363,1037,363,887,2023,1561,1349,1510,1400,0.5189003436426117,0.33568225496476617,0.5907553551296505,0.48739495798319327,0.5126050420168067,0.4092446448703495,0.42810457516339867
0.161,2910,"[[522, 1036], [365, 987]]",522,365,1036,365,887,2023,1558,1352,1509,1401,0.5185567010309279,0.33504492939666236,0.588500563697858,0.48788927335640137,0.5121107266435986,0.41149943630214203,0.4269938650306748
0.162,2910,"[[522, 1035], [365, 988]]",522,365,1035,365,887,2023,1557,1353,1510,1400,0.5189003436426117,0.3352601156069364,0.588500563697858,0.48838358872960946,0.5116164112703905,0.41149943630214203,0.42716857610474634
0.163,2910,"[[522, 1033], [365, 990]]",522,365,1033,365,887,2023,1555,1355,1512,1398,0.5195876288659794,0.3356913183279743,0.588500563697858,0.4893722194760257,0.5106277805239743,0.41149943630214203,0.42751842751842756
0.164,2910,"[[520, 1030], [367, 993]]",520,367,1030,367,887,2023,1550,1360,1513,1397,0.5199312714776633,0.33548387096774196,0.5862457722660653,0.49085516559565,0.50914483440435,0.4137542277339346,0.4267542059909725
0.165,2910,"[[520, 1026], [367, 997]]",520,367,1026,367,887,2023,1546,1364,1517,1393,0.5213058419243987,0.33635187580853815,0.5862457722660653,0.49283242708848246,0.5071675729115176,0.4137542277339346,0.42745581586518705
0.166,2910,"[[520, 1024], [367, 999]]",520,367,1024,367,887,2023,1544,1366,1519,1391,0.5219931271477664,0.33678756476683935,0.5862457722660653,0.49382105783489866,0.5061789421651013,0.4137542277339346,0.427807486631016
0.167,2910,"[[520, 1022], [367, 1001]]",520,367,1022,367,887,2023,1542,1368,1521,1389,0.522680412371134,0.33722438391699094,0.5862457722660653,0.49480968858131485,0.5051903114186851,0.4137542277339346,0.4281597365170852
0.168,2910,"[[519, 1020], [368, 1003]]",519,368,1020,368,887,2023,1539,1371,1522,1388,0.5230240549828179,0.33723196881091616,0.5851183765501691,0.4957983193277311,0.5042016806722689,0.41488162344983087,0.4278647980214344
0.169,2910,"[[518, 1019], [369, 1004]]",518,369,1019,369,887,2023,1537,1373,1522,1388,0.5230240549828179,0.33702016916070265,0.5839909808342728,0.4962926347009392,0.5037073652990608,0.4160090191657272,0.4273927392739274
0.17,2910,"[[517, 1019], [370, 1004]]",517,370,1019,370,887,2023,1536,1374,1521,1389,0.522680412371134,0.3365885416666667,0.5828635851183765,0.4962926347009392,0.5037073652990608,0.41713641488162345,0.4267437061494016
0.171,2910,"[[517, 1018], [370, 1005]]",517,370,1018,370,887,2023,1535,1375,1522,1388,0.5230240549828179,0.33680781758957656,0.5828635851183765,0.4967869500741473,0.5032130499258527,0.41713641488162345,0.42691990090834026
0.172,2910,"[[517, 1018], [370, 1005]]",517,370,1018,370,887,2023,1535,1375,1522,1388,0.5230240549828179,0.33680781758957656,0.5828635851183765,0.4967869500741473,0.5032130499258527,0.41713641488162345,0.42691990090834026
0.173,2910,"[[517, 1017], [370, 1006]]",517,370,1017,370,887,2023,1534,1376,1523,1387,0.5233676975945017,0.33702737940026073,0.5828635851183765,0.4972812654473554,0.5027187345526446,0.41713641488162345,0.42709624122263523
0.174,2910,"[[517, 1017], [370, 1006]]",517,370,1017,370,887,2023,1534,1376,1523,1387,0.5233676975945017,0.33702737940026073,0.5828635851183765,0.4972812654473554,0.5027187345526446,0.41713641488162345,0.42709624122263523
0.175,2910,"[[517, 1014], [370, 1009]]",517,370,1014,370,887,2023,1531,1379,1526,1384,0.5243986254295533,0.33768778576094055,0.5828635851183765,0.49876421156697975,0.5012357884330203,0.41713641488162345,0.42762613730355664
0.176,2910,"[[516, 1013], [371, 1010]]",516,371,1013,371,887,2023,1529,1381,1526,1384,0.5243986254295533,0.33747547416612167,0.5817361894024803,0.49925852694018785,0.5007414730598122,0.4182638105975197,0.4271523178807947
0.177,2910,"[[516, 1012], [371, 1011]]",516,371,1012,371,887,2023,1528,1382,1527,1383,0.5247422680412371,0.337696335078534,0.5817361894024803,0.49975284231339595,0.5002471576866041,0.4182638105975197,0.42732919254658386
0.178,2910,"[[516, 1009], [371, 1014]]",516,371,1009,371,887,2023,1525,1385,1530,1380,0.5257731958762887,0.3383606557377049,0.5817361894024803,0.5012357884330203,0.49876421156697975,0.4182638105975197,0.42786069651741293
0.179,2910,"[[515, 1008], [372, 1015]]",515,372,1008,372,887,2023,1523,1387,1530,1380,0.5257731958762887,0.3381483913328956,0.580608793686584,0.5017301038062284,0.4982698961937716,0.41939120631341603,0.4273858921161826
0.18,2910,"[[514, 1008], [373, 1015]]",514,373,1008,373,887,2023,1522,1388,1529,1381,0.5254295532646048,0.33771353482260186,0.5794813979706878,0.5017301038062284,0.4982698961937716,0.4205186020293123,0.4267330842673309
0.181,2910,"[[514, 1006], [373, 1017]]",514,373,1006,373,887,2023,1520,1390,1531,1379,0.5261168384879725,0.3381578947368421,0.5794813979706878,0.5027187345526446,0.4972812654473554,0.4205186020293123,0.42708766098878276
0.182,2910,"[[513, 1006], [374, 1017]]",513,374,1006,374,887,2023,1519,1391,1530,1380,0.5257731958762887,0.3377221856484529,0.5783540022547914,0.5027187345526446,0.4972812654473554,0.42164599774520856,0.42643391521197005
0.183,2910,"[[513, 1006], [374, 1017]]",513,374,1006,374,887,2023,1519,1391,1530,1380,0.5257731958762887,0.3377221856484529,0.5783540022547914,0.5027187345526446,0.4972812654473554,0.42164599774520856,0.42643391521197005
0.184,2910,"[[512, 1005], [375, 1018]]",512,375,1005,375,887,2023,1517,1393,1530,1380,0.5257731958762887,0.3375082399472643,0.5772266065388951,0.5032130499258527,0.4967869500741473,0.4227733934611049,0.4259567387687188
0.185,2910,"[[511, 1004], [376, 1019]]",511,376,1004,376,887,2023,1515,1395,1530,1380,0.5257731958762887,0.3372937293729373,0.5760992108229989,0.5037073652990608,0.4962926347009392,0.42390078917700114,0.4254787676935886
0.186,2910,"[[511, 1004], [376, 1019]]",511,376,1004,376,887,2023,1515,1395,1530,1380,0.5257731958762887,0.3372937293729373,0.5760992108229989,0.5037073652990608,0.4962926347009392,0.42390078917700114,0.4254787676935886
0.187,2910,"[[511, 1003], [376, 1020]]",511,376,1003,376,887,2023,1514,1396,1531,1379,0.5261168384879725,0.33751651254953763,0.5760992108229989,0.5042016806722689,0.4957983193277311,0.42390078917700114,0.4256559766763848
0.188,2910,"[[510, 1000], [377, 1023]]",510,377,1000,377,887,2023,1510,1400,1533,1377,0.5268041237113402,0.33774834437086093,0.5749718151071026,0.5056846267918932,0.49431537320810676,0.4250281848928974,0.4255319148936171
0.189,2910,"[[508, 999], [379, 1024]]",508,379,999,379,887,2023,1507,1403,1532,1378,0.5264604810996564,0.33709356337093566,0.5727170236753101,0.5061789421651013,0.49382105783489866,0.42728297632469,0.42439431913116127
0.19,2910,"[[508, 996], [379, 1027]]",508,379,996,379,887,2023,1504,1406,1535,1375,0.5274914089347079,0.3377659574468085,0.5727170236753101,0.5076618882847257,0.49233811171527436,0.42728297632469,0.424926808866583
0.191,2910,"[[508, 993], [379, 1030]]",508,379,993,379,887,2023,1501,1409,1538,1372,0.5285223367697595,0.3384410393071286,0.5727170236753101,0.50914483440435,0.49085516559565,0.42728297632469,0.4254606365159129
0.192,2910,"[[508, 992], [379, 1031]]",508,379,992,379,887,2023,1500,1410,1539,1371,0.5288659793814433,0.33866666666666667,0.5727170236753101,0.5096391497775581,0.4903608502224419,0.42728297632469,0.42563887725178046
0.193,2910,"[[507, 990], [380, 1033]]",507,380,990,380,887,2023,1497,1413,1540,1370,0.5292096219931272,0.33867735470941884,0.5715896279594137,0.5106277805239743,0.4893722194760257,0.42841037204058624,0.42533557046979864
0.194,2910,"[[507, 989], [380, 1034]]",507,380,989,380,887,2023,1496,1414,1541,1369,0.529553264604811,0.33890374331550804,0.5715896279594137,0.5111220958971824,0.4888779041028176,0.42841037204058624,0.4255140579101973
0.195,2910,"[[507, 987], [380, 1036]]",507,380,987,380,887,2023,1494,1416,1543,1367,0.5302405498281787,0.3393574297188755,0.5715896279594137,0.5121107266435986,0.48788927335640137,0.42841037204058624,0.42587148257034857
0.196,2910,"[[507, 986], [380, 1037]]",507,380,986,380,887,2023,1493,1417,1544,1366,0.5305841924398625,0.33958472873409246,0.5715896279594137,0.5126050420168067,0.48739495798319327,0.42841037204058624,0.4260504201680672
0.197,2910,"[[506, 984], [381, 1039]]",506,381,984,381,887,2023,1490,1420,1545,1365,0.5309278350515464,0.3395973154362416,0.5704622322435174,0.513593672763223,0.48640632723677707,0.4295377677564825,0.4257467395877156
0.198,2910,"[[506, 984], [381, 1039]]",506,381,984,381,887,2023,1490,1420,1545,1365,0.5309278350515464,0.3395973154362416,0.5704622322435174,0.513593672763223,0.48640632723677707,0.4295377677564825,0.4257467395877156
0.199,2910,"[[506, 983], [381, 1040]]",506,381,983,381,887,2023,1489,1421,1546,1364,0.5312714776632302,0.3398253861652116,0.5704622322435174,0.5140879881364311,0.48591201186356897,0.4295377677564825,0.42592592592592593
0.2,2910,"[[506, 983], [381, 1040]]",506,381,983,381,887,2023,1489,1421,1546,1364,0.5312714776632302,0.3398253861652116,0.5704622322435174,0.5140879881364311,0.48591201186356897,0.4295377677564825,0.42592592592592593
0.201,2910,"[[505, 982], [382, 1041]]",505,382,982,382,887,2023,1487,1423,1546,1364,0.5312714776632302,0.33960995292535306,0.5693348365276212,0.5145823035096392,0.4854176964903609,0.4306651634723788,0.42544229149115415
0.202,2910,"[[505, 979], [382, 1044]]",505,382,979,382,887,2023,1484,1426,1549,1361,0.5323024054982818,0.34029649595687333,0.5693348365276212,0.5160652496292635,0.4839347503707365,0.4306651634723788,0.42598059890341633
0.203,2910,"[[505, 976], [382, 1047]]",505,382,976,382,887,2023,1481,1429,1552,1358,0.5333333333333333,0.3409858203916273,0.5693348365276212,0.5175481957488878,0.4824518042511122,0.4306651634723788,0.4265202702702703
0.204,2910,"[[503, 976], [384, 1047]]",503,384,976,384,887,2023,1479,1431,1550,1360,0.5326460481099656,0.3400946585530764,0.5670800450958287,0.5175481957488878,0.4824518042511122,0.43291995490417134,0.4251901944209637
0.205,2910,"[[502, 976], [385, 1047]]",502,385,976,385,887,2023,1478,1432,1549,1361,0.5323024054982818,0.33964817320703655,0.5659526493799324,0.5175481957488878,0.4824518042511122,0.43404735062006766,0.4245243128964059
0.206,2910,"[[502, 974], [385, 1049]]",502,385,974,385,887,2023,1476,1434,1551,1359,0.5329896907216495,0.34010840108401086,0.5659526493799324,0.518536826495304,0.481463173504696,0.43404735062006766,0.4248836225137538
0.207,2910,"[[502, 974], [385, 1049]]",502,385,974,385,887,2023,1476,1434,1551,1359,0.5329896907216495,0.34010840108401086,0.5659526493799324,0.518536826495304,0.481463173504696,0.43404735062006766,0.4248836225137538
0.208,2910,"[[501, 972], [386, 1051]]",501,386,972,386,887,2023,1473,1437,1552,1358,0.5333333333333333,0.34012219959266804,0.5648252536640361,0.5195254572417202,0.4804745427582798,0.4351747463359639,0.42457627118644076
0.209,2910,"[[500, 972], [387, 1051]]",500,387,972,387,887,2023,1472,1438,1551,1359,0.5329896907216495,0.33967391304347827,0.5636978579481398,0.5195254572417202,0.4804745427582798,0.4363021420518602,0.42390843577787196
0.21,2910,"[[500, 972], [387, 1051]]",500,387,972,387,887,2023,1472,1438,1551,1359,0.5329896907216495,0.33967391304347827,0.5636978579481398,0.5195254572417202,0.4804745427582798,0.4363021420518602,0.42390843577787196
0.211,2910,"[[496, 970], [391, 1053]]",496,391,970,391,887,2023,1466,1444,1549,1361,0.5323024054982818,0.3383356070941337,0.5591882750845547,0.5205140879881365,0.4794859120118636,0.44081172491544535,0.4215894602634934
0.212,2910,"[[496, 968], [391, 1055]]",496,391,968,391,887,2023,1464,1446,1551,1359,0.5329896907216495,0.33879781420765026,0.5591882750845547,0.5215027187345527,0.4784972812654474,0.44081172491544535,0.42194810718843045
0.213,2910,"[[496, 968], [391, 1055]]",496,391,968,391,887,2023,1464,1446,1551,1359,0.5329896907216495,0.33879781420765026,0.5591882750845547,0.5215027187345527,0.4784972812654474,0.44081172491544535,0.42194810718843045
0.214,2910,"[[496, 966], [391, 1057]]",496,391,966,391,887,2023,1462,1448,1553,1357,0.5336769759450172,0.3392612859097127,0.5591882750845547,0.5224913494809689,0.47750865051903113,0.44081172491544535,0.4223073648361005
0.215,2910,"[[495, 966], [392, 1057]]",495,392,966,392,887,2023,1461,1449,1552,1358,0.5333333333333333,0.33880903490759756,0.5580608793686584,0.5224913494809689,0.47750865051903113,0.4419391206313416,0.4216354344122658
0.216,2910,"[[495, 964], [392, 1059]]",495,392,964,392,887,2023,1459,1451,1554,1356,0.534020618556701,0.339273474982865,0.5580608793686584,0.5234799802273851,0.47652001977261493,0.4419391206313416,0.421994884910486
0.217,2910,"[[494, 963], [393, 1060]]",494,393,963,393,887,2023,1457,1453,1554,1356,0.534020618556701,0.3390528483184626,0.5569334836527621,0.5239742956005932,0.47602570439940683,0.44306651634723787,0.42150170648464164
0.218,2910,"[[492, 962], [395, 1061]]",492,395,962,395,887,2023,1454,1456,1553,1357,0.5336769759450172,0.33837689133425036,0.5546786922209695,0.5244686109738013,0.47553138902619874,0.44532130777903045,0.42033319094404104
0.219,2910,"[[492, 961], [395, 1062]]",492,395,961,395,887,2023,1453,1457,1554,1356,0.534020618556701,0.33860977288368893,0.5546786922209695,0.5249629263470094,0.4750370736529906,0.44532130777903045,0.4205128205128205
0.22,2910,"[[492, 960], [395, 1063]]",492,395,960,395,887,2023,1452,1458,1555,1355,0.5343642611683849,0.33884297520661155,0.5546786922209695,0.5254572417202175,0.4745427582797825,0.44532130777903045,0.42069260367678496
0.221,2910,"[[492, 959], [395, 1064]]",492,395,959,395,887,2023,1451,1459,1556,1354,0.5347079037800687,0.3390764989662302,0.5546786922209695,0.5259515570934256,0.4740484429065744,0.44532130777903045,0.4208725406330197
0.222,2910,"[[492, 958], [395, 1065]]",492,395,958,395,887,2023,1450,1460,1557,1353,0.5350515463917526,0.3393103448275862,0.5546786922209695,0.5264458724666337,0.4735541275333663,0.44532130777903045,0.42105263157894735
0.223,2910,"[[491, 957], [396, 1066]]",491,396,957,396,887,2023,1448,1462,1557,1353,0.5350515463917526,0.33908839779005523,0.5535512965050733,0.5269401878398419,0.4730598121601582,0.4464487034949267,0.42055674518201286
0.224,2910,"[[491, 957], [396, 1066]]",491,396,957,396,887,2023,1448,1462,1557,1353,0.5350515463917526,0.33908839779005523,0.5535512965050733,0.5269401878398419,0.4730598121601582,0.4464487034949267,0.42055674518201286
0.225,2910,"[[491, 957], [396, 1066]]",491,396,957,396,887,2023,1448,1462,1557,1353,0.5350515463917526,0.33908839779005523,0.5535512965050733,0.5269401878398419,0.4730598121601582,0.4464487034949267,0.42055674518201286
0.226,2910,"[[489, 957], [398, 1066]]",489,398,957,398,887,2023,1446,1464,1555,1355,0.5343642611683849,0.3381742738589212,0.5512965050732808,0.5269401878398419,0.4730598121601582,0.4487034949267193,0.4192027432490356
0.227,2910,"[[488, 956], [399, 1067]]",488,399,956,399,887,2023,1444,1466,1555,1355,0.5343642611683849,0.3379501385041551,0.5501691093573844,0.52743450321305,0.4725654967869501,0.44983089064261556,0.4187044187044187
0.228,2910,"[[486, 956], [401, 1067]]",486,401,956,401,887,2023,1442,1468,1553,1357,0.5336769759450172,0.33703190013869627,0.5479143179255919,0.52743450321305,0.4725654967869501,0.45208568207440814,0.4173465006440532
0.229,2910,"[[485, 956], [402, 1067]]",485,402,956,402,887,2023,1441,1469,1552,1358,0.5333333333333333,0.33657182512144346,0.5467869222096956,0.52743450321305,0.4725654967869501,0.4532130777903044,0.4166666666666667
0.23,2910,"[[484, 956], [403, 1067]]",484,403,956,403,887,2023,1440,1470,1551,1359,0.5329896907216495,0.33611111111111114,0.5456595264937993,0.52743450321305,0.4725654967869501,0.45434047350620066,0.415986248388483
0.231,2910,"[[483, 956], [404, 1067]]",483,404,956,404,887,2023,1439,1471,1550,1360,0.5326460481099656,0.33564975677553854,0.5445321307779031,0.52743450321305,0.4725654967869501,0.455467869222097,0.41530524505588995
0.232,2910,"[[482, 956], [405, 1067]]",482,405,956,405,887,2023,1438,1472,1549,1361,0.5323024054982818,0.33518776077885953,0.5434047350620068,0.52743450321305,0.4725654967869501,0.45659526493799324,0.41462365591397854
0.233,2910,"[[482, 956], [405, 1067]]",482,405,956,405,887,2023,1438,1472,1549,1361,0.5323024054982818,0.33518776077885953,0.5434047350620068,0.52743450321305,0.4725654967869501,0.45659526493799324,0.41462365591397854
0.234,2910,"[[481, 956], [406, 1067]]",481,406,956,406,887,2023,1437,1473,1548,1362,0.5319587628865979,0.3347251217814892,0.5422773393461104,0.52743450321305,0.4725654967869501,0.4577226606538895,0.4139414802065404
0.235,2910,"[[479, 954], [408, 1069]]",479,408,954,408,887,2023,1433,1477,1548,1362,0.5319587628865979,0.3342637822749477,0.5400225479143179,0.5284231339594662,0.47157686604053384,0.4599774520856821,0.41293103448275864
0.236,2910,"[[479, 953], [408, 1070]]",479,408,953,408,887,2023,1432,1478,1549,1361,0.5323024054982818,0.3344972067039106,0.5400225479143179,0.5289174493326743,0.47108255066732574,0.4599774520856821,0.41310909874946095
0.237,2910,"[[478, 952], [409, 1071]]",478,409,952,409,887,2023,1430,1480,1549,1361,0.5323024054982818,0.33426573426573425,0.5388951521984217,0.5294117647058824,0.47058823529411764,0.46110484780157834,0.4126025032369443
0.238,2910,"[[478, 951], [409, 1072]]",478,409,951,409,887,2023,1429,1481,1550,1360,0.5326460481099656,0.3344996501049685,0.5388951521984217,0.5299060800790905,0.47009391992090954,0.46110484780157834,0.41278065630397237
0.239,2910,"[[477, 951], [410, 1072]]",477,410,951,410,887,2023,1428,1482,1549,1361,0.5323024054982818,0.33403361344537813,0.5377677564825254,0.5299060800790905,0.47009391992090954,0.46223224351747466,0.4120950323974082
0.24,2910,"[[475, 951], [412, 1072]]",475,412,951,412,887,2023,1426,1484,1547,1363,0.5316151202749141,0.3330995792426367,0.5355129650507328,0.5299060800790905,0.47009391992090954,0.4644870349492672,0.41072200605274534
0.241,2910,"[[474, 950], [413, 1073]]",474,413,950,413,887,2023,1424,1486,1547,1363,0.5316151202749141,0.33286516853932585,0.5343855693348365,0.5304003954522986,0.46959960454770144,0.46561443066516345,0.4102120294244916
0.242,2910,"[[474, 949], [413, 1074]]",474,413,949,413,887,2023,1423,1487,1548,1362,0.5319587628865979,0.33309908643710473,0.5343855693348365,0.5308947108255067,0.46910528917449335,0.46561443066516345,0.4103896103896104
0.243,2910,"[[473, 949], [414, 1074]]",473,414,949,414,887,2023,1422,1488,1547,1363,0.5316151202749141,0.33263009845288327,0.5332581736189402,0.5308947108255067,0.46910528917449335,0.46674182638105977,0.4097011693373755
0.244,2910,"[[471, 948], [416, 1075]]",471,416,948,416,887,2023,1419,1491,1546,1364,0.5312714776632302,0.33192389006342493,0.5310033821871477,0.5313890261987148,0.46861097380128525,0.4689966178128523,0.4084995663486557
0.245,2910,"[[471, 948], [416, 1075]]",471,416,948,416,887,2023,1419,1491,1546,1364,0.5312714776632302,0.33192389006342493,0.5310033821871477,0.5313890261987148,0.46861097380128525,0.4689966178128523,0.4084995663486557
0.246,2910,"[[471, 945], [416, 1078]]",471,416,945,416,887,2023,1416,1494,1549,1361,0.5323024054982818,0.3326271186440678,0.5310033821871477,0.532871972318339,0.4671280276816609,0.4689966178128523,0.4090316977854972
0.247,2910,"[[471, 945], [416, 1078]]",471,416,945,416,887,2023,1416,1494,1549,1361,0.5323024054982818,0.3326271186440678,0.5310033821871477,0.532871972318339,0.4671280276816609,0.4689966178128523,0.4090316977854972
0.248,2910,"[[471, 943], [416, 1080]]",471,416,943,416,887,2023,1414,1496,1551,1359,0.5329896907216495,0.3330975954738331,0.5310033821871477,0.5338606030647554,0.4661393969352447,0.4689966178128523,0.409387222946545
0.249,2910,"[[471, 941], [416, 1082]]",471,416,941,416,887,2023,1412,1498,1553,1357,0.5336769759450172,0.3335694050991501,0.5310033821871477,0.5348492338111716,0.46515076618882845,0.4689966178128523,0.4097433666811657
0.25,2910,"[[470, 941], [417, 1082]]",470,417,941,417,887,2023,1411,1499,1552,1358,0.5333333333333333,0.3330970942593905,0.5298759864712514,0.5348492338111716,0.46515076618882845,0.4701240135287486,0.40905134899912965
0.251,2910,"[[470, 940], [417, 1083]]",470,417,940,417,887,2023,1410,1500,1553,1357,0.5336769759450172,0.3333333333333333,0.5298759864712514,0.5353435491843797,0.46465645081562035,0.4701240135287486,0.4092294296909012
0.252,2910,"[[469, 940], [418, 1083]]",469,418,940,418,887,2023,1409,1501,1552,1358,0.5333333333333333,0.33286018452803406,0.5287485907553551,0.5353435491843797,0.46465645081562035,0.47125140924464487,0.40853658536585363
0.253,2910,"[[469, 939], [418, 1084]]",469,418,939,418,887,2023,1408,1502,1553,1357,0.5336769759450172,0.3330965909090909,0.5287485907553551,0.5358378645575878,0.46416213544241225,0.47125140924464487,0.4087145969498911
0.254,2910,"[[468, 937], [419, 1086]]",468,419,937,419,887,2023,1405,1505,1554,1356,0.534020618556701,0.3330960854092527,0.5276211950394588,0.536826495304004,0.46317350469599605,0.47237880496054113,0.40837696335078527
0.255,2910,"[[468, 937], [419, 1086]]",468,419,937,419,887,2023,1405,1505,1554,1356,0.534020618556701,0.3330960854092527,0.5276211950394588,0.536826495304004,0.46317350469599605,0.47237880496054113,0.40837696335078527
0.256,2910,"[[467, 935], [420, 1088]]",467,420,935,420,887,2023,1402,1508,1555,1355,0.5343642611683849,0.333095577746077,0.5264937993235626,0.5378151260504201,0.46218487394957986,0.47350620067643745,0.4080384447356924
0.257,2910,"[[467, 935], [420, 1088]]",467,420,935,420,887,2023,1402,1508,1555,1355,0.5343642611683849,0.333095577746077,0.5264937993235626,0.5378151260504201,0.46218487394957986,0.47350620067643745,0.4080384447356924
0.258,2910,"[[467, 934], [420, 1089]]",467,420,934,420,887,2023,1401,1509,1556,1354,0.5347079037800687,0.3333333333333333,0.5264937993235626,0.5383094414236282,0.4616905585763717,0.47350620067643745,0.40821678321678323
0.259,2910,"[[466, 932], [421, 1091]]",466,421,932,421,887,2023,1398,1512,1557,1353,0.5350515463917526,0.3333333333333333,0.5253664036076663,0.5392980721700444,0.4607019278299555,0.4746335963923337,0.40787746170678335
0.26,2910,"[[466, 931], [421, 1092]]",466,421,931,421,887,2023,1397,1513,1558,1352,0.5353951890034364,0.33357193987115247,0.5253664036076663,0.5397923875432526,0.4602076124567474,0.4746335963923337,0.4080560420315237
0.261,2910,"[[465, 930], [422, 1093]]",465,422,930,422,887,2023,1395,1515,1558,1352,0.5353951890034364,0.3333333333333333,0.52423900789177,0.5402867029164607,0.4597132970835393,0.47576099210823,0.4075372480280456
0.262,2910,"[[465, 930], [422, 1093]]",465,422,930,422,887,2023,1395,1515,1558,1352,0.5353951890034364,0.3333333333333333,0.52423900789177,0.5402867029164607,0.4597132970835393,0.47576099210823,0.4075372480280456
0.263,2910,"[[465, 930], [422, 1093]]",465,422,930,422,887,2023,1395,1515,1558,1352,0.5353951890034364,0.3333333333333333,0.52423900789177,0.5402867029164607,0.4597132970835393,0.47576099210823,0.4075372480280456
0.264,2910,"[[465, 930], [422, 1093]]",465,422,930,422,887,2023,1395,1515,1558,1352,0.5353951890034364,0.3333333333333333,0.52423900789177,0.5402867029164607,0.4597132970835393,0.47576099210823,0.4075372480280456
0.265,2910,"[[464, 929], [423, 1094]]",464,423,929,423,887,2023,1393,1517,1558,1352,0.5353951890034364,0.3330940416367552,0.5231116121758738,0.5407810182896688,0.4592189817103312,0.4768883878241263,0.4070175438596491
0.266,2910,"[[464, 927], [423, 1096]]",464,423,927,423,887,2023,1391,1519,1560,1350,0.5360824742268041,0.3335729690869878,0.5231116121758738,0.541769649036085,0.45823035096391496,0.4768883878241263,0.4073748902546093
0.267,2910,"[[464, 927], [423, 1096]]",464,423,927,423,887,2023,1391,1519,1560,1350,0.5360824742268041,0.3335729690869878,0.5231116121758738,0.541769649036085,0.45823035096391496,0.4768883878241263,0.4073748902546093
0.268,2910,"[[464, 927], [423, 1096]]",464,423,927,423,887,2023,1391,1519,1560,1350,0.5360824742268041,0.3335729690869878,0.5231116121758738,0.541769649036085,0.45823035096391496,0.4768883878241263,0.4073748902546093
0.269,2910,"[[464, 926], [423, 1097]]",464,423,926,423,887,2023,1390,1520,1561,1349,0.536426116838488,0.3338129496402878,0.5231116121758738,0.5422639644092931,0.45773603559070686,0.4768883878241263,0.4075537988581467
0.27,2910,"[[464, 925], [423, 1098]]",464,423,925,423,887,2023,1389,1521,1562,1348,0.5367697594501718,0.33405327573794097,0.5231116121758738,0.5427582797825012,0.45724172021749876,0.4768883878241263,0.4077328646748682
0.271,2910,"[[464, 924], [423, 1099]]",464,423,924,423,887,2023,1388,1522,1563,1347,0.5371134020618556,0.33429394812680113,0.5231116121758738,0.5432525951557093,0.45674740484429066,0.4768883878241263,0.4079120879120879
0.272,2910,"[[463, 923], [424, 1100]]",463,424,923,424,887,2023,1386,1524,1563,1347,0.5371134020618556,0.33405483405483405,0.5219842164599775,0.5437469105289174,0.45625308947108256,0.47801578354002255,0.40739111306643205
0.273,2910,"[[462, 921], [425, 1102]]",462,425,921,425,887,2023,1383,1527,1564,1346,0.5374570446735395,0.33405639913232105,0.5208568207440811,0.5447355412753336,0.4552644587246663,0.4791431792559188,0.4070484581497797
0.274,2910,"[[461, 920], [426, 1103]]",461,426,920,426,887,2023,1381,1529,1564,1346,0.5374570446735395,0.333816075307748,0.5197294250281849,0.5452298566485417,0.4547701433514582,0.48027057497181513,0.4065255731922398
0.275,2910,"[[461, 919], [426, 1104]]",461,426,919,426,887,2023,1380,1530,1565,1345,0.5378006872852233,0.33405797101449275,0.5197294250281849,0.5457241720217498,0.4542758279782501,0.48027057497181513,0.4067048963387737
0.276,2910,"[[460, 919], [427, 1104]]",460,427,919,427,887,2023,1379,1531,1564,1346,0.5374570446735395,0.3335750543872371,0.5186020293122886,0.5457241720217498,0.4542758279782501,0.4813979706877114,0.4060017652250662
0.277,2910,"[[459, 917], [428, 1106]]",459,428,917,428,887,2023,1376,1534,1565,1345,0.5378006872852233,0.3335755813953488,0.5174746335963923,0.5467128027681661,0.4532871972318339,0.48252536640360766,0.4056562085726911
0.278,2910,"[[459, 917], [428, 1106]]",459,428,917,428,887,2023,1376,1534,1565,1345,0.5378006872852233,0.3335755813953488,0.5174746335963923,0.5467128027681661,0.4532871972318339,0.48252536640360766,0.4056562085726911
0.279,2910,"[[459, 917], [428, 1106]]",459,428,917,428,887,2023,1376,1534,1565,1345,0.5378006872852233,0.3335755813953488,0.5174746335963923,0.5467128027681661,0.4532871972318339,0.48252536640360766,0.4056562085726911
0.28,2910,"[[459, 916], [428, 1107]]",459,428,916,428,887,2023,1375,1535,1566,1344,0.5381443298969072,0.3338181818181818,0.5174746335963923,0.5472071181413742,0.4527928818586258,0.48252536640360766,0.40583554376657827
0.281,2910,"[[459, 915], [428, 1108]]",459,428,915,428,887,2023,1374,1536,1567,1343,0.538487972508591,0.33406113537117904,0.5174746335963923,0.5477014335145823,0.4522985664854177,0.48252536640360766,0.406015037593985
0.282,2910,"[[459, 913], [428, 1110]]",459,428,913,428,887,2023,1372,1538,1569,1341,0.5391752577319587,0.33454810495626824,0.5174746335963923,0.5486900642609985,0.45130993573900147,0.48252536640360766,0.4063745019920319
0.283,2910,"[[459, 912], [428, 1111]]",459,428,912,428,887,2023,1371,1539,1570,1340,0.5395189003436426,0.3347921225382932,0.5174746335963923,0.5491843796342066,0.45081562036579337,0.48252536640360766,0.40655447298494246
0.284,2910,"[[459, 911], [428, 1112]]",459,428,911,428,887,2023,1370,1540,1571,1339,0.5398625429553264,0.335036496350365,0.5174746335963923,0.5496786950074147,0.45032130499258527,0.48252536640360766,0.4067346034559149
0.285,2910,"[[458, 908], [429, 1115]]",458,429,908,429,887,2023,1366,1544,1573,1337,0.5405498281786941,0.33528550512445093,0.5163472378804961,0.551161641127039,0.448838358872961,0.4836527621195039,0.40656901908566356
0.286,2910,"[[457, 908], [430, 1115]]",457,430,908,430,887,2023,1365,1545,1572,1338,0.5402061855670103,0.3347985347985348,0.5152198421645998,0.551161641127039,0.448838358872961,0.48478015783540024,0.40586145648312605
0.287,2910,"[[456, 908], [431, 1115]]",456,431,908,431,887,2023,1364,1546,1571,1339,0.5398625429553264,0.3343108504398827,0.5140924464487034,0.551161641127039,0.448838358872961,0.4859075535512965,0.40515326521545975
0.288,2910,"[[456, 907], [431, 1116]]",456,431,907,431,887,2023,1363,1547,1572,1338,0.5402061855670103,0.334556126192223,0.5140924464487034,0.5516559565002471,0.4483440434997528,0.4859075535512965,0.40533333333333327
0.289,2910,"[[455, 907], [432, 1116]]",455,432,907,432,887,2023,1362,1548,1571,1339,0.5398625429553264,0.3340675477239354,0.5129650507328072,0.5516559565002471,0.4483440434997528,0.48703494926719276,0.40462427745664736
0.29,2910,"[[455, 907], [432, 1116]]",455,432,907,432,887,2023,1362,1548,1571,1339,0.5398625429553264,0.3340675477239354,0.5129650507328072,0.5516559565002471,0.4483440434997528,0.48703494926719276,0.40462427745664736
0.291,2910,"[[455, 906], [432, 1117]]",455,432,906,432,887,2023,1361,1549,1572,1338,0.5402061855670103,0.334313005143277,0.5129650507328072,0.5521502718734552,0.4478497281265447,0.48703494926719276,0.40480427046263345
0.292,2910,"[[455, 906], [432, 1117]]",455,432,906,432,887,2023,1361,1549,1572,1338,0.5402061855670103,0.334313005143277,0.5129650507328072,0.5521502718734552,0.4478497281265447,0.48703494926719276,0.40480427046263345
0.293,2910,"[[454, 905], [433, 1118]]",454,433,905,433,887,2023,1359,1551,1572,1338,0.5402061855670103,0.3340691685062546,0.5118376550169109,0.5526445872466633,0.4473554127533366,0.4881623449830891,0.40427426536064115
0.294,2910,"[[453, 904], [434, 1119]]",453,434,904,434,887,2023,1357,1553,1572,1338,0.5402061855670103,0.3338246131171702,0.5107102593010147,0.5531389026198715,0.4468610973801285,0.48928974069898534,0.40374331550802134
0.295,2910,"[[453, 904], [434, 1119]]",453,434,904,434,887,2023,1357,1553,1572,1338,0.5402061855670103,0.3338246131171702,0.5107102593010147,0.5531389026198715,0.4468610973801285,0.48928974069898534,0.40374331550802134
0.296,2910,"[[452, 901], [435, 1122]]",452,435,901,435,887,2023,1353,1557,1574,1336,0.540893470790378,0.3340724316334072,0.5095828635851184,0.5546218487394958,0.44537815126050423,0.4904171364148816,0.4035714285714285
0.297,2910,"[[452, 901], [435, 1122]]",452,435,901,435,887,2023,1353,1557,1574,1336,0.540893470790378,0.3340724316334072,0.5095828635851184,0.5546218487394958,0.44537815126050423,0.4904171364148816,0.4035714285714285
0.298,2910,"[[449, 898], [438, 1125]]",449,438,898,438,887,2023,1347,1563,1574,1336,0.540893470790378,0.3333333333333333,0.5062006764374295,0.5561047948591201,0.4438952051408799,0.49379932356257045,0.4019695613249775
0.299,2910,"[[449, 895], [438, 1128]]",449,438,895,438,887,2023,1344,1566,1577,1333,0.5419243986254295,0.33407738095238093,0.5062006764374295,0.5575877409787444,0.4424122590212556,0.49379932356257045,0.4025100851636037
0.3,2910,"[[449, 894], [438, 1129]]",449,438,894,438,887,2023,1343,1567,1578,1332,0.5422680412371134,0.3343261355174981,0.5062006764374295,0.5580820563519525,0.44191794364804743,0.49379932356257045,0.4026905829596413
0.301,2910,"[[448, 892], [439, 1131]]",448,439,892,439,887,2023,1340,1570,1579,1331,0.5426116838487972,0.33432835820895523,0.5050732807215332,0.5590706870983687,0.44092931290163123,0.49492671927846676,0.40233497979344407
0.302,2910,"[[447, 890], [440, 1133]]",447,440,890,440,887,2023,1337,1573,1580,1330,0.5429553264604811,0.3343305908750935,0.503945885005637,0.560059317844785,0.43994068215521503,0.496054114994363,0.40197841726618705
0.303,2910,"[[447, 889], [440, 1134]]",447,440,889,440,887,2023,1336,1574,1581,1329,0.5432989690721649,0.3345808383233533,0.503945885005637,0.5605536332179931,0.43944636678200694,0.496054114994363,0.4021592442645074
0.304,2910,"[[447, 888], [440, 1135]]",447,440,888,440,887,2023,1335,1575,1582,1328,0.5436426116838488,0.3348314606741573,0.503945885005637,0.5610479485912012,0.43895205140879884,0.496054114994363,0.40234023402340235
0.305,2910,"[[447, 886], [440, 1137]]",447,440,886,440,887,2023,1333,1577,1584,1326,0.5443298969072164,0.3353338334583646,0.503945885005637,0.5620365793376174,0.4379634206623826,0.496054114994363,0.40270270270270275
0.306,2910,"[[447, 885], [440, 1138]]",447,440,885,440,887,2023,1332,1578,1585,1325,0.5446735395189003,0.3355855855855856,0.503945885005637,0.5625308947108255,0.4374691052891745,0.496054114994363,0.4028841820639928
0.307,2910,"[[447, 883], [440, 1140]]",447,440,883,440,887,2023,1330,1580,1587,1323,0.545360824742268,0.3360902255639098,0.503945885005637,0.5635195254572417,0.4364804745427583,0.496054114994363,0.4032476319350473
0.308,2910,"[[447, 880], [440, 1143]]",447,440,880,440,887,2023,1327,1583,1590,1320,0.5463917525773195,0.33685003767897514,0.503945885005637,0.565002471576866,0.43499752842313394,0.496054114994363,0.40379403794037944
0.309,2910,"[[447, 876], [440, 1147]]",447,440,876,440,887,2023,1323,1587,1594,1316,0.547766323024055,0.3378684807256236,0.503945885005637,0.5669797330696985,0.43302026693030155,0.496054114994363,0.40452488687782806
0.31,2910,"[[445, 876], [442, 1147]]",445,442,876,442,887,2023,1321,1589,1592,1318,0.5470790378006873,0.3368660105980318,0.5016910935738444,0.5669797330696985,0.43302026693030155,0.4983089064261556,0.40307971014492755
0.311,2910,"[[445, 874], [442, 1149]]",445,442,874,442,887,2023,1319,1591,1594,1316,0.547766323024055,0.3373768006065201,0.5016910935738444,0.5679683638161147,0.4320316361838853,0.4983089064261556,0.40344514959202177
0.312,2910,"[[445, 874], [442, 1149]]",445,442,874,442,887,2023,1319,1591,1594,1316,0.547766323024055,0.3373768006065201,0.5016910935738444,0.5679683638161147,0.4320316361838853,0.4983089064261556,0.40344514959202177
0.313,2910,"[[445, 874], [442, 1149]]",445,442,874,442,887,2023,1319,1591,1594,1316,0.547766323024055,0.3373768006065201,0.5016910935738444,0.5679683638161147,0.4320316361838853,0.4983089064261556,0.40344514959202177
0.314,2910,"[[445, 874], [442, 1149]]",445,442,874,442,887,2023,1319,1591,1594,1316,0.547766323024055,0.3373768006065201,0.5016910935738444,0.5679683638161147,0.4320316361838853,0.4983089064261556,0.40344514959202177
0.315,2910,"[[442, 874], [445, 1149]]",442,445,874,445,887,2023,1316,1594,1591,1319,0.5467353951890034,0.33586626139817627,0.4983089064261556,0.5679683638161147,0.4320316361838853,0.5016910935738444,0.40127099409895595
0.316,2910,"[[440, 874], [447, 1149]]",440,447,874,447,887,2023,1314,1596,1589,1321,0.5460481099656357,0.334855403348554,0.496054114994363,0.5679683638161147,0.4320316361838853,0.503945885005637,0.39981826442526125
0.317,2910,"[[438, 873], [449, 1150]]",438,449,873,449,887,2023,1311,1599,1588,1322,0.5457044673539518,0.3340961098398169,0.49379932356257045,0.5684626791893228,0.4315373208106772,0.5062006764374295,0.39854413102820746
0.318,2910,"[[437, 873], [450, 1150]]",437,450,873,450,887,2023,1310,1600,1587,1323,0.545360824742268,0.333587786259542,0.4926719278466742,0.5684626791893228,0.4315373208106772,0.5073280721533259,0.3978152025489303
0.319,2910,"[[437, 872], [450, 1151]]",437,450,872,450,887,2023,1309,1601,1588,1322,0.5457044673539518,0.33384262796027503,0.4926719278466742,0.5689569945625309,0.4310430054374691,0.5073280721533259,0.39799635701275043
0.32,2910,"[[436, 871], [451, 1152]]",436,451,871,451,887,2023,1307,1603,1588,1322,0.5457044673539518,0.3335883703136955,0.4915445321307779,0.569451309935739,0.430548690064261,0.5084554678692221,0.3974475843208752
0.321,2910,"[[436, 871], [451, 1152]]",436,451,871,451,887,2023,1307,1603,1588,1322,0.5457044673539518,0.3335883703136955,0.4915445321307779,0.569451309935739,0.430548690064261,0.5084554678692221,0.3974475843208752
0.322,2910,"[[435, 871], [452, 1152]]",435,452,871,452,887,2023,1306,1604,1587,1323,0.545360824742268,0.3330781010719755,0.4904171364148816,0.569451309935739,0.430548690064261,0.5095828635851184,0.39671682626538984
0.323,2910,"[[435, 869], [452, 1154]]",435,452,869,452,887,2023,1304,1606,1589,1321,0.5460481099656357,0.33358895705521474,0.4904171364148816,0.5704399406821552,0.4295600593178448,0.5095828635851184,0.3970789593792789
0.324,2910,"[[435, 869], [452, 1154]]",435,452,869,452,887,2023,1304,1606,1589,1321,0.5460481099656357,0.33358895705521474,0.4904171364148816,0.5704399406821552,0.4295600593178448,0.5095828635851184,0.3970789593792789
0.325,2910,"[[434, 868], [453, 1155]]",434,453,868,453,887,2023,1302,1608,1589,1321,0.5460481099656357,0.3333333333333333,0.48928974069898534,0.5709342560553633,0.4290657439446367,0.5107102593010147,0.39652809502055736
0.326,2910,"[[434, 867], [453, 1156]]",434,453,867,453,887,2023,1301,1609,1590,1320,0.5463917525773195,0.33358954650269024,0.48928974069898534,0.5714285714285714,0.42857142857142855,0.5107102593010147,0.396709323583181
0.327,2910,"[[434, 867], [453, 1156]]",434,453,867,453,887,2023,1301,1609,1590,1320,0.5463917525773195,0.33358954650269024,0.48928974069898534,0.5714285714285714,0.42857142857142855,0.5107102593010147,0.396709323583181
0.328,2910,"[[432, 867], [455, 1156]]",432,455,867,455,887,2023,1299,1611,1588,1322,0.5457044673539518,0.3325635103926097,0.48703494926719276,0.5714285714285714,0.42857142857142855,0.5129650507328072,0.39524245196706304
0.329,2910,"[[431, 867], [456, 1156]]",431,456,867,456,887,2023,1298,1612,1587,1323,0.545360824742268,0.3320493066255778,0.4859075535512965,0.5714285714285714,0.42857142857142855,0.5140924464487034,0.3945080091533181
0.33,2910,"[[430, 867], [457, 1156]]",430,457,867,457,887,2023,1297,1613,1586,1324,0.5450171821305841,0.3315343099460293,0.48478015783540024,0.5714285714285714,0.42857142857142855,0.5152198421645998,0.39377289377289376
0.331,2910,"[[430, 867], [457, 1156]]",430,457,867,457,887,2023,1297,1613,1586,1324,0.5450171821305841,0.3315343099460293,0.48478015783540024,0.5714285714285714,0.42857142857142855,0.5152198421645998,0.39377289377289376
0.332,2910,"[[430, 864], [457, 1159]]",430,457,864,457,887,2023,1294,1616,1589,1321,0.5460481099656357,0.3323029366306028,0.48478015783540024,0.5729115175481958,0.42708848245180425,0.5152198421645998,0.3943145346171481
0.333,2910,"[[430, 864], [457, 1159]]",430,457,864,457,887,2023,1294,1616,1589,1321,0.5460481099656357,0.3323029366306028,0.48478015783540024,0.5729115175481958,0.42708848245180425,0.5152198421645998,0.3943145346171481
0.334,2910,"[[430, 863], [457, 1160]]",430,457,863,457,887,2023,1293,1617,1590,1320,0.5463917525773195,0.3325599381283836,0.48478015783540024,0.5734058329214039,0.42659416707859615,0.5152198421645998,0.3944954128440367
0.335,2910,"[[429, 863], [458, 1160]]",429,458,863,458,887,2023,1292,1618,1589,1321,0.5460481099656357,0.3320433436532508,0.4836527621195039,0.5734058329214039,0.42659416707859615,0.5163472378804961,0.3937586048646168
0.336,2910,"[[429, 863], [458, 1160]]",429,458,863,458,887,2023,1292,1618,1589,1321,0.5460481099656357,0.3320433436532508,0.4836527621195039,0.5734058329214039,0.42659416707859615,0.5163472378804961,0.3937586048646168
0.337,2910,"[[429, 863], [458, 1160]]",429,458,863,458,887,2023,1292,1618,1589,1321,0.5460481099656357,0.3320433436532508,0.4836527621195039,0.5734058329214039,0.42659416707859615,0.5163472378804961,0.3937586048646168
0.338,2910,"[[429, 862], [458, 1161]]",429,458,862,458,887,2023,1291,1619,1590,1320,0.5463917525773195,0.33230054221533695,0.4836527621195039,0.573900148294612,0.42609985170538806,0.5163472378804961,0.3939393939393939
0.339,2910,"[[428, 862], [459, 1161]]",428,459,862,459,887,2023,1290,1620,1589,1321,0.5460481099656357,0.33178294573643413,0.48252536640360766,0.573900148294612,0.42609985170538806,0.5174746335963923,0.3932016536518144
0.34,2910,"[[427, 859], [460, 1164]]",427,460,859,460,887,2023,1286,1624,1591,1319,0.5467353951890034,0.3320373250388802,0.4813979706877114,0.5753830944142363,0.4246169055857637,0.5186020293122886,0.393005062126093
0.341,2910,"[[427, 859], [460, 1164]]",427,460,859,460,887,2023,1286,1624,1591,1319,0.5467353951890034,0.3320373250388802,0.4813979706877114,0.5753830944142363,0.4246169055857637,0.5186020293122886,0.393005062126093
0.342,2910,"[[426, 858], [461, 1165]]",426,461,858,461,887,2023,1284,1626,1591,1319,0.5467353951890034,0.3317757009345794,0.48027057497181513,0.5758774097874444,0.4241225902125556,0.5197294250281849,0.3924458774758176
0.343,2910,"[[426, 857], [461, 1166]]",426,461,857,461,887,2023,1283,1627,1592,1318,0.5470790378006873,0.33203429462197975,0.48027057497181513,0.5763717251606525,0.4236282748393475,0.5197294250281849,0.3926267281105991
0.344,2910,"[[426, 857], [461, 1166]]",426,461,857,461,887,2023,1283,1627,1592,1318,0.5470790378006873,0.33203429462197975,0.48027057497181513,0.5763717251606525,0.4236282748393475,0.5197294250281849,0.3926267281105991
0.345,2910,"[[426, 856], [461, 1167]]",426,461,856,461,887,2023,1282,1628,1593,1317,0.5474226804123712,0.33229329173166927,0.48027057497181513,0.5768660405338606,0.4231339594661394,0.5197294250281849,0.39280774550484093
0.346,2910,"[[426, 856], [461, 1167]]",426,461,856,461,887,2023,1282,1628,1593,1317,0.5474226804123712,0.33229329173166927,0.48027057497181513,0.5768660405338606,0.4231339594661394,0.5197294250281849,0.39280774550484093
0.347,2910,"[[426, 856], [461, 1167]]",426,461,856,461,887,2023,1282,1628,1593,1317,0.5474226804123712,0.33229329173166927,0.48027057497181513,0.5768660405338606,0.4231339594661394,0.5197294250281849,0.39280774550484093
0.348,2910,"[[425, 855], [462, 1168]]",425,462,855,462,887,2023,1280,1630,1593,1317,0.5474226804123712,0.33203125,0.4791431792559188,0.5773603559070687,0.4226396440929313,0.5208568207440811,0.39224734656206733
0.349,2910,"[[425, 854], [462, 1169]]",425,462,854,462,887,2023,1279,1631,1594,1316,0.547766323024055,0.33229085222830335,0.4791431792559188,0.5778546712802768,0.42214532871972316,0.5208568207440811,0.3924284395198523
0.35,2910,"[[425, 854], [462, 1169]]",425,462,854,462,887,2023,1279,1631,1594,1316,0.547766323024055,0.33229085222830335,0.4791431792559188,0.5778546712802768,0.42214532871972316,0.5208568207440811,0.3924284395198523
0.351,2910,"[[425, 852], [462, 1171]]",425,462,852,462,887,2023,1277,1633,1596,1314,0.5484536082474227,0.3328112764291308,0.4791431792559188,0.578843302026693,0.42115669797330696,0.5208568207440811,0.3927911275415897
0.352,2910,"[[425, 851], [462, 1172]]",425,462,851,462,887,2023,1276,1634,1597,1313,0.5487972508591066,0.3330721003134796,0.4791431792559188,0.5793376173999011,0.42066238260009886,0.5208568207440811,0.3929727230698104
0.353,2910,"[[425, 849], [462, 1174]]",425,462,849,462,887,2023,1274,1636,1599,1311,0.5494845360824743,0.33359497645211933,0.4791431792559188,0.5803262481463174,0.41967375185368266,0.5208568207440811,0.3933364183248496
0.354,2910,"[[424, 849], [463, 1174]]",424,463,849,463,887,2023,1273,1637,1598,1312,0.5491408934707904,0.3330714846818539,0.47801578354002255,0.5803262481463174,0.41967375185368266,0.5219842164599775,0.3925925925925926
0.355,2910,"[[424, 848], [463, 1175]]",424,463,848,463,887,2023,1272,1638,1599,1311,0.5494845360824743,0.3333333333333333,0.47801578354002255,0.5808205635195255,0.41917943648047457,0.5219842164599775,0.39277443260768874
0.356,2910,"[[424, 848], [463, 1175]]",424,463,848,463,887,2023,1272,1638,1599,1311,0.5494845360824743,0.3333333333333333,0.47801578354002255,0.5808205635195255,0.41917943648047457,0.5219842164599775,0.39277443260768874
0.357,2910,"[[424, 847], [463, 1176]]",424,463,847,463,887,2023,1271,1639,1600,1310,0.5498281786941581,0.33359559402045635,0.47801578354002255,0.5813148788927336,0.4186851211072664,0.5219842164599775,0.3929564411492122
0.358,2910,"[[424, 847], [463, 1176]]",424,463,847,463,887,2023,1271,1639,1600,1310,0.5498281786941581,0.33359559402045635,0.47801578354002255,0.5813148788927336,0.4186851211072664,0.5219842164599775,0.3929564411492122
0.359,2910,"[[424, 846], [463, 1177]]",424,463,846,463,887,2023,1270,1640,1601,1309,0.550171821305842,0.33385826771653543,0.47801578354002255,0.5818091942659417,0.4181908057340583,0.5219842164599775,0.39313861845155307
0.36,2910,"[[423, 843], [464, 1180]]",423,464,843,464,887,2023,1266,1644,1603,1307,0.5508591065292097,0.3341232227488152,0.4768883878241263,0.583292140385566,0.416707859614434,0.5231116121758738,0.39294008360427307
0.361,2910,"[[423, 841], [464, 1182]]",423,464,841,464,887,2023,1264,1646,1605,1305,0.5515463917525774,0.3346518987341772,0.4768883878241263,0.5842807711319822,0.4157192288680178,0.5231116121758738,0.393305439330544
0.362,2910,"[[423, 841], [464, 1182]]",423,464,841,464,887,2023,1264,1646,1605,1305,0.5515463917525774,0.3346518987341772,0.4768883878241263,0.5842807711319822,0.4157192288680178,0.5231116121758738,0.393305439330544
0.363,2910,"[[422, 840], [465, 1183]]",422,465,840,465,887,2023,1262,1648,1605,1305,0.5515463917525774,0.33438985736925514,0.47576099210823,0.5847750865051903,0.41522491349480967,0.52423900789177,0.3927408096789204
0.364,2910,"[[421, 840], [466, 1183]]",421,466,840,466,887,2023,1261,1649,1604,1306,0.5512027491408935,0.3338620142743854,0.4746335963923337,0.5847750865051903,0.41522491349480967,0.5253664036076663,0.3919925512104283
0.365,2910,"[[420, 839], [467, 1184]]",420,467,839,467,887,2023,1259,1651,1604,1306,0.5512027491408935,0.33359809372517873,0.47350620067643745,0.5852694018783984,0.41473059812160157,0.5264937993235626,0.39142590866728794
0.366,2910,"[[420, 838], [467, 1185]]",420,467,838,467,887,2023,1258,1652,1605,1305,0.5515463917525774,0.3338632750397456,0.47350620067643745,0.5857637172516065,0.41423628274839347,0.5264937993235626,0.39160839160839156
0.367,2910,"[[420, 836], [467, 1187]]",420,467,836,467,887,2023,1256,1654,1607,1303,0.552233676975945,0.3343949044585987,0.47350620067643745,0.5867523479980228,0.4132476520019773,0.5264937993235626,0.39197386840877274
0.368,2910,"[[419, 835], [468, 1188]]",419,468,835,468,887,2023,1254,1656,1607,1303,0.552233676975945,0.33413078149920256,0.47237880496054113,0.5872466633712309,0.4127533366287692,0.5276211950394588,0.39140588510042035
0.369,2910,"[[419, 834], [468, 1189]]",419,468,834,468,887,2023,1253,1657,1608,1302,0.5525773195876289,0.3343974461292897,0.47237880496054113,0.587740978744439,0.4122590212555611,0.5276211950394588,0.39158878504672895
0.37,2910,"[[419, 833], [468, 1190]]",419,468,833,468,887,2023,1252,1658,1609,1301,0.5529209621993127,0.33466453674121405,0.47237880496054113,0.5882352941176471,0.4117647058823529,0.5276211950394588,0.39177185600748016
0.371,2910,"[[419, 833], [468, 1190]]",419,468,833,468,887,2023,1252,1658,1609,1301,0.5529209621993127,0.33466453674121405,0.47237880496054113,0.5882352941176471,0.4117647058823529,0.5276211950394588,0.39177185600748016
0.372,2910,"[[418, 832], [469, 1191]]",418,469,832,469,887,2023,1250,1660,1609,1301,0.5529209621993127,0.3344,0.47125140924464487,0.5887296094908552,0.4112703905091448,0.5287485907553551,0.39120262049602245
0.373,2910,"[[418, 831], [469, 1192]]",418,469,831,469,887,2023,1249,1661,1610,1300,0.5532646048109966,0.33466773418734985,0.47125140924464487,0.5892239248640633,0.4107760751359367,0.5287485907553551,0.39138576779026213
0.374,2910,"[[417, 831], [470, 1192]]",417,470,831,470,887,2023,1248,1662,1609,1301,0.5529209621993127,0.33413461538461536,0.4701240135287486,0.5892239248640633,0.4107760751359367,0.5298759864712514,0.3906323185011709
0.375,2910,"[[417, 830], [470, 1193]]",417,470,830,470,887,2023,1247,1663,1610,1300,0.5532646048109966,0.33440256615878106,0.4701240135287486,0.5897182402372714,0.4102817597627286,0.5298759864712514,0.3908153701968135
0.376,2910,"[[417, 830], [470, 1193]]",417,470,830,470,887,2023,1247,1663,1610,1300,0.5532646048109966,0.33440256615878106,0.4701240135287486,0.5897182402372714,0.4102817597627286,0.5298759864712514,0.3908153701968135
0.377,2910,"[[417, 830], [470, 1193]]",417,470,830,470,887,2023,1247,1663,1610,1300,0.5532646048109966,0.33440256615878106,0.4701240135287486,0.5897182402372714,0.4102817597627286,0.5298759864712514,0.3908153701968135
0.378,2910,"[[415, 828], [472, 1195]]",415,472,828,472,887,2023,1243,1667,1610,1300,0.5532646048109966,0.333869670152856,0.46786922209695603,0.5907068709836876,0.40929312901631243,0.532130777903044,0.3896713615023474
0.379,2910,"[[414, 828], [473, 1195]]",414,473,828,473,887,2023,1242,1668,1609,1301,0.5529209621993127,0.3333333333333333,0.46674182638105977,0.5907068709836876,0.40929312901631243,0.5332581736189402,0.3889149835603569
0.38,2910,"[[414, 828], [473, 1195]]",414,473,828,473,887,2023,1242,1668,1609,1301,0.5529209621993127,0.3333333333333333,0.46674182638105977,0.5907068709836876,0.40929312901631243,0.5332581736189402,0.3889149835603569
0.381,2910,"[[414, 827], [473, 1196]]",414,473,827,473,887,2023,1241,1669,1610,1300,0.5532646048109966,0.33360193392425463,0.46674182638105977,0.5912011863568957,0.4087988136431043,0.5332581736189402,0.3890977443609023
0.382,2910,"[[414, 827], [473, 1196]]",414,473,827,473,887,2023,1241,1669,1610,1300,0.5532646048109966,0.33360193392425463,0.46674182638105977,0.5912011863568957,0.4087988136431043,0.5332581736189402,0.3890977443609023
0.383,2910,"[[412, 827], [475, 1196]]",412,475,827,475,887,2023,1239,1671,1608,1302,0.5525773195876289,0.33252623083131555,0.4644870349492672,0.5912011863568957,0.4087988136431043,0.5355129650507328,0.38758231420508
0.384,2910,"[[411, 827], [476, 1196]]",411,476,827,476,887,2023,1238,1672,1607,1303,0.552233676975945,0.33198707592891763,0.4633596392333709,0.5912011863568957,0.4087988136431043,0.5366403607666291,0.3868235294117647
0.385,2910,"[[411, 827], [476, 1196]]",411,476,827,476,887,2023,1238,1672,1607,1303,0.552233676975945,0.33198707592891763,0.4633596392333709,0.5912011863568957,0.4087988136431043,0.5366403607666291,0.3868235294117647
0.386,2910,"[[410, 826], [477, 1197]]",410,477,826,477,887,2023,1236,1674,1607,1303,0.552233676975945,0.33171521035598706,0.46223224351747466,0.5916955017301038,0.4083044982698962,0.5377677564825254,0.3862458784738578
0.387,2910,"[[410, 825], [477, 1198]]",410,477,825,477,887,2023,1235,1675,1608,1302,0.5525773195876289,0.3319838056680162,0.46223224351747466,0.5921898171033119,0.4078101828966881,0.5377677564825254,0.38642789820923656
0.388,2910,"[[410, 825], [477, 1198]]",410,477,825,477,887,2023,1235,1675,1608,1302,0.5525773195876289,0.3319838056680162,0.46223224351747466,0.5921898171033119,0.4078101828966881,0.5377677564825254,0.38642789820923656
0.389,2910,"[[410, 824], [477, 1199]]",410,477,824,477,887,2023,1234,1676,1609,1301,0.5529209621993127,0.33225283630470015,0.46223224351747466,0.59268413247652,0.40731586752348,0.5377677564825254,0.3866100895803867
0.39,2910,"[[410, 821], [477, 1202]]",410,477,821,477,887,2023,1231,1679,1612,1298,0.5539518900343643,0.3330625507717303,0.46223224351747466,0.5941670785961444,0.4058329214038557,0.5377677564825254,0.3871576959395656
0.391,2910,"[[410, 819], [477, 1204]]",410,477,819,477,887,2023,1229,1681,1614,1296,0.554639175257732,0.3336045565500407,0.46223224351747466,0.5951557093425606,0.40484429065743943,0.5377677564825254,0.38752362948960306
0.392,2910,"[[410, 819], [477, 1204]]",410,477,819,477,887,2023,1229,1681,1614,1296,0.554639175257732,0.3336045565500407,0.46223224351747466,0.5951557093425606,0.40484429065743943,0.5377677564825254,0.38752362948960306
0.393,2910,"[[410, 818], [477, 1205]]",410,477,818,477,887,2023,1228,1682,1615,1295,0.5549828178694158,0.3338762214983713,0.46223224351747466,0.5956500247157687,0.40434997528423133,0.5377677564825254,0.3877068557919622
0.394,2910,"[[410, 817], [477, 1206]]",410,477,817,477,887,2023,1227,1683,1616,1294,0.5553264604810997,0.3341483292583537,0.46223224351747466,0.5961443400889768,0.40385565991102323,0.5377677564825254,0.3878902554399243
0.395,2910,"[[410, 813], [477, 1210]]",410,477,813,477,887,2023,1223,1687,1620,1290,0.5567010309278351,0.33524121013900243,0.46223224351747466,0.5981216015818092,0.4018783984181908,0.5377677564825254,0.38862559241706157
0.396,2910,"[[410, 813], [477, 1210]]",410,477,813,477,887,2023,1223,1687,1620,1290,0.5567010309278351,0.33524121013900243,0.46223224351747466,0.5981216015818092,0.4018783984181908,0.5377677564825254,0.38862559241706157
0.397,2910,"[[410, 812], [477, 1211]]",410,477,812,477,887,2023,1222,1688,1621,1289,0.5570446735395189,0.3355155482815057,0.46223224351747466,0.5986159169550173,0.4013840830449827,0.5377677564825254,0.388809862494073
0.398,2910,"[[410, 812], [477, 1211]]",410,477,812,477,887,2023,1222,1688,1621,1289,0.5570446735395189,0.3355155482815057,0.46223224351747466,0.5986159169550173,0.4013840830449827,0.5377677564825254,0.388809862494073
0.399,2910,"[[409, 811], [478, 1212]]",409,478,811,478,887,2023,1220,1690,1621,1289,0.5570446735395189,0.33524590163934426,0.46110484780157834,0.5991102323282254,0.4008897676717746,0.5388951521984217,0.38822971048884675
0.4,2910,"[[409, 810], [478, 1213]]",409,478,810,478,887,2023,1219,1691,1622,1288,0.5573883161512028,0.3355209187858901,0.46110484780157834,0.5996045477014336,0.4003954522985665,0.5388951521984217,0.38841405508072174
0.401,2910,"[[408, 810], [479, 1213]]",408,479,810,479,887,2023,1218,1692,1621,1289,0.5570446735395189,0.33497536945812806,0.4599774520856821,0.5996045477014336,0.4003954522985665,0.5400225479143179,0.3876484560570071
0.402,2910,"[[408, 810], [479, 1213]]",408,479,810,479,887,2023,1218,1692,1621,1289,0.5570446735395189,0.33497536945812806,0.4599774520856821,0.5996045477014336,0.4003954522985665,0.5400225479143179,0.3876484560570071
0.403,2910,"[[408, 809], [479, 1214]]",408,479,809,479,887,2023,1217,1693,1622,1288,0.5573883161512028,0.3352506162695152,0.4599774520856821,0.6000988630746417,0.3999011369253584,0.5400225479143179,0.38783269961977185
0.404,2910,"[[408, 809], [479, 1214]]",408,479,809,479,887,2023,1217,1693,1622,1288,0.5573883161512028,0.3352506162695152,0.4599774520856821,0.6000988630746417,0.3999011369253584,0.5400225479143179,0.38783269961977185
0.405,2910,"[[408, 807], [479, 1216]]",408,479,807,479,887,2023,1215,1695,1624,1286,0.5580756013745705,0.3358024691358025,0.4599774520856821,0.6010874938210579,0.39891250617894214,0.5400225479143179,0.3882017126546147
0.406,2910,"[[407, 806], [480, 1217]]",407,480,806,480,887,2023,1213,1697,1624,1286,0.5580756013745705,0.33553173948887055,0.4588500563697858,0.601581809194266,0.39841819080573404,0.5411499436302142,0.38761904761904764
0.407,2910,"[[406, 806], [481, 1217]]",406,481,806,481,887,2023,1212,1698,1623,1287,0.5577319587628866,0.334983498349835,0.4577226606538895,0.601581809194266,0.39841819080573404,0.5422773393461104,0.3868508813720819
0.408,2910,"[[406, 805], [481, 1218]]",406,481,805,481,887,2023,1211,1699,1624,1286,0.5580756013745705,0.3352601156069364,0.4577226606538895,0.6020761245674741,0.39792387543252594,0.5422773393461104,0.38703527168732127
0.409,2910,"[[406, 805], [481, 1218]]",406,481,805,481,887,2023,1211,1699,1624,1286,0.5580756013745705,0.3352601156069364,0.4577226606538895,0.6020761245674741,0.39792387543252594,0.5422773393461104,0.38703527168732127
0.41,2910,"[[406, 803], [481, 1220]]",406,481,803,481,887,2023,1209,1701,1626,1284,0.5587628865979382,0.3358147229114971,0.4577226606538895,0.6030647553138903,0.39693524468610974,0.5422773393461104,0.3874045801526717
0.411,2910,"[[405, 803], [482, 1220]]",405,482,803,482,887,2023,1208,1702,1625,1285,0.5584192439862543,0.3352649006622517,0.45659526493799324,0.6030647553138903,0.39693524468610974,0.5434047350620068,0.3866348448687351
0.412,2910,"[[404, 800], [483, 1223]]",404,483,800,483,887,2023,1204,1706,1627,1283,0.559106529209622,0.33554817275747506,0.455467869222097,0.6045477014335146,0.3954522985664854,0.5445321307779031,0.3864179818268771
0.413,2910,"[[404, 798], [483, 1225]]",404,483,798,483,887,2023,1202,1708,1629,1281,0.5597938144329897,0.33610648918469216,0.455467869222097,0.6055363321799307,0.3944636678200692,0.5445321307779031,0.3867879368118717
0.414,2910,"[[404, 798], [483, 1225]]",404,483,798,483,887,2023,1202,1708,1629,1281,0.5597938144329897,0.33610648918469216,0.455467869222097,0.6055363321799307,0.3944636678200692,0.5445321307779031,0.3867879368118717
0.415,2910,"[[403, 798], [484, 1225]]",403,484,798,484,887,2023,1201,1709,1628,1282,0.5594501718213059,0.33555370524562866,0.45434047350620066,0.6055363321799307,0.3944636678200692,0.5456595264937993,0.38601532567049807
0.416,2910,"[[403, 797], [484, 1226]]",403,484,797,484,887,2023,1200,1710,1629,1281,0.5597938144329897,0.3358333333333333,0.45434047350620066,0.606030647553139,0.3939693524468611,0.5456595264937993,0.38620028749401053
0.417,2910,"[[403, 797], [484, 1226]]",403,484,797,484,887,2023,1200,1710,1629,1281,0.5597938144329897,0.3358333333333333,0.45434047350620066,0.606030647553139,0.3939693524468611,0.5456595264937993,0.38620028749401053
0.418,2910,"[[403, 797], [484, 1226]]",403,484,797,484,887,2023,1200,1710,1629,1281,0.5597938144329897,0.3358333333333333,0.45434047350620066,0.606030647553139,0.3939693524468611,0.5456595264937993,0.38620028749401053
0.419,2910,"[[403, 797], [484, 1226]]",403,484,797,484,887,2023,1200,1710,1629,1281,0.5597938144329897,0.3358333333333333,0.45434047350620066,0.606030647553139,0.3939693524468611,0.5456595264937993,0.38620028749401053
0.42,2910,"[[402, 797], [485, 1226]]",402,485,797,485,887,2023,1199,1711,1628,1282,0.5594501718213059,0.33527939949958296,0.4532130777903044,0.606030647553139,0.3939693524468611,0.5467869222096956,0.3854266538830297
0.421,2910,"[[402, 796], [485, 1227]]",402,485,796,485,887,2023,1198,1712,1629,1281,0.5597938144329897,0.335559265442404,0.4532130777903044,0.606524962926347,0.393475037073653,0.5467869222096956,0.3856115107913669
0.422,2910,"[[402, 795], [485, 1228]]",402,485,795,485,887,2023,1197,1713,1630,1280,0.5601374570446735,0.3358395989974937,0.4532130777903044,0.6070192782995552,0.3929807217004449,0.5467869222096956,0.3857965451055662
0.423,2910,"[[402, 793], [485, 1230]]",402,485,793,485,887,2023,1195,1715,1632,1278,0.5608247422680412,0.3364016736401674,0.4532130777903044,0.6080079090459714,0.39199209095402865,0.5467869222096956,0.38616714697406346
0.424,2910,"[[402, 793], [485, 1230]]",402,485,793,485,887,2023,1195,1715,1632,1278,0.5608247422680412,0.3364016736401674,0.4532130777903044,0.6080079090459714,0.39199209095402865,0.5467869222096956,0.38616714697406346
0.425,2910,"[[401, 793], [486, 1230]]",401,486,793,486,887,2023,1194,1716,1631,1279,0.5604810996563574,0.3358458961474037,0.45208568207440814,0.6080079090459714,0.39199209095402865,0.5479143179255919,0.3853916386352715
0.426,2910,"[[400, 793], [487, 1230]]",400,487,793,487,887,2023,1193,1717,1630,1280,0.5601374570446735,0.3352891869237217,0.4509582863585118,0.6080079090459714,0.39199209095402865,0.5490417136414881,0.38461538461538464
0.427,2910,"[[400, 792], [487, 1231]]",400,487,792,487,887,2023,1192,1718,1631,1279,0.5604810996563574,0.33557046979865773,0.4509582863585118,0.6085022244191794,0.39149777558082055,0.5490417136414881,0.3848003848003848
0.428,2910,"[[399, 792], [488, 1231]]",399,488,792,488,887,2023,1191,1719,1630,1280,0.5601374570446735,0.3350125944584383,0.44983089064261556,0.6085022244191794,0.39149777558082055,0.5501691093573844,0.38402309913378246
0.429,2910,"[[399, 792], [488, 1231]]",399,488,792,488,887,2023,1191,1719,1630,1280,0.5601374570446735,0.3350125944584383,0.44983089064261556,0.6085022244191794,0.39149777558082055,0.5501691093573844,0.38402309913378246
0.43,2910,"[[399, 790], [488, 1233]]",399,488,790,488,887,2023,1189,1721,1632,1278,0.5608247422680412,0.3355761143818335,0.44983089064261556,0.6094908551655956,0.39050914483440435,0.5501691093573844,0.38439306358381503
0.431,2910,"[[399, 790], [488, 1233]]",399,488,790,488,887,2023,1189,1721,1632,1278,0.5608247422680412,0.3355761143818335,0.44983089064261556,0.6094908551655956,0.39050914483440435,0.5501691093573844,0.38439306358381503
0.432,2910,"[[398, 790], [489, 1233]]",398,489,790,489,887,2023,1188,1722,1631,1279,0.5604810996563574,0.335016835016835,0.4487034949267193,0.6094908551655956,0.39050914483440435,0.5512965050732808,0.3836144578313253
0.433,2910,"[[398, 789], [489, 1234]]",398,489,789,489,887,2023,1187,1723,1632,1278,0.5608247422680412,0.33529907329401853,0.4487034949267193,0.6099851705388037,0.39001482946119626,0.5512965050732808,0.3837994214079074
0.434,2910,"[[398, 789], [489, 1234]]",398,489,789,489,887,2023,1187,1723,1632,1278,0.5608247422680412,0.33529907329401853,0.4487034949267193,0.6099851705388037,0.39001482946119626,0.5512965050732808,0.3837994214079074
0.435,2910,"[[398, 789], [489, 1234]]",398,489,789,489,887,2023,1187,1723,1632,1278,0.5608247422680412,0.33529907329401853,0.4487034949267193,0.6099851705388037,0.39001482946119626,0.5512965050732808,0.3837994214079074
0.436,2910,"[[398, 788], [489, 1235]]",398,489,788,489,887,2023,1186,1724,1633,1277,0.5611683848797251,0.33558178752107926,0.4487034949267193,0.6104794859120118,0.38952051408798816,0.5512965050732808,0.3839845634346358
0.437,2910,"[[398, 788], [489, 1235]]",398,489,788,489,887,2023,1186,1724,1633,1277,0.5611683848797251,0.33558178752107926,0.4487034949267193,0.6104794859120118,0.38952051408798816,0.5512965050732808,0.3839845634346358
0.438,2910,"[[398, 788], [489, 1235]]",398,489,788,489,887,2023,1186,1724,1633,1277,0.5611683848797251,0.33558178752107926,0.4487034949267193,0.6104794859120118,0.38952051408798816,0.5512965050732808,0.3839845634346358
0.439,2910,"[[396, 788], [491, 1235]]",396,491,788,491,887,2023,1184,1726,1631,1279,0.5604810996563574,0.3344594594594595,0.4464487034949267,0.6104794859120118,0.38952051408798816,0.5535512965050733,0.3824239497827137
0.44,2910,"[[396, 787], [491, 1236]]",396,491,787,491,887,2023,1183,1727,1632,1278,0.5608247422680412,0.33474218089602703,0.4464487034949267,0.6109738012852199,0.38902619871478,0.5535512965050733,0.3826086956521739
0.441,2910,"[[396, 785], [491, 1238]]",396,491,785,491,887,2023,1181,1729,1634,1276,0.5615120274914089,0.3353090601185436,0.4464487034949267,0.6119624320316361,0.3880375679683638,0.5535512965050733,0.3829787234042553
0.442,2910,"[[395, 785], [492, 1238]]",395,492,785,492,887,2023,1180,1730,1633,1277,0.5611683848797251,0.3347457627118644,0.44532130777903045,0.6119624320316361,0.3880375679683638,0.5546786922209695,0.382196419932269
0.443,2910,"[[395, 785], [492, 1238]]",395,492,785,492,887,2023,1180,1730,1633,1277,0.5611683848797251,0.3347457627118644,0.44532130777903045,0.6119624320316361,0.3880375679683638,0.5546786922209695,0.382196419932269
0.444,2910,"[[395, 785], [492, 1238]]",395,492,785,492,887,2023,1180,1730,1633,1277,0.5611683848797251,0.3347457627118644,0.44532130777903045,0.6119624320316361,0.3880375679683638,0.5546786922209695,0.382196419932269
0.445,2910,"[[394, 785], [493, 1238]]",394,493,785,493,887,2023,1179,1731,1632,1278,0.5608247422680412,0.3341815097540288,0.44419391206313413,0.6119624320316361,0.3880375679683638,0.5558060879368658,0.38141335914811225
0.446,2910,"[[394, 785], [493, 1238]]",394,493,785,493,887,2023,1179,1731,1632,1278,0.5608247422680412,0.3341815097540288,0.44419391206313413,0.6119624320316361,0.3880375679683638,0.5558060879368658,0.38141335914811225
0.447,2910,"[[392, 784], [495, 1239]]",392,495,784,495,887,2023,1176,1734,1631,1279,0.5604810996563574,0.3333333333333333,0.4419391206313416,0.6124567474048442,0.3875432525951557,0.5580608793686584,0.3800290838584585
0.448,2910,"[[390, 783], [497, 1240]]",390,497,783,497,887,2023,1173,1737,1630,1280,0.5601374570446735,0.33248081841432225,0.43968432919954903,0.6129510627780524,0.3870489372219476,0.560315670800451,0.3786407766990291
0.449,2910,"[[390, 782], [497, 1241]]",390,497,782,497,887,2023,1172,1738,1631,1279,0.5604810996563574,0.33276450511945393,0.43968432919954903,0.6134453781512605,0.3865546218487395,0.560315670800451,0.3788246721709567
0.45,2910,"[[390, 781], [497, 1242]]",390,497,781,497,887,2023,1171,1739,1632,1278,0.5608247422680412,0.3330486763450043,0.43968432919954903,0.6139396935244686,0.3860603064755314,0.560315670800451,0.37900874635568516
0.451,2910,"[[390, 781], [497, 1242]]",390,497,781,497,887,2023,1171,1739,1632,1278,0.5608247422680412,0.3330486763450043,0.43968432919954903,0.6139396935244686,0.3860603064755314,0.560315670800451,0.37900874635568516
0.452,2910,"[[390, 780], [497, 1243]]",390,497,780,497,887,2023,1170,1740,1633,1277,0.5611683848797251,0.3333333333333333,0.43968432919954903,0.6144340088976767,0.38556599110232326,0.560315670800451,0.3791929995138551
0.453,2910,"[[390, 779], [497, 1244]]",390,497,779,497,887,2023,1169,1741,1634,1276,0.5615120274914089,0.33361847733105215,0.43968432919954903,0.6149283242708848,0.38507167572911516,0.560315670800451,0.3793774319066148
0.454,2910,"[[389, 778], [498, 1245]]",389,498,778,498,887,2023,1167,1743,1634,1276,0.5615120274914089,0.3333333333333333,0.43855693348365277,0.6154226396440929,0.38457736035590706,0.5614430665163472,0.37877312560856863
0.455,2910,"[[389, 778], [498, 1245]]",389,498,778,498,887,2023,1167,1743,1634,1276,0.5615120274914089,0.3333333333333333,0.43855693348365277,0.6154226396440929,0.38457736035590706,0.5614430665163472,0.37877312560856863
0.456,2910,"[[389, 778], [498, 1245]]",389,498,778,498,887,2023,1167,1743,1634,1276,0.5615120274914089,0.3333333333333333,0.43855693348365277,0.6154226396440929,0.38457736035590706,0.5614430665163472,0.37877312560856863
0.457,2910,"[[389, 778], [498, 1245]]",389,498,778,498,887,2023,1167,1743,1634,1276,0.5615120274914089,0.3333333333333333,0.43855693348365277,0.6154226396440929,0.38457736035590706,0.5614430665163472,0.37877312560856863
0.458,2910,"[[389, 778], [498, 1245]]",389,498,778,498,887,2023,1167,1743,1634,1276,0.5615120274914089,0.3333333333333333,0.43855693348365277,0.6154226396440929,0.38457736035590706,0.5614430665163472,0.37877312560856863
0.459,2910,"[[388, 778], [499, 1245]]",388,499,778,499,887,2023,1166,1744,1633,1277,0.5611683848797251,0.33276157804459694,0.4374295377677565,0.6154226396440929,0.38457736035590706,0.5625704622322435,0.37798343886994645
0.46,2910,"[[387, 777], [500, 1246]]",387,500,777,500,887,2023,1164,1746,1633,1277,0.5611683848797251,0.3324742268041237,0.4363021420518602,0.615916955017301,0.38408304498269896,0.5636978579481398,0.37737688932228175
0.461,2910,"[[387, 776], [500, 1247]]",387,500,776,500,887,2023,1163,1747,1634,1276,0.5615120274914089,0.33276010318142735,0.4363021420518602,0.6164112703905091,0.38358872960949086,0.5636978579481398,0.3775609756097561
0.462,2910,"[[387, 775], [500, 1248]]",387,500,775,500,887,2023,1162,1748,1635,1275,0.5618556701030928,0.33304647160068845,0.4363021420518602,0.6169055857637172,0.38309441423628277,0.5636978579481398,0.37774524158125916
0.463,2910,"[[386, 774], [501, 1249]]",386,501,774,501,887,2023,1160,1750,1635,1275,0.5618556701030928,0.33275862068965517,0.4351747463359639,0.6173999011369253,0.38260009886307467,0.5648252536640361,0.3771372740595994
0.464,2910,"[[385, 774], [502, 1249]]",385,502,774,502,887,2023,1159,1751,1634,1276,0.5615120274914089,0.33218291630716135,0.43404735062006766,0.6173999011369253,0.38260009886307467,0.5659526493799324,0.37634408602150543
0.465,2910,"[[384, 772], [503, 1251]]",384,503,772,503,887,2023,1156,1754,1635,1275,0.5618556701030928,0.33217993079584773,0.43291995490417134,0.6183885318833415,0.3816114681166584,0.5670800450958287,0.37591776798825255
0.466,2910,"[[384, 771], [503, 1252]]",384,503,771,503,887,2023,1155,1755,1636,1274,0.5621993127147766,0.33246753246753247,0.43291995490417134,0.6188828472565496,0.3811171527434503,0.5670800450958287,0.376101860920666
0.467,2910,"[[384, 770], [503, 1253]]",384,503,770,503,887,2023,1154,1756,1637,1273,0.5625429553264605,0.3327556325823224,0.43291995490417134,0.6193771626297578,0.3806228373702422,0.5670800450958287,0.3762861342479176
0.468,2910,"[[384, 769], [503, 1254]]",384,503,769,503,887,2023,1153,1757,1638,1272,0.5628865979381443,0.33304423243712056,0.43291995490417134,0.6198714780029659,0.3801285219970341,0.5670800450958287,0.3764705882352941
0.469,2910,"[[384, 768], [503, 1255]]",384,503,768,503,887,2023,1152,1758,1639,1271,0.5632302405498282,0.3333333333333333,0.43291995490417134,0.620365793376174,0.379634206623826,0.5670800450958287,0.3766552231486023
0.47,2910,"[[383, 768], [504, 1255]]",383,504,768,504,887,2023,1151,1759,1638,1272,0.5628865979381443,0.3327541268462207,0.4317925591882751,0.620365793376174,0.379634206623826,0.5682074408117249,0.3758586849852797
0.471,2910,"[[383, 766], [504, 1257]]",383,504,766,504,887,2023,1149,1761,1640,1270,0.563573883161512,0.3333333333333333,0.4317925591882751,0.6213544241225902,0.37864557587740977,0.5682074408117249,0.37622789783889976
0.472,2910,"[[382, 766], [505, 1257]]",382,505,766,505,887,2023,1148,1762,1639,1271,0.5632302405498282,0.3327526132404181,0.4306651634723788,0.6213544241225902,0.37864557587740977,0.5693348365276212,0.3754299754299754
0.473,2910,"[[379, 766], [508, 1257]]",379,508,766,508,887,2023,1145,1765,1636,1274,0.5621993127147766,0.33100436681222706,0.42728297632469,0.6213544241225902,0.37864557587740977,0.5727170236753101,0.3730314960629921
0.474,2910,"[[379, 766], [508, 1257]]",379,508,766,508,887,2023,1145,1765,1636,1274,0.5621993127147766,0.33100436681222706,0.42728297632469,0.6213544241225902,0.37864557587740977,0.5727170236753101,0.3730314960629921
0.475,2910,"[[377, 765], [510, 1258]]",377,510,765,510,887,2023,1142,1768,1635,1275,0.5618556701030928,0.330122591943958,0.4250281848928974,0.6218487394957983,0.37815126050420167,0.5749718151071026,0.37161163134549036
0.476,2910,"[[377, 764], [510, 1259]]",377,510,764,510,887,2023,1141,1769,1636,1274,0.5621993127147766,0.33041191936897457,0.4250281848928974,0.6223430548690064,0.37765694513099357,0.5749718151071026,0.3717948717948718
0.477,2910,"[[377, 764], [510, 1259]]",377,510,764,510,887,2023,1141,1769,1636,1274,0.5621993127147766,0.33041191936897457,0.4250281848928974,0.6223430548690064,0.37765694513099357,0.5749718151071026,0.3717948717948718
0.478,2910,"[[377, 764], [510, 1259]]",377,510,764,510,887,2023,1141,1769,1636,1274,0.5621993127147766,0.33041191936897457,0.4250281848928974,0.6223430548690064,0.37765694513099357,0.5749718151071026,0.3717948717948718
0.479,2910,"[[376, 764], [511, 1259]]",376,511,764,511,887,2023,1140,1770,1635,1275,0.5618556701030928,0.3298245614035088,0.42390078917700114,0.6223430548690064,0.37765694513099357,0.5760992108229989,0.3709916132215096
0.48,2910,"[[376, 762], [511, 1261]]",376,511,762,511,887,2023,1138,1772,1637,1273,0.5625429553264605,0.3304042179261863,0.42390078917700114,0.6233316856154226,0.3766683143845774,0.5760992108229989,0.37135802469135804
0.481,2910,"[[376, 758], [511, 1265]]",376,511,758,511,887,2023,1134,1776,1641,1269,0.5639175257731959,0.3315696649029982,0.42390078917700114,0.625308947108255,0.3746910528917449,0.5760992108229989,0.37209302325581395
0.482,2910,"[[376, 758], [511, 1265]]",376,511,758,511,887,2023,1134,1776,1641,1269,0.5639175257731959,0.3315696649029982,0.42390078917700114,0.625308947108255,0.3746910528917449,0.5760992108229989,0.37209302325581395
0.483,2910,"[[376, 757], [511, 1266]]",376,511,757,511,887,2023,1133,1777,1642,1268,0.5642611683848797,0.3318623124448367,0.42390078917700114,0.6258032624814631,0.3741967375185368,0.5760992108229989,0.37227722772277233
0.484,2910,"[[374, 757], [513, 1266]]",374,513,757,513,887,2023,1131,1779,1640,1270,0.563573883161512,0.3306808134394341,0.42164599774520856,0.6258032624814631,0.3741967375185368,0.5783540022547914,0.37066402378592667
0.485,2910,"[[374, 756], [513, 1267]]",374,513,756,513,887,2023,1130,1780,1641,1269,0.5639175257731959,0.3309734513274336,0.42164599774520856,0.6262975778546713,0.3737024221453287,0.5783540022547914,0.3708477937530986
0.486,2910,"[[373, 755], [514, 1268]]",373,514,755,514,887,2023,1128,1782,1641,1269,0.5639175257731959,0.33067375886524825,0.4205186020293123,0.6267918932278794,0.37320810677212063,0.5794813979706878,0.37022332506203476
0.487,2910,"[[372, 754], [515, 1269]]",372,515,754,515,887,2023,1126,1784,1641,1269,0.5639175257731959,0.33037300177619894,0.41939120631341603,0.6272862086010875,0.37271379139891253,0.580608793686584,0.36959761549925485
0.488,2910,"[[372, 754], [515, 1269]]",372,515,754,515,887,2023,1126,1784,1641,1269,0.5639175257731959,0.33037300177619894,0.41939120631341603,0.6272862086010875,0.37271379139891253,0.580608793686584,0.36959761549925485
0.489,2910,"[[372, 753], [515, 1270]]",372,515,753,515,887,2023,1125,1785,1642,1268,0.5642611683848797,0.33066666666666666,0.41939120631341603,0.6277805239742956,0.3722194760257044,0.580608793686584,0.36978131212723664
0.49,2910,"[[372, 752], [515, 1271]]",372,515,752,515,887,2023,1124,1786,1643,1267,0.5646048109965636,0.3309608540925267,0.41939120631341603,0.6282748393475037,0.3717251606524963,0.580608793686584,0.36996519144704126
0.491,2910,"[[372, 749], [515, 1274]]",372,515,749,515,887,2023,1121,1789,1646,1264,0.5656357388316151,0.33184656556645853,0.41939120631341603,0.629757785467128,0.370242214532872,0.580608793686584,0.37051792828685254
0.492,2910,"[[372, 748], [515, 1275]]",372,515,748,515,887,2023,1120,1790,1647,1263,0.565979381443299,0.33214285714285713,0.41939120631341603,0.6302521008403361,0.3697478991596639,0.580608793686584,0.37070254110612855
0.493,2910,"[[372, 747], [515, 1276]]",372,515,747,515,887,2023,1119,1791,1648,1262,0.5663230240549828,0.3324396782841823,0.41939120631341603,0.6307464162135442,0.3692535837864558,0.580608793686584,0.3708873379860419
0.494,2910,"[[370, 747], [517, 1276]]",370,517,747,517,887,2023,1117,1793,1646,1264,0.5656357388316151,0.3312444046553268,0.41713641488162345,0.6307464162135442,0.3692535837864558,0.5828635851183765,0.3692614770459082
0.495,2910,"[[370, 747], [517, 1276]]",370,517,747,517,887,2023,1117,1793,1646,1264,0.5656357388316151,0.3312444046553268,0.41713641488162345,0.6307464162135442,0.3692535837864558,0.5828635851183765,0.3692614770459082
0.496,2910,"[[369, 746], [518, 1277]]",369,518,746,518,887,2023,1115,1795,1646,1264,0.5656357388316151,0.3309417040358744,0.4160090191657272,0.6312407315867523,0.36875926841324763,0.5839909808342728,0.36863136863136864
0.497,2910,"[[369, 745], [518, 1278]]",369,518,745,518,887,2023,1114,1796,1647,1263,0.565979381443299,0.33123877917414724,0.4160090191657272,0.6317350469599604,0.36826495304003953,0.5839909808342728,0.36881559220389803
0.498,2910,"[[368, 743], [519, 1280]]",368,519,743,519,887,2023,1111,1799,1648,1262,0.5663230240549828,0.33123312331233123,0.41488162344983087,0.6327236777063767,0.36727632229362334,0.5851183765501691,0.3683683683683684
0.499,2910,"[[368, 743], [519, 1280]]",368,519,743,519,887,2023,1111,1799,1648,1262,0.5663230240549828,0.33123312331233123,0.41488162344983087,0.6327236777063767,0.36727632229362334,0.5851183765501691,0.3683683683683684
0.5,2910,"[[368, 743], [519, 1280]]",368,519,743,519,887,2023,1111,1799,1648,1262,0.5663230240549828,0.33123312331233123,0.41488162344983087,0.6327236777063767,0.36727632229362334,0.5851183765501691,0.3683683683683684
0.501,2910,"[[368, 743], [519, 1280]]",368,519,743,519,887,2023,1111,1799,1648,1262,0.5663230240549828,0.33123312331233123,0.41488162344983087,0.6327236777063767,0.36727632229362334,0.5851183765501691,0.3683683683683684
0.502,2910,"[[368, 743], [519, 1280]]",368,519,743,519,887,2023,1111,1799,1648,1262,0.5663230240549828,0.33123312331233123,0.41488162344983087,0.6327236777063767,0.36727632229362334,0.5851183765501691,0.3683683683683684
0.503,2910,"[[368, 743], [519, 1280]]",368,519,743,519,887,2023,1111,1799,1648,1262,0.5663230240549828,0.33123312331233123,0.41488162344983087,0.6327236777063767,0.36727632229362334,0.5851183765501691,0.3683683683683684
0.504,2910,"[[368, 741], [519, 1282]]",368,519,741,519,887,2023,1109,1801,1650,1260,0.5670103092783505,0.3318304779080252,0.41488162344983087,0.6337123084527929,0.36628769154720714,0.5851183765501691,0.3687374749498998
0.505,2910,"[[368, 741], [519, 1282]]",368,519,741,519,887,2023,1109,1801,1650,1260,0.5670103092783505,0.3318304779080252,0.41488162344983087,0.6337123084527929,0.36628769154720714,0.5851183765501691,0.3687374749498998
0.506,2910,"[[367, 740], [520, 1283]]",367,520,740,520,887,2023,1107,1803,1650,1260,0.5670103092783505,0.33152664859981934,0.4137542277339346,0.634206623826001,0.365793376173999,0.5862457722660653,0.36810431293881646
0.507,2910,"[[366, 740], [521, 1283]]",366,521,740,521,887,2023,1106,1804,1649,1261,0.5666666666666667,0.3309222423146474,0.41262683201803835,0.634206623826001,0.365793376173999,0.5873731679819617,0.3672854992473658
0.508,2910,"[[365, 740], [522, 1283]]",365,522,740,522,887,2023,1105,1805,1648,1262,0.5663230240549828,0.33031674208144796,0.41149943630214203,0.634206623826001,0.365793376173999,0.588500563697858,0.36646586345381527
0.509,2910,"[[364, 738], [523, 1285]]",364,523,738,523,887,2023,1102,1808,1649,1261,0.5666666666666667,0.33030852994555354,0.41037204058624577,0.6351952545724172,0.3648047454275828,0.5896279594137542,0.3660130718954248
0.51,2910,"[[363, 738], [524, 1285]]",363,524,738,524,887,2023,1101,1809,1648,1262,0.5663230240549828,0.329700272479564,0.4092446448703495,0.6351952545724172,0.3648047454275828,0.5907553551296505,0.36519114688128773
0.511,2910,"[[363, 737], [524, 1286]]",363,524,737,524,887,2023,1100,1810,1649,1261,0.5666666666666667,0.33,0.4092446448703495,0.6356895699456253,0.3643104300543747,0.5907553551296505,0.36537493709109214
0.512,2910,"[[362, 737], [525, 1286]]",362,525,737,525,887,2023,1099,1811,1648,1262,0.5663230240549828,0.3293903548680619,0.4081172491544532,0.6356895699456253,0.3643104300543747,0.5918827508455468,0.36455186304128906
0.513,2910,"[[361, 737], [526, 1286]]",361,526,737,526,887,2023,1098,1812,1647,1263,0.565979381443299,0.32877959927140255,0.4069898534385569,0.6356895699456253,0.3643104300543747,0.593010146561443,0.363727959697733
0.514,2910,"[[361, 736], [526, 1287]]",361,526,736,526,887,2023,1097,1813,1648,1262,0.5663230240549828,0.3290793072014585,0.4069898534385569,0.6361838853188334,0.3638161146811666,0.593010146561443,0.3639112903225806
0.515,2910,"[[361, 733], [526, 1290]]",361,526,733,526,887,2023,1094,1816,1651,1259,0.5673539518900343,0.329981718464351,0.4069898534385569,0.6376668314384577,0.36233316856154224,0.593010146561443,0.3644623927309439
0.516,2910,"[[361, 733], [526, 1290]]",361,526,733,526,887,2023,1094,1816,1651,1259,0.5673539518900343,0.329981718464351,0.4069898534385569,0.6376668314384577,0.36233316856154224,0.593010146561443,0.3644623927309439
0.517,2910,"[[361, 730], [526, 1293]]",361,526,730,526,887,2023,1091,1819,1654,1256,0.5683848797250859,0.3308890925756187,0.4069898534385569,0.6391497775580821,0.36085022244191794,0.593010146561443,0.36501516683518703
0.518,2910,"[[361, 728], [526, 1295]]",361,526,728,526,887,2023,1089,1821,1656,1254,0.5690721649484536,0.3314967860422406,0.4069898534385569,0.6401384083044983,0.35986159169550175,0.593010146561443,0.3653846153846154
0.519,2910,"[[361, 727], [526, 1296]]",361,526,727,526,887,2023,1088,1822,1657,1253,0.5694158075601374,0.3318014705882353,0.4069898534385569,0.6406327236777064,0.35936727632229365,0.593010146561443,0.36556962025316453
0.52,2910,"[[359, 727], [528, 1296]]",359,528,727,528,887,2023,1086,1824,1655,1255,0.5687285223367697,0.3305709023941068,0.4047350620067644,0.6406327236777064,0.35936727632229365,0.5952649379932357,0.3639128231120121
0.521,2910,"[[359, 726], [528, 1297]]",359,528,726,528,887,2023,1085,1825,1656,1254,0.5690721649484536,0.33087557603686635,0.4047350620067644,0.6411270390509145,0.3588729609490855,0.5952649379932357,0.36409736308316437
0.522,2910,"[[359, 726], [528, 1297]]",359,528,726,528,887,2023,1085,1825,1656,1254,0.5690721649484536,0.33087557603686635,0.4047350620067644,0.6411270390509145,0.3588729609490855,0.5952649379932357,0.36409736308316437
0.523,2910,"[[359, 724], [528, 1299]]",359,528,724,528,887,2023,1083,1827,1658,1252,0.5697594501718213,0.3314866112650046,0.4047350620067644,0.6421156697973307,0.3578843302026693,0.5952649379932357,0.36446700507614216
0.524,2910,"[[359, 724], [528, 1299]]",359,528,724,528,887,2023,1083,1827,1658,1252,0.5697594501718213,0.3314866112650046,0.4047350620067644,0.6421156697973307,0.3578843302026693,0.5952649379932357,0.36446700507614216
0.525,2910,"[[359, 724], [528, 1299]]",359,528,724,528,887,2023,1083,1827,1658,1252,0.5697594501718213,0.3314866112650046,0.4047350620067644,0.6421156697973307,0.3578843302026693,0.5952649379932357,0.36446700507614216
0.526,2910,"[[359, 724], [528, 1299]]",359,528,724,528,887,2023,1083,1827,1658,1252,0.5697594501718213,0.3314866112650046,0.4047350620067644,0.6421156697973307,0.3578843302026693,0.5952649379932357,0.36446700507614216
0.527,2910,"[[358, 722], [529, 1301]]",358,529,722,529,887,2023,1080,1830,1659,1251,0.5701030927835051,0.3314814814814815,0.4036076662908681,0.6431043005437469,0.3568956994562531,0.5963923337091319,0.3640061006609049
0.528,2910,"[[357, 720], [530, 1303]]",357,530,720,530,887,2023,1077,1833,1660,1250,0.570446735395189,0.33147632311977715,0.4024802705749718,0.6440929312901631,0.35590706870983685,0.5975197294250282,0.36354378818737265
0.529,2910,"[[356, 720], [531, 1303]]",356,531,720,531,887,2023,1076,1834,1659,1251,0.5701030927835051,0.3308550185873606,0.40135287485907556,0.6440929312901631,0.35590706870983685,0.5986471251409244,0.3627101375445746
0.53,2910,"[[356, 719], [531, 1304]]",356,531,719,531,887,2023,1075,1835,1660,1250,0.570446735395189,0.3311627906976744,0.40135287485907556,0.6445872466633712,0.35541275333662875,0.5986471251409244,0.36289500509684
0.531,2910,"[[356, 719], [531, 1304]]",356,531,719,531,887,2023,1075,1835,1660,1250,0.570446735395189,0.3311627906976744,0.40135287485907556,0.6445872466633712,0.35541275333662875,0.5986471251409244,0.36289500509684
0.532,2910,"[[355, 718], [532, 1305]]",355,532,718,532,887,2023,1073,1837,1660,1250,0.570446735395189,0.33084808946877914,0.40022547914317924,0.6450815620365793,0.35491843796342065,0.5997745208568207,0.3622448979591837
0.533,2910,"[[355, 718], [532, 1305]]",355,532,718,532,887,2023,1073,1837,1660,1250,0.570446735395189,0.33084808946877914,0.40022547914317924,0.6450815620365793,0.35491843796342065,0.5997745208568207,0.3622448979591837
0.534,2910,"[[355, 716], [532, 1307]]",355,532,716,532,887,2023,1071,1839,1662,1248,0.5711340206185567,0.3314659197012138,0.40022547914317924,0.6460701927829956,0.35392980721700446,0.5997745208568207,0.3626149131767109
0.535,2910,"[[355, 716], [532, 1307]]",355,532,716,532,887,2023,1071,1839,1662,1248,0.5711340206185567,0.3314659197012138,0.40022547914317924,0.6460701927829956,0.35392980721700446,0.5997745208568207,0.3626149131767109
0.536,2910,"[[355, 716], [532, 1307]]",355,532,716,532,887,2023,1071,1839,1662,1248,0.5711340206185567,0.3314659197012138,0.40022547914317924,0.6460701927829956,0.35392980721700446,0.5997745208568207,0.3626149131767109
0.537,2910,"[[355, 715], [532, 1308]]",355,532,715,532,887,2023,1070,1840,1663,1247,0.5714776632302405,0.3317757009345794,0.40022547914317924,0.6465645081562037,0.35343549184379636,0.5997745208568207,0.36280020439448135
0.538,2910,"[[354, 715], [533, 1308]]",354,533,715,533,887,2023,1069,1841,1662,1248,0.5711340206185567,0.33115060804490176,0.399098083427283,0.6465645081562037,0.35343549184379636,0.6009019165727171,0.3619631901840491
0.539,2910,"[[354, 715], [533, 1308]]",354,533,715,533,887,2023,1069,1841,1662,1248,0.5711340206185567,0.33115060804490176,0.399098083427283,0.6465645081562037,0.35343549184379636,0.6009019165727171,0.3619631901840491
0.54,2910,"[[353, 712], [534, 1311]]",353,534,712,534,887,2023,1065,1845,1664,1246,0.5718213058419244,0.3314553990610329,0.3979706877113867,0.648047454275828,0.351952545724172,0.6020293122886133,0.3616803278688525
0.541,2910,"[[352, 712], [535, 1311]]",352,535,712,535,887,2023,1064,1846,1663,1247,0.5714776632302405,0.3308270676691729,0.3968432919954904,0.648047454275828,0.351952545724172,0.6031567080045096,0.3608405945668888
0.542,2910,"[[350, 711], [537, 1312]]",350,537,711,537,887,2023,1061,1849,1662,1248,0.5711340206185567,0.3298774740810556,0.3945885005636979,0.6485417696490361,0.3514582303509639,0.6054114994363021,0.35934291581108835
0.543,2910,"[[349, 710], [538, 1313]]",349,538,710,538,887,2023,1059,1851,1662,1248,0.5711340206185567,0.3295561850802644,0.39346110484780156,0.6490360850222442,0.3509639149777558,0.6065388951521984,0.35868448098663924
0.544,2910,"[[349, 709], [538, 1314]]",349,538,709,538,887,2023,1058,1852,1663,1247,0.5714776632302405,0.32986767485822305,0.39346110484780156,0.6495304003954523,0.3504695996045477,0.6065388951521984,0.3588688946015424
0.545,2910,"[[349, 709], [538, 1314]]",349,538,709,538,887,2023,1058,1852,1663,1247,0.5714776632302405,0.32986767485822305,0.39346110484780156,0.6495304003954523,0.3504695996045477,0.6065388951521984,0.3588688946015424
0.546,2910,"[[349, 709], [538, 1314]]",349,538,709,538,887,2023,1058,1852,1663,1247,0.5714776632302405,0.32986767485822305,0.39346110484780156,0.6495304003954523,0.3504695996045477,0.6065388951521984,0.3588688946015424
0.547,2910,"[[349, 709], [538, 1314]]",349,538,709,538,887,2023,1058,1852,1663,1247,0.5714776632302405,0.32986767485822305,0.39346110484780156,0.6495304003954523,0.3504695996045477,0.6065388951521984,0.3588688946015424
0.548,2910,"[[349, 709], [538, 1314]]",349,538,709,538,887,2023,1058,1852,1663,1247,0.5714776632302405,0.32986767485822305,0.39346110484780156,0.6495304003954523,0.3504695996045477,0.6065388951521984,0.3588688946015424
0.549,2910,"[[348, 709], [539, 1314]]",348,539,709,539,887,2023,1057,1853,1662,1248,0.5711340206185567,0.32923368022705773,0.3923337091319053,0.6495304003954523,0.3504695996045477,0.6076662908680946,0.3580246913580247
0.55,2910,"[[348, 709], [539, 1314]]",348,539,709,539,887,2023,1057,1853,1662,1248,0.5711340206185567,0.32923368022705773,0.3923337091319053,0.6495304003954523,0.3504695996045477,0.6076662908680946,0.3580246913580247
0.551,2910,"[[348, 709], [539, 1314]]",348,539,709,539,887,2023,1057,1853,1662,1248,0.5711340206185567,0.32923368022705773,0.3923337091319053,0.6495304003954523,0.3504695996045477,0.6076662908680946,0.3580246913580247
0.552,2910,"[[347, 707], [540, 1316]]",347,540,707,540,887,2023,1054,1856,1663,1247,0.5714776632302405,0.32922201138519924,0.39120631341600903,0.6505190311418685,0.3494809688581315,0.608793686583991,0.3575476558475013
0.553,2910,"[[347, 707], [540, 1316]]",347,540,707,540,887,2023,1054,1856,1663,1247,0.5714776632302405,0.32922201138519924,0.39120631341600903,0.6505190311418685,0.3494809688581315,0.608793686583991,0.3575476558475013
0.554,2910,"[[347, 706], [540, 1317]]",347,540,706,540,887,2023,1053,1857,1664,1246,0.5718213058419244,0.3295346628679962,0.39120631341600903,0.6510133465150766,0.34898665348492336,0.608793686583991,0.3577319587628866
0.555,2910,"[[347, 706], [540, 1317]]",347,540,706,540,887,2023,1053,1857,1664,1246,0.5718213058419244,0.3295346628679962,0.39120631341600903,0.6510133465150766,0.34898665348492336,0.608793686583991,0.3577319587628866
0.556,2910,"[[347, 704], [540, 1319]]",347,540,704,540,887,2023,1051,1859,1666,1244,0.5725085910652921,0.3301617507136061,0.39120631341600903,0.6520019772614928,0.34799802273850716,0.608793686583991,0.3581011351909184
0.557,2910,"[[347, 702], [540, 1321]]",347,540,702,540,887,2023,1049,1861,1668,1242,0.5731958762886598,0.330791229742612,0.39120631341600903,0.6529906080079091,0.34700939199209097,0.608793686583991,0.35847107438016534
0.558,2910,"[[346, 702], [541, 1321]]",346,541,702,541,887,2023,1048,1862,1667,1243,0.5728522336769759,0.3301526717557252,0.3900789177001127,0.6529906080079091,0.34700939199209097,0.6099210822998873,0.3576227390180878
0.559,2910,"[[346, 702], [541, 1321]]",346,541,702,541,887,2023,1048,1862,1667,1243,0.5728522336769759,0.3301526717557252,0.3900789177001127,0.6529906080079091,0.34700939199209097,0.6099210822998873,0.3576227390180878
0.56,2910,"[[346, 700], [541, 1323]]",346,541,700,541,887,2023,1046,1864,1669,1241,0.5735395189003436,0.33078393881453155,0.3900789177001127,0.6539792387543253,0.3460207612456747,0.6099210822998873,0.3579927573719607
0.561,2910,"[[346, 700], [541, 1323]]",346,541,700,541,887,2023,1046,1864,1669,1241,0.5735395189003436,0.33078393881453155,0.3900789177001127,0.6539792387543253,0.3460207612456747,0.6099210822998873,0.3579927573719607
0.562,2910,"[[345, 700], [542, 1323]]",345,542,700,542,887,2023,1045,1865,1668,1242,0.5731958762886598,0.33014354066985646,0.38895152198421645,0.6539792387543253,0.3460207612456747,0.6110484780157835,0.35714285714285715
0.563,2910,"[[345, 700], [542, 1323]]",345,542,700,542,887,2023,1045,1865,1668,1242,0.5731958762886598,0.33014354066985646,0.38895152198421645,0.6539792387543253,0.3460207612456747,0.6110484780157835,0.35714285714285715
0.564,2910,"[[345, 699], [542, 1324]]",345,542,699,542,887,2023,1044,1866,1669,1241,0.5735395189003436,0.33045977011494254,0.38895152198421645,0.6544735541275334,0.3455264458724666,0.6110484780157835,0.35732780942516834
0.565,2910,"[[345, 697], [542, 1326]]",345,542,697,542,887,2023,1042,1868,1671,1239,0.5742268041237113,0.3310940499040307,0.38895152198421645,0.6554621848739496,0.3445378151260504,0.6110484780157835,0.3576982892690513
0.566,2910,"[[345, 697], [542, 1326]]",345,542,697,542,887,2023,1042,1868,1671,1239,0.5742268041237113,0.3310940499040307,0.38895152198421645,0.6554621848739496,0.3445378151260504,0.6110484780157835,0.3576982892690513
0.567,2910,"[[345, 696], [542, 1327]]",345,542,696,542,887,2023,1041,1869,1672,1238,0.5745704467353951,0.3314121037463977,0.38895152198421645,0.6559565002471577,0.3440434997528423,0.6110484780157835,0.3578838174273859
0.568,2910,"[[344, 694], [543, 1329]]",344,543,694,543,887,2023,1038,1872,1673,1237,0.574914089347079,0.33140655105973027,0.3878241262683202,0.6569451309935739,0.3430548690064261,0.6121758737316798,0.3574025974025974
0.569,2910,"[[344, 694], [543, 1329]]",344,543,694,543,887,2023,1038,1872,1673,1237,0.574914089347079,0.33140655105973027,0.3878241262683202,0.6569451309935739,0.3430548690064261,0.6121758737316798,0.3574025974025974
0.57,2910,"[[344, 693], [543, 1330]]",344,543,693,543,887,2023,1037,1873,1674,1236,0.5752577319587628,0.3317261330761813,0.3878241262683202,0.657439446366782,0.34256055363321797,0.6121758737316798,0.35758835758835755
0.571,2910,"[[344, 692], [543, 1331]]",344,543,692,543,887,2023,1036,1874,1675,1235,0.5756013745704467,0.33204633204633205,0.3878241262683202,0.6579337617399901,0.34206623826000987,0.6121758737316798,0.35777431097243895
0.572,2910,"[[344, 692], [543, 1331]]",344,543,692,543,887,2023,1036,1874,1675,1235,0.5756013745704467,0.33204633204633205,0.3878241262683202,0.6579337617399901,0.34206623826000987,0.6121758737316798,0.35777431097243895
0.573,2910,"[[344, 692], [543, 1331]]",344,543,692,543,887,2023,1036,1874,1675,1235,0.5756013745704467,0.33204633204633205,0.3878241262683202,0.6579337617399901,0.34206623826000987,0.6121758737316798,0.35777431097243895
0.574,2910,"[[344, 692], [543, 1331]]",344,543,692,543,887,2023,1036,1874,1675,1235,0.5756013745704467,0.33204633204633205,0.3878241262683202,0.6579337617399901,0.34206623826000987,0.6121758737316798,0.35777431097243895
0.575,2910,"[[344, 691], [543, 1332]]",344,543,691,543,887,2023,1035,1875,1676,1234,0.5759450171821305,0.3323671497584541,0.3878241262683202,0.6584280771131982,0.34157192288680177,0.6121758737316798,0.35796045785639957
0.576,2910,"[[344, 689], [543, 1334]]",344,543,689,543,887,2023,1033,1877,1678,1232,0.5766323024054982,0.3330106485963214,0.3878241262683202,0.6594167078596145,0.3405832921403856,0.6121758737316798,0.3583333333333334
0.577,2910,"[[343, 689], [544, 1334]]",343,544,689,544,887,2023,1032,1878,1677,1233,0.5762886597938144,0.3323643410852713,0.38669673055242393,0.6594167078596145,0.3405832921403856,0.6133032694475761,0.3574778530484627
0.578,2910,"[[343, 689], [544, 1334]]",343,544,689,544,887,2023,1032,1878,1677,1233,0.5762886597938144,0.3323643410852713,0.38669673055242393,0.6594167078596145,0.3405832921403856,0.6133032694475761,0.3574778530484627
0.579,2910,"[[343, 687], [544, 1336]]",343,544,687,544,887,2023,1030,1880,1679,1231,0.5769759450171821,0.33300970873786406,0.38669673055242393,0.6604053386060307,0.3395946613939694,0.6133032694475761,0.3578508085550339
0.58,2910,"[[343, 686], [544, 1337]]",343,544,686,544,887,2023,1029,1881,1680,1230,0.5773195876288659,0.3333333333333333,0.38669673055242393,0.6608996539792388,0.3391003460207612,0.6133032694475761,0.3580375782881002
0.581,2910,"[[342, 685], [545, 1338]]",342,545,685,545,887,2023,1027,1883,1680,1230,0.5773195876288659,0.3330087633885102,0.3855693348365276,0.6613939693524469,0.3386060306475531,0.6144306651634723,0.3573667711598746
0.582,2910,"[[341, 684], [546, 1339]]",341,546,684,546,887,2023,1025,1885,1680,1230,0.5773195876288659,0.3326829268292683,0.38444193912063135,0.661888284725655,0.338111715274345,0.6155580608793687,0.3566945606694561
0.583,2910,"[[340, 684], [547, 1339]]",340,547,684,547,887,2023,1024,1886,1679,1231,0.5769759450171821,0.33203125,0.3833145434047351,0.661888284725655,0.338111715274345,0.616685456595265,0.35583464154892724
0.584,2910,"[[340, 684], [547, 1339]]",340,547,684,547,887,2023,1024,1886,1679,1231,0.5769759450171821,0.33203125,0.3833145434047351,0.661888284725655,0.338111715274345,0.616685456595265,0.35583464154892724
0.585,2910,"[[340, 684], [547, 1339]]",340,547,684,547,887,2023,1024,1886,1679,1231,0.5769759450171821,0.33203125,0.3833145434047351,0.661888284725655,0.338111715274345,0.616685456595265,0.35583464154892724
0.586,2910,"[[340, 682], [547, 1341]]",340,547,682,547,887,2023,1022,1888,1681,1229,0.5776632302405498,0.33268101761252444,0.3833145434047351,0.6628769154720712,0.33712308452792883,0.616685456595265,0.35620743844944996
0.587,2910,"[[339, 682], [548, 1341]]",339,548,682,548,887,2023,1021,1889,1680,1230,0.5773195876288659,0.33202742409402547,0.38218714768883877,0.6628769154720712,0.33712308452792883,0.6178128523111612,0.3553459119496855
0.588,2910,"[[339, 682], [548, 1341]]",339,548,682,548,887,2023,1021,1889,1680,1230,0.5773195876288659,0.33202742409402547,0.38218714768883877,0.6628769154720712,0.33712308452792883,0.6178128523111612,0.3553459119496855
0.589,2910,"[[337, 681], [550, 1342]]",337,550,681,550,887,2023,1018,1892,1679,1231,0.5769759450171821,0.33104125736738704,0.37993235625704624,0.6633712308452793,0.33662876915472073,0.6200676437429538,0.3538057742782152
0.59,2910,"[[335, 681], [552, 1342]]",335,552,681,552,887,2023,1016,1894,1677,1233,0.5762886597938144,0.3297244094488189,0.37767756482525366,0.6633712308452793,0.33662876915472073,0.6223224351747464,0.35207566999474516
0.591,2910,"[[335, 680], [552, 1343]]",335,552,680,552,887,2023,1015,1895,1678,1232,0.5766323024054982,0.33004926108374383,0.37767756482525366,0.6638655462184874,0.33613445378151263,0.6223224351747464,0.352260778128286
0.592,2910,"[[335, 680], [552, 1343]]",335,552,680,552,887,2023,1015,1895,1678,1232,0.5766323024054982,0.33004926108374383,0.37767756482525366,0.6638655462184874,0.33613445378151263,0.6223224351747464,0.352260778128286
0.593,2910,"[[335, 677], [552, 1346]]",335,552,677,552,887,2023,1012,1898,1681,1229,0.5776632302405498,0.3310276679841897,0.37767756482525366,0.6653484923381117,0.3346515076618883,0.6223224351747464,0.35281727224855186
0.594,2910,"[[335, 677], [552, 1346]]",335,552,677,552,887,2023,1012,1898,1681,1229,0.5776632302405498,0.3310276679841897,0.37767756482525366,0.6653484923381117,0.3346515076618883,0.6223224351747464,0.35281727224855186
0.595,2910,"[[335, 675], [552, 1348]]",335,552,675,552,887,2023,1010,1900,1683,1227,0.5783505154639176,0.3316831683168317,0.37767756482525366,0.666337123084528,0.3336628769154721,0.6223224351747464,0.3531892461781761
0.596,2910,"[[335, 675], [552, 1348]]",335,552,675,552,887,2023,1010,1900,1683,1227,0.5783505154639176,0.3316831683168317,0.37767756482525366,0.666337123084528,0.3336628769154721,0.6223224351747464,0.3531892461781761
0.597,2910,"[[335, 674], [552, 1349]]",335,552,674,552,887,2023,1009,1901,1684,1226,0.5786941580756014,0.33201189296333,0.37767756482525366,0.6668314384577361,0.333168561542264,0.6223224351747464,0.3533755274261603
0.598,2910,"[[335, 673], [552, 1350]]",335,552,673,552,887,2023,1008,1902,1685,1225,0.5790378006872853,0.3323412698412698,0.37767756482525366,0.6673257538309442,0.33267424616905583,0.6223224351747464,0.35356200527704484
0.599,2910,"[[335, 673], [552, 1350]]",335,552,673,552,887,2023,1008,1902,1685,1225,0.5790378006872853,0.3323412698412698,0.37767756482525366,0.6673257538309442,0.33267424616905583,0.6223224351747464,0.35356200527704484
0.6,2910,"[[335, 673], [552, 1350]]",335,552,673,552,887,2023,1008,1902,1685,1225,0.5790378006872853,0.3323412698412698,0.37767756482525366,0.6673257538309442,0.33267424616905583,0.6223224351747464,0.35356200527704484
0.601,2910,"[[335, 669], [552, 1354]]",335,552,669,552,887,2023,1004,1906,1689,1221,0.5804123711340207,0.3336653386454183,0.37767756482525366,0.6693030153237766,0.33069698467622344,0.6223224351747464,0.3543098889476467
0.602,2910,"[[335, 667], [552, 1356]]",335,552,667,552,887,2023,1002,1908,1691,1219,0.5810996563573884,0.3343313373253493,0.37767756482525366,0.6702916460701928,0.32970835392980724,0.6223224351747464,0.35468501852832185
0.603,2910,"[[335, 667], [552, 1356]]",335,552,667,552,887,2023,1002,1908,1691,1219,0.5810996563573884,0.3343313373253493,0.37767756482525366,0.6702916460701928,0.32970835392980724,0.6223224351747464,0.35468501852832185
0.604,2910,"[[335, 667], [552, 1356]]",335,552,667,552,887,2023,1002,1908,1691,1219,0.5810996563573884,0.3343313373253493,0.37767756482525366,0.6702916460701928,0.32970835392980724,0.6223224351747464,0.35468501852832185
0.605,2910,"[[335, 666], [552, 1357]]",335,552,666,552,887,2023,1001,1909,1692,1218,0.5814432989690722,0.33466533466533466,0.37767756482525366,0.6707859614434009,0.3292140385565991,0.6223224351747464,0.35487288135593226
0.606,2910,"[[334, 666], [553, 1357]]",334,553,666,553,887,2023,1000,1910,1691,1219,0.5810996563573884,0.334,0.3765501691093574,0.6707859614434009,0.3292140385565991,0.6234498308906427,0.35400105988341285
0.607,2910,"[[334, 665], [553, 1358]]",334,553,665,553,887,2023,999,1911,1692,1218,0.5814432989690722,0.33433433433433435,0.3765501691093574,0.671280276816609,0.328719723183391,0.6234498308906427,0.3541887592788972
0.608,2910,"[[334, 664], [553, 1359]]",334,553,664,553,887,2023,998,1912,1693,1217,0.5817869415807561,0.3346693386773547,0.3765501691093574,0.671774592189817,0.3282254078101829,0.6234498308906427,0.3543766578249337
0.609,2910,"[[334, 664], [553, 1359]]",334,553,664,553,887,2023,998,1912,1693,1217,0.5817869415807561,0.3346693386773547,0.3765501691093574,0.671774592189817,0.3282254078101829,0.6234498308906427,0.3543766578249337
0.61,2910,"[[334, 664], [553, 1359]]",334,553,664,553,887,2023,998,1912,1693,1217,0.5817869415807561,0.3346693386773547,0.3765501691093574,0.671774592189817,0.3282254078101829,0.6234498308906427,0.3543766578249337
0.611,2910,"[[333, 664], [554, 1359]]",333,554,664,554,887,2023,997,1913,1692,1218,0.5814432989690722,0.3340020060180542,0.3754227733934611,0.671774592189817,0.3282254078101829,0.6245772266065389,0.3535031847133758
0.612,2910,"[[332, 663], [555, 1360]]",332,555,663,555,887,2023,995,1915,1692,1218,0.5814432989690722,0.3336683417085427,0.3742953776775648,0.6722689075630253,0.3277310924369748,0.6257046223224352,0.3528161530286929
0.613,2910,"[[331, 662], [556, 1361]]",331,556,662,556,887,2023,993,1917,1692,1218,0.5814432989690722,0.3333333333333333,0.37316798196166856,0.6727632229362334,0.3272367770637667,0.6268320180383314,0.35212765957446807
0.614,2910,"[[331, 662], [556, 1361]]",331,556,662,556,887,2023,993,1917,1692,1218,0.5814432989690722,0.3333333333333333,0.37316798196166856,0.6727632229362334,0.3272367770637667,0.6268320180383314,0.35212765957446807
0.615,2910,"[[331, 660], [556, 1363]]",331,556,660,556,887,2023,991,1919,1694,1216,0.5821305841924399,0.3340060544904137,0.37316798196166856,0.6737518536826496,0.3262481463173505,0.6268320180383314,0.35250266240681577
0.616,2910,"[[331, 660], [556, 1363]]",331,556,660,556,887,2023,991,1919,1694,1216,0.5821305841924399,0.3340060544904137,0.37316798196166856,0.6737518536826496,0.3262481463173505,0.6268320180383314,0.35250266240681577
0.617,2910,"[[331, 660], [556, 1363]]",331,556,660,556,887,2023,991,1919,1694,1216,0.5821305841924399,0.3340060544904137,0.37316798196166856,0.6737518536826496,0.3262481463173505,0.6268320180383314,0.35250266240681577
0.618,2910,"[[329, 660], [558, 1363]]",329,558,660,558,887,2023,989,1921,1692,1218,0.5814432989690722,0.3326592517694641,0.370913190529876,0.6737518536826496,0.3262481463173505,0.629086809470124,0.3507462686567164
0.619,2910,"[[327, 660], [560, 1363]]",327,560,660,560,887,2023,987,1923,1690,1220,0.5807560137457045,0.331306990881459,0.3686583990980834,0.6737518536826496,0.3262481463173505,0.6313416009019166,0.3489861259338314
0.62,2910,"[[327, 660], [560, 1363]]",327,560,660,560,887,2023,987,1923,1690,1220,0.5807560137457045,0.331306990881459,0.3686583990980834,0.6737518536826496,0.3262481463173505,0.6313416009019166,0.3489861259338314
0.621,2910,"[[327, 660], [560, 1363]]",327,560,660,560,887,2023,987,1923,1690,1220,0.5807560137457045,0.331306990881459,0.3686583990980834,0.6737518536826496,0.3262481463173505,0.6313416009019166,0.3489861259338314
0.622,2910,"[[327, 659], [560, 1364]]",327,560,659,560,887,2023,986,1924,1691,1219,0.5810996563573884,0.3316430020283976,0.3686583990980834,0.6742461690558577,0.32575383094414234,0.6313416009019166,0.3491724506139882
0.623,2910,"[[327, 659], [560, 1364]]",327,560,659,560,887,2023,986,1924,1691,1219,0.5810996563573884,0.3316430020283976,0.3686583990980834,0.6742461690558577,0.32575383094414234,0.6313416009019166,0.3491724506139882
0.624,2910,"[[327, 659], [560, 1364]]",327,560,659,560,887,2023,986,1924,1691,1219,0.5810996563573884,0.3316430020283976,0.3686583990980834,0.6742461690558577,0.32575383094414234,0.6313416009019166,0.3491724506139882
0.625,2910,"[[325, 658], [562, 1365]]",325,562,658,562,887,2023,983,1927,1690,1220,0.5807560137457045,0.3306205493387589,0.3664036076662909,0.6747404844290658,0.32525951557093424,0.6335963923337091,0.3475935828877006
0.626,2910,"[[324, 658], [563, 1365]]",324,563,658,563,887,2023,982,1928,1689,1221,0.5804123711340207,0.329938900203666,0.3652762119503946,0.6747404844290658,0.32525951557093424,0.6347237880496054,0.34670947030497595
0.627,2910,"[[324, 658], [563, 1365]]",324,563,658,563,887,2023,982,1928,1689,1221,0.5804123711340207,0.329938900203666,0.3652762119503946,0.6747404844290658,0.32525951557093424,0.6347237880496054,0.34670947030497595
0.628,2910,"[[323, 658], [564, 1365]]",323,564,658,564,887,2023,981,1929,1688,1222,0.5800687285223368,0.3292558613659531,0.3641488162344983,0.6747404844290658,0.32525951557093424,0.6358511837655016,0.3458244111349036
0.629,2910,"[[323, 657], [564, 1366]]",323,564,657,564,887,2023,980,1930,1689,1221,0.5804123711340207,0.3295918367346939,0.3641488162344983,0.6752347998022739,0.32476520019772614,0.6358511837655016,0.3460096411355115
0.63,2910,"[[318, 656], [569, 1367]]",318,569,656,569,887,2023,974,1936,1685,1225,0.5790378006872853,0.3264887063655031,0.35851183765501693,0.675729115175482,0.32427088482451805,0.6414881623449831,0.34175174637291783
0.631,2910,"[[318, 655], [569, 1368]]",318,569,655,569,887,2023,973,1937,1686,1224,0.5793814432989691,0.32682425488180883,0.35851183765501693,0.67622343054869,0.32377656945130995,0.6414881623449831,0.3419354838709678
0.632,2910,"[[317, 655], [570, 1368]]",317,570,655,570,887,2023,972,1938,1685,1225,0.5790378006872853,0.32613168724279834,0.3573844419391206,0.67622343054869,0.32377656945130995,0.6426155580608793,0.3410435718128026
0.633,2910,"[[317, 652], [570, 1371]]",317,570,652,570,887,2023,969,1941,1688,1222,0.5800687285223368,0.32714138286893707,0.3573844419391206,0.6777063766683143,0.3222936233316856,0.6426155580608793,0.3415948275862069
0.634,2910,"[[317, 652], [570, 1371]]",317,570,652,570,887,2023,969,1941,1688,1222,0.5800687285223368,0.32714138286893707,0.3573844419391206,0.6777063766683143,0.3222936233316856,0.6426155580608793,0.3415948275862069
0.635,2910,"[[315, 651], [572, 1372]]",315,572,651,572,887,2023,966,1944,1687,1223,0.579725085910653,0.32608695652173914,0.3551296505073281,0.6782006920415224,0.3217993079584775,0.644870349492672,0.339989206691851
0.636,2910,"[[315, 650], [572, 1373]]",315,572,650,572,887,2023,965,1945,1688,1222,0.5800687285223368,0.32642487046632124,0.3551296505073281,0.6786950074147305,0.3213049925852694,0.644870349492672,0.34017278617710583
0.637,2910,"[[315, 650], [572, 1373]]",315,572,650,572,887,2023,965,1945,1688,1222,0.5800687285223368,0.32642487046632124,0.3551296505073281,0.6786950074147305,0.3213049925852694,0.644870349492672,0.34017278617710583
0.638,2910,"[[315, 649], [572, 1374]]",315,572,649,572,887,2023,964,1946,1689,1221,0.5804123711340207,0.32676348547717843,0.3551296505073281,0.6791893227879388,0.3208106772120613,0.644870349492672,0.34035656401944897
0.639,2910,"[[315, 649], [572, 1374]]",315,572,649,572,887,2023,964,1946,1689,1221,0.5804123711340207,0.32676348547717843,0.3551296505073281,0.6791893227879388,0.3208106772120613,0.644870349492672,0.34035656401944897
0.64,2910,"[[315, 649], [572, 1374]]",315,572,649,572,887,2023,964,1946,1689,1221,0.5804123711340207,0.32676348547717843,0.3551296505073281,0.6791893227879388,0.3208106772120613,0.644870349492672,0.34035656401944897
0.641,2910,"[[314, 648], [573, 1375]]",314,573,648,573,887,2023,962,1948,1689,1221,0.5804123711340207,0.3264033264033264,0.35400225479143177,0.6796836381611469,0.3203163618388532,0.6459977452085682,0.33964305029745806
0.642,2910,"[[314, 648], [573, 1375]]",314,573,648,573,887,2023,962,1948,1689,1221,0.5804123711340207,0.3264033264033264,0.35400225479143177,0.6796836381611469,0.3203163618388532,0.6459977452085682,0.33964305029745806
0.643,2910,"[[313, 646], [574, 1377]]",313,574,646,574,887,2023,959,1951,1690,1220,0.5807560137457045,0.32638164754953075,0.3528748590755355,0.680672268907563,0.31932773109243695,0.6471251409244645,0.3391115926327194
0.644,2910,"[[311, 645], [576, 1378]]",311,576,645,576,887,2023,956,1954,1689,1221,0.5804123711340207,0.3253138075313807,0.3506200676437429,0.6811665842807711,0.31883341571922885,0.649379932356257,0.3374932175800326
0.645,2910,"[[310, 645], [577, 1378]]",310,577,645,577,887,2023,955,1955,1688,1222,0.5800687285223368,0.32460732984293195,0.34949267192784667,0.6811665842807711,0.31883341571922885,0.6505073280721533,0.3365906623235614
0.646,2910,"[[310, 644], [577, 1379]]",310,577,644,577,887,2023,954,1956,1689,1221,0.5804123711340207,0.3249475890985325,0.34949267192784667,0.6816608996539792,0.31833910034602075,0.6505073280721533,0.33677349266702883
0.647,2910,"[[309, 644], [578, 1379]]",309,578,644,578,887,2023,953,1957,1688,1222,0.5800687285223368,0.3242392444910808,0.3483652762119504,0.6816608996539792,0.31833910034602075,0.6516347237880497,0.3358695652173913
0.648,2910,"[[309, 642], [578, 1381]]",309,578,642,578,887,2023,951,1959,1690,1220,0.5807560137457045,0.3249211356466877,0.3483652762119504,0.6826495304003954,0.31735046959960456,0.6516347237880497,0.33623503808487487
0.649,2910,"[[309, 642], [578, 1381]]",309,578,642,578,887,2023,951,1959,1690,1220,0.5807560137457045,0.3249211356466877,0.3483652762119504,0.6826495304003954,0.31735046959960456,0.6516347237880497,0.33623503808487487
0.65,2910,"[[309, 641], [578, 1382]]",309,578,641,578,887,2023,950,1960,1691,1219,0.5810996563573884,0.32526315789473687,0.3483652762119504,0.6831438457736035,0.31685615422639646,0.6516347237880497,0.3364180729450191
0.651,2910,"[[309, 641], [578, 1382]]",309,578,641,578,887,2023,950,1960,1691,1219,0.5810996563573884,0.32526315789473687,0.3483652762119504,0.6831438457736035,0.31685615422639646,0.6516347237880497,0.3364180729450191
0.652,2910,"[[307, 641], [580, 1382]]",307,580,641,580,887,2023,948,1962,1689,1221,0.5804123711340207,0.32383966244725737,0.3461104847801578,0.6831438457736035,0.31685615422639646,0.6538895152198422,0.3346049046321526
0.653,2910,"[[307, 641], [580, 1382]]",307,580,641,580,887,2023,948,1962,1689,1221,0.5804123711340207,0.32383966244725737,0.3461104847801578,0.6831438457736035,0.31685615422639646,0.6538895152198422,0.3346049046321526
0.654,2910,"[[307, 641], [580, 1382]]",307,580,641,580,887,2023,948,1962,1689,1221,0.5804123711340207,0.32383966244725737,0.3461104847801578,0.6831438457736035,0.31685615422639646,0.6538895152198422,0.3346049046321526
0.655,2910,"[[307, 638], [580, 1385]]",307,580,638,580,887,2023,945,1965,1692,1218,0.5814432989690722,0.32486772486772486,0.3461104847801578,0.6846267918932278,0.3153732081067721,0.6538895152198422,0.3351528384279476
0.656,2910,"[[307, 637], [580, 1386]]",307,580,637,580,887,2023,944,1966,1693,1217,0.5817869415807561,0.3252118644067797,0.3461104847801578,0.6851211072664359,0.314878892733564,0.6538895152198422,0.3353358820316767
0.657,2910,"[[306, 636], [581, 1387]]",306,581,636,581,887,2023,942,1968,1693,1217,0.5817869415807561,0.3248407643312102,0.34498308906426156,0.6856154226396441,0.3143845773603559,0.6550169109357384,0.33460907599781303
0.658,2910,"[[305, 635], [582, 1388]]",305,582,635,582,887,2023,940,1970,1693,1217,0.5817869415807561,0.324468085106383,0.3438556933483653,0.6861097380128522,0.3138902619871478,0.6561443066516347,0.33388067870826493
0.659,2910,"[[304, 635], [583, 1388]]",304,583,635,583,887,2023,939,1971,1692,1218,0.5814432989690722,0.32374866879659214,0.342728297632469,0.6861097380128522,0.3138902619871478,0.657271702367531,0.3329682365826944
0.66,2910,"[[304, 635], [583, 1388]]",304,583,635,583,887,2023,939,1971,1692,1218,0.5814432989690722,0.32374866879659214,0.342728297632469,0.6861097380128522,0.3138902619871478,0.657271702367531,0.3329682365826944
0.661,2910,"[[303, 632], [584, 1391]]",303,584,632,584,887,2023,935,1975,1694,1216,0.5821305841924399,0.3240641711229946,0.3416009019165727,0.6875926841324765,0.31240731586752346,0.6583990980834273,0.33260153677277715
0.662,2910,"[[303, 632], [584, 1391]]",303,584,632,584,887,2023,935,1975,1694,1216,0.5821305841924399,0.3240641711229946,0.3416009019165727,0.6875926841324765,0.31240731586752346,0.6583990980834273,0.33260153677277715
0.663,2910,"[[303, 632], [584, 1391]]",303,584,632,584,887,2023,935,1975,1694,1216,0.5821305841924399,0.3240641711229946,0.3416009019165727,0.6875926841324765,0.31240731586752346,0.6583990980834273,0.33260153677277715
0.664,2910,"[[302, 632], [585, 1391]]",302,585,632,585,887,2023,934,1976,1693,1217,0.5817869415807561,0.3233404710920771,0.34047350620067646,0.6875926841324765,0.31240731586752346,0.6595264937993236,0.33168588687534317
0.665,2910,"[[301, 629], [586, 1394]]",301,586,629,586,887,2023,930,1980,1695,1215,0.5824742268041238,0.32365591397849464,0.33934611048478014,0.6890756302521008,0.31092436974789917,0.6606538895152199,0.33131535498073744
0.666,2910,"[[301, 629], [586, 1394]]",301,586,629,586,887,2023,930,1980,1695,1215,0.5824742268041238,0.32365591397849464,0.33934611048478014,0.6890756302521008,0.31092436974789917,0.6606538895152199,0.33131535498073744
0.667,2910,"[[300, 629], [587, 1394]]",300,587,629,587,887,2023,929,1981,1694,1216,0.5821305841924399,0.32292787944025836,0.3382187147688839,0.6890756302521008,0.31092436974789917,0.6617812852311161,0.3303964757709251
0.668,2910,"[[300, 627], [587, 1396]]",300,587,627,587,887,2023,927,1983,1696,1214,0.5828178694158076,0.32362459546925565,0.3382187147688839,0.690064260998517,0.30993573900148297,0.6617812852311161,0.33076074972436603
0.669,2910,"[[300, 627], [587, 1396]]",300,587,627,587,887,2023,927,1983,1696,1214,0.5828178694158076,0.32362459546925565,0.3382187147688839,0.690064260998517,0.30993573900148297,0.6617812852311161,0.33076074972436603
0.67,2910,"[[300, 627], [587, 1396]]",300,587,627,587,887,2023,927,1983,1696,1214,0.5828178694158076,0.32362459546925565,0.3382187147688839,0.690064260998517,0.30993573900148297,0.6617812852311161,0.33076074972436603
0.671,2910,"[[300, 627], [587, 1396]]",300,587,627,587,887,2023,927,1983,1696,1214,0.5828178694158076,0.32362459546925565,0.3382187147688839,0.690064260998517,0.30993573900148297,0.6617812852311161,0.33076074972436603
0.672,2910,"[[298, 625], [589, 1398]]",298,589,625,589,887,2023,923,1987,1696,1214,0.5828178694158076,0.3228602383531961,0.3359639233370913,0.6910528917449332,0.3089471082550667,0.6640360766629086,0.3292817679558011
0.673,2910,"[[298, 624], [589, 1399]]",298,589,624,589,887,2023,922,1988,1697,1213,0.5831615120274914,0.3232104121475054,0.3359639233370913,0.6915472071181413,0.3084527928818586,0.6640360766629086,0.3294637921503593
0.674,2910,"[[298, 623], [589, 1400]]",298,589,623,589,887,2023,921,1989,1698,1212,0.5835051546391753,0.32356134636264927,0.3359639233370913,0.6920415224913494,0.3079584775086505,0.6640360766629086,0.32964601769911506
0.675,2910,"[[297, 622], [590, 1401]]",297,590,622,590,887,2023,919,1991,1698,1212,0.5835051546391753,0.32317736670293795,0.33483652762119503,0.6925358378645576,0.3074641621354424,0.6651634723788049,0.3289036544850499
0.676,2910,"[[295, 622], [592, 1401]]",295,592,622,592,887,2023,917,1993,1696,1214,0.5828178694158076,0.321701199563795,0.33258173618940245,0.6925358378645576,0.3074641621354424,0.6674182638105975,0.32705099778270513
0.677,2910,"[[295, 620], [592, 1403]]",295,592,620,592,887,2023,915,1995,1698,1212,0.5835051546391753,0.3224043715846995,0.33258173618940245,0.6935244686109738,0.3064755313890262,0.6674182638105975,0.3274139844617092
0.678,2910,"[[295, 619], [592, 1404]]",295,592,619,592,887,2023,914,1996,1699,1211,0.5838487972508591,0.3227571115973742,0.33258173618940245,0.6940187839841819,0.30598121601581807,0.6674182638105975,0.32759578012215435
0.679,2910,"[[295, 619], [592, 1404]]",295,592,619,592,887,2023,914,1996,1699,1211,0.5838487972508591,0.3227571115973742,0.33258173618940245,0.6940187839841819,0.30598121601581807,0.6674182638105975,0.32759578012215435
0.68,2910,"[[295, 619], [592, 1404]]",295,592,619,592,887,2023,914,1996,1699,1211,0.5838487972508591,0.3227571115973742,0.33258173618940245,0.6940187839841819,0.30598121601581807,0.6674182638105975,0.32759578012215435
0.681,2910,"[[295, 618], [592, 1405]]",295,592,618,592,887,2023,913,1997,1700,1210,0.584192439862543,0.3231106243154436,0.33258173618940245,0.69451309935739,0.30548690064260997,0.6674182638105975,0.3277777777777777
0.682,2910,"[[295, 618], [592, 1405]]",295,592,618,592,887,2023,913,1997,1700,1210,0.584192439862543,0.3231106243154436,0.33258173618940245,0.69451309935739,0.30548690064260997,0.6674182638105975,0.3277777777777777
0.683,2910,"[[292, 614], [595, 1409]]",292,595,614,595,887,2023,906,2004,1701,1209,0.5845360824742268,0.32229580573951433,0.32919954904171367,0.6964903608502224,0.3035096391497776,0.6708004509582863,0.3257110987172337
0.684,2910,"[[292, 614], [595, 1409]]",292,595,614,595,887,2023,906,2004,1701,1209,0.5845360824742268,0.32229580573951433,0.32919954904171367,0.6964903608502224,0.3035096391497776,0.6708004509582863,0.3257110987172337
0.685,2910,"[[292, 612], [595, 1411]]",292,595,612,595,887,2023,904,2006,1703,1207,0.5852233676975945,0.3230088495575221,0.32919954904171367,0.6974789915966386,0.3025210084033613,0.6708004509582863,0.32607481853713016
0.686,2910,"[[292, 612], [595, 1411]]",292,595,612,595,887,2023,904,2006,1703,1207,0.5852233676975945,0.3230088495575221,0.32919954904171367,0.6974789915966386,0.3025210084033613,0.6708004509582863,0.32607481853713016
0.687,2910,"[[290, 611], [597, 1412]]",290,597,611,597,887,2023,901,2009,1702,1208,0.5848797250859107,0.3218645948945616,0.3269447576099211,0.6979733069698467,0.3020266930301532,0.673055242390079,0.3243847874720358
0.688,2910,"[[289, 609], [598, 1414]]",289,598,609,598,887,2023,898,2012,1703,1207,0.5852233676975945,0.321826280623608,0.3258173618940248,0.698961937716263,0.30103806228373703,0.6741826381059752,0.3238095238095238
0.689,2910,"[[289, 606], [598, 1417]]",289,598,606,598,887,2023,895,2015,1706,1204,0.5862542955326461,0.3229050279329609,0.3258173618940248,0.7004448838358873,0.2995551161641127,0.6741826381059752,0.32435465768799104
0.69,2910,"[[289, 606], [598, 1417]]",289,598,606,598,887,2023,895,2015,1706,1204,0.5862542955326461,0.3229050279329609,0.3258173618940248,0.7004448838358873,0.2995551161641127,0.6741826381059752,0.32435465768799104
0.691,2910,"[[289, 606], [598, 1417]]",289,598,606,598,887,2023,895,2015,1706,1204,0.5862542955326461,0.3229050279329609,0.3258173618940248,0.7004448838358873,0.2995551161641127,0.6741826381059752,0.32435465768799104
0.692,2910,"[[288, 606], [599, 1417]]",288,599,606,599,887,2023,894,2016,1705,1205,0.5859106529209622,0.3221476510067114,0.3246899661781285,0.7004448838358873,0.2995551161641127,0.6753100338218715,0.32341381246490736
0.693,2910,"[[288, 605], [599, 1418]]",288,599,605,599,887,2023,893,2017,1706,1204,0.5862542955326461,0.322508398656215,0.3246899661781285,0.7009391992090954,0.2990608007909046,0.6753100338218715,0.3235955056179775
0.694,2910,"[[288, 604], [599, 1419]]",288,599,604,599,887,2023,892,2018,1707,1203,0.5865979381443299,0.32286995515695066,0.3246899661781285,0.7014335145823035,0.2985664854176965,0.6753100338218715,0.32377740303541314
0.695,2910,"[[288, 602], [599, 1421]]",288,599,602,599,887,2023,890,2020,1709,1201,0.5872852233676976,0.3235955056179775,0.3246899661781285,0.7024221453287197,0.2975778546712803,0.6753100338218715,0.32414181204276876
0.696,2910,"[[288, 602], [599, 1421]]",288,599,602,599,887,2023,890,2020,1709,1201,0.5872852233676976,0.3235955056179775,0.3246899661781285,0.7024221453287197,0.2975778546712803,0.6753100338218715,0.32414181204276876
0.697,2910,"[[288, 601], [599, 1422]]",288,599,601,599,887,2023,889,2021,1710,1200,0.5876288659793815,0.32395950506186727,0.3246899661781285,0.7029164607019278,0.2970835392980722,0.6753100338218715,0.32432432432432434
0.698,2910,"[[288, 600], [599, 1423]]",288,599,600,599,887,2023,888,2022,1711,1199,0.5879725085910653,0.32432432432432434,0.3246899661781285,0.7034107760751359,0.2965892239248641,0.6753100338218715,0.32450704225352117
0.699,2910,"[[288, 600], [599, 1423]]",288,599,600,599,887,2023,888,2022,1711,1199,0.5879725085910653,0.32432432432432434,0.3246899661781285,0.7034107760751359,0.2965892239248641,0.6753100338218715,0.32450704225352117
0.7,2910,"[[286, 600], [601, 1423]]",286,601,600,601,887,2023,886,2024,1709,1201,0.5872852233676976,0.3227990970654628,0.322435174746336,0.7034107760751359,0.2965892239248641,0.677564825253664,0.3226170332769318
0.701,2910,"[[286, 600], [601, 1423]]",286,601,600,601,887,2023,886,2024,1709,1201,0.5872852233676976,0.3227990970654628,0.322435174746336,0.7034107760751359,0.2965892239248641,0.677564825253664,0.3226170332769318
0.702,2910,"[[286, 599], [601, 1424]]",286,601,599,601,887,2023,885,2025,1710,1200,0.5876288659793815,0.3231638418079096,0.322435174746336,0.703905091448344,0.29609490855165593,0.677564825253664,0.3227990970654627
0.703,2910,"[[286, 596], [601, 1427]]",286,601,596,601,887,2023,882,2028,1713,1197,0.588659793814433,0.3242630385487528,0.322435174746336,0.7053880375679684,0.29461196243203164,0.677564825253664,0.3233465234595817
0.704,2910,"[[286, 596], [601, 1427]]",286,601,596,601,887,2023,882,2028,1713,1197,0.588659793814433,0.3242630385487528,0.322435174746336,0.7053880375679684,0.29461196243203164,0.677564825253664,0.3233465234595817
0.705,2910,"[[285, 595], [602, 1428]]",285,602,595,602,887,2023,880,2030,1713,1197,0.588659793814433,0.32386363636363635,0.32130777903043967,0.7058823529411765,0.29411764705882354,0.6786922209695603,0.32258064516129037
0.706,2910,"[[285, 593], [602, 1430]]",285,602,593,602,887,2023,878,2032,1715,1195,0.5893470790378007,0.3246013667425968,0.32130777903043967,0.7068709836875927,0.29312901631240734,0.6786922209695603,0.3229461756373938
0.707,2910,"[[285, 591], [602, 1432]]",285,602,591,602,887,2023,876,2034,1717,1193,0.5900343642611684,0.3253424657534247,0.32130777903043967,0.7078596144340089,0.2921403855659911,0.6786922209695603,0.3233125354509359
0.708,2910,"[[284, 591], [603, 1432]]",284,603,591,603,887,2023,875,2035,1716,1194,0.5896907216494846,0.32457142857142857,0.3201803833145434,0.7078596144340089,0.2921403855659911,0.6798196166854565,0.322360953461975
0.709,2910,"[[283, 590], [604, 1433]]",283,604,590,604,887,2023,873,2037,1716,1194,0.5896907216494846,0.3241695303550974,0.31905298759864714,0.708353929807217,0.291646070192783,0.6809470124013529,0.3215909090909091
0.71,2910,"[[283, 589], [604, 1434]]",283,604,589,604,887,2023,872,2038,1717,1193,0.5900343642611684,0.32454128440366975,0.31905298759864714,0.7088482451804251,0.2911517548195749,0.6809470124013529,0.32177373507674817
0.711,2910,"[[282, 589], [605, 1434]]",282,605,589,605,887,2023,871,2039,1716,1194,0.5896907216494846,0.3237657864523536,0.3179255918827508,0.7088482451804251,0.2911517548195749,0.6820744081172492,0.32081911262798635
0.712,2910,"[[282, 589], [605, 1434]]",282,605,589,605,887,2023,871,2039,1716,1194,0.5896907216494846,0.3237657864523536,0.3179255918827508,0.7088482451804251,0.2911517548195749,0.6820744081172492,0.32081911262798635
0.713,2910,"[[281, 589], [606, 1434]]",281,606,589,606,887,2023,870,2040,1715,1195,0.5893470790378007,0.32298850574712645,0.31679819616685456,0.7088482451804251,0.2911517548195749,0.6832018038331454,0.3198634035287422
0.714,2910,"[[281, 589], [606, 1434]]",281,606,589,606,887,2023,870,2040,1715,1195,0.5893470790378007,0.32298850574712645,0.31679819616685456,0.7088482451804251,0.2911517548195749,0.6832018038331454,0.3198634035287422
0.715,2910,"[[280, 589], [607, 1434]]",280,607,589,607,887,2023,869,2041,1714,1196,0.5890034364261169,0.3222094361334868,0.3156708004509583,0.7088482451804251,0.2911517548195749,0.6843291995490417,0.31890660592255127
0.716,2910,"[[280, 589], [607, 1434]]",280,607,589,607,887,2023,869,2041,1714,1196,0.5890034364261169,0.3222094361334868,0.3156708004509583,0.7088482451804251,0.2911517548195749,0.6843291995490417,0.31890660592255127
0.717,2910,"[[280, 588], [607, 1435]]",280,607,588,607,887,2023,868,2042,1715,1195,0.5893470790378007,0.3225806451612903,0.3156708004509583,0.7093425605536332,0.2906574394463668,0.6843291995490417,0.3190883190883191
0.718,2910,"[[278, 587], [609, 1436]]",278,609,587,609,887,2023,865,2045,1714,1196,0.5890034364261169,0.3213872832369942,0.3134160090191657,0.7098368759268413,0.2901631240731587,0.6865839909808342,0.317351598173516
0.719,2910,"[[278, 585], [609, 1438]]",278,609,585,609,887,2023,863,2047,1716,1194,0.5896907216494846,0.32213209733487835,0.3134160090191657,0.7108255066732575,0.28917449332674244,0.6865839909808342,0.3177142857142858
0.72,2910,"[[278, 584], [609, 1439]]",278,609,584,609,887,2023,862,2048,1717,1193,0.5900343642611684,0.3225058004640371,0.3134160090191657,0.7113198220464656,0.28868017795353434,0.6865839909808342,0.3178959405374499
0.721,2910,"[[278, 584], [609, 1439]]",278,609,584,609,887,2023,862,2048,1717,1193,0.5900343642611684,0.3225058004640371,0.3134160090191657,0.7113198220464656,0.28868017795353434,0.6865839909808342,0.3178959405374499
0.722,2910,"[[278, 583], [609, 1440]]",278,609,583,609,887,2023,861,2049,1718,1192,0.5903780068728522,0.3228803716608595,0.3134160090191657,0.7118141374196737,0.28818586258032625,0.6865839909808342,0.3180778032036613
0.723,2910,"[[278, 583], [609, 1440]]",278,609,583,609,887,2023,861,2049,1718,1192,0.5903780068728522,0.3228803716608595,0.3134160090191657,0.7118141374196737,0.28818586258032625,0.6865839909808342,0.3180778032036613
0.724,2910,"[[278, 582], [609, 1441]]",278,609,582,609,887,2023,860,2050,1719,1191,0.5907216494845361,0.32325581395348835,0.3134160090191657,0.7123084527928819,0.28769154720711815,0.6865839909808342,0.318259874069834
0.725,2910,"[[278, 581], [609, 1442]]",278,609,581,609,887,2023,859,2051,1720,1190,0.5910652920962199,0.32363213038416766,0.3134160090191657,0.71280276816609,0.28719723183391005,0.6865839909808342,0.31844215349369986
0.726,2910,"[[278, 578], [609, 1445]]",278,609,578,609,887,2023,856,2054,1723,1187,0.5920962199312715,0.3247663551401869,0.3134160090191657,0.7142857142857143,0.2857142857142857,0.6865839909808342,0.31899024670109005
0.727,2910,"[[277, 578], [610, 1445]]",277,610,578,610,887,2023,855,2055,1722,1188,0.5917525773195876,0.32397660818713453,0.31228861330326946,0.7142857142857143,0.2857142857142857,0.6877113866967306,0.31802525832376577
0.728,2910,"[[276, 577], [611, 1446]]",276,611,577,611,887,2023,853,2057,1722,1188,0.5917525773195876,0.3235638921453693,0.3111612175873732,0.7147800296589224,0.2852199703410776,0.6888387824126269,0.31724137931034485
0.729,2910,"[[276, 576], [611, 1447]]",276,611,576,611,887,2023,852,2058,1723,1187,0.5920962199312715,0.323943661971831,0.3111612175873732,0.7152743450321305,0.2847256549678695,0.6888387824126269,0.3174238067855089
0.73,2910,"[[276, 575], [611, 1448]]",276,611,575,611,887,2023,851,2059,1724,1186,0.5924398625429553,0.32432432432432434,0.3111612175873732,0.7157686604053386,0.2842313395946614,0.6888387824126269,0.31760644418872264
0.731,2910,"[[276, 575], [611, 1448]]",276,611,575,611,887,2023,851,2059,1724,1186,0.5924398625429553,0.32432432432432434,0.3111612175873732,0.7157686604053386,0.2842313395946614,0.6888387824126269,0.31760644418872264
0.732,2910,"[[272, 574], [615, 1449]]",272,615,574,615,887,2023,846,2064,1721,1189,0.5914089347079038,0.3215130023640662,0.30665163472378804,0.7162629757785467,0.2837370242214533,0.6933483652762119,0.31390652048470863
0.733,2910,"[[272, 574], [615, 1449]]",272,615,574,615,887,2023,846,2064,1721,1189,0.5914089347079038,0.3215130023640662,0.30665163472378804,0.7162629757785467,0.2837370242214533,0.6933483652762119,0.31390652048470863
0.734,2910,"[[272, 573], [615, 1450]]",272,615,573,615,887,2023,845,2065,1722,1188,0.5917525773195876,0.32189349112426036,0.30665163472378804,0.7167572911517548,0.2832427088482452,0.6933483652762119,0.3140877598152425
0.735,2910,"[[272, 573], [615, 1450]]",272,615,573,615,887,2023,845,2065,1722,1188,0.5917525773195876,0.32189349112426036,0.30665163472378804,0.7167572911517548,0.2832427088482452,0.6933483652762119,0.3140877598152425
0.736,2910,"[[271, 572], [616, 1451]]",271,616,572,616,887,2023,843,2067,1722,1188,0.5917525773195876,0.32147093712930014,0.3055242390078918,0.7172516065249629,0.28274839347503705,0.6944757609921083,0.3132947976878613
0.737,2910,"[[271, 572], [616, 1451]]",271,616,572,616,887,2023,843,2067,1722,1188,0.5917525773195876,0.32147093712930014,0.3055242390078918,0.7172516065249629,0.28274839347503705,0.6944757609921083,0.3132947976878613
0.738,2910,"[[271, 572], [616, 1451]]",271,616,572,616,887,2023,843,2067,1722,1188,0.5917525773195876,0.32147093712930014,0.3055242390078918,0.7172516065249629,0.28274839347503705,0.6944757609921083,0.3132947976878613
0.739,2910,"[[271, 572], [616, 1451]]",271,616,572,616,887,2023,843,2067,1722,1188,0.5917525773195876,0.32147093712930014,0.3055242390078918,0.7172516065249629,0.28274839347503705,0.6944757609921083,0.3132947976878613
0.74,2910,"[[271, 572], [616, 1451]]",271,616,572,616,887,2023,843,2067,1722,1188,0.5917525773195876,0.32147093712930014,0.3055242390078918,0.7172516065249629,0.28274839347503705,0.6944757609921083,0.3132947976878613
0.741,2910,"[[271, 571], [616, 1452]]",271,616,571,616,887,2023,842,2068,1723,1187,0.5920962199312715,0.32185273159144895,0.3055242390078918,0.717745921898171,0.28225407810182895,0.6944757609921083,0.313475997686524
0.742,2910,"[[271, 570], [616, 1453]]",271,616,570,616,887,2023,841,2069,1724,1186,0.5924398625429553,0.3222354340071344,0.3055242390078918,0.7182402372713791,0.28175976272862086,0.6944757609921083,0.31365740740740744
0.743,2910,"[[271, 569], [616, 1454]]",271,616,569,616,887,2023,840,2070,1725,1185,0.5927835051546392,0.32261904761904764,0.3055242390078918,0.7187345526445873,0.28126544735541276,0.6944757609921083,0.31383902721482343
0.744,2910,"[[271, 569], [616, 1454]]",271,616,569,616,887,2023,840,2070,1725,1185,0.5927835051546392,0.32261904761904764,0.3055242390078918,0.7187345526445873,0.28126544735541276,0.6944757609921083,0.31383902721482343
0.745,2910,"[[271, 567], [616, 1456]]",271,616,567,616,887,2023,838,2072,1727,1183,0.5934707903780069,0.3233890214797136,0.3055242390078918,0.7197231833910035,0.28027681660899656,0.6944757609921083,0.3142028985507247
0.746,2910,"[[271, 566], [616, 1457]]",271,616,566,616,887,2023,837,2073,1728,1182,0.5938144329896907,0.3237753882915173,0.3055242390078918,0.7202174987642116,0.2797825012357884,0.6944757609921083,0.3143851508120649
0.747,2910,"[[271, 566], [616, 1457]]",271,616,566,616,887,2023,837,2073,1728,1182,0.5938144329896907,0.3237753882915173,0.3055242390078918,0.7202174987642116,0.2797825012357884,0.6944757609921083,0.3143851508120649
0.748,2910,"[[271, 565], [616, 1458]]",271,616,565,616,887,2023,836,2074,1729,1181,0.5941580756013746,0.3241626794258373,0.3055242390078918,0.7207118141374197,0.2792881858625803,0.6944757609921083,0.31456761462565297
0.749,2910,"[[271, 565], [616, 1458]]",271,616,565,616,887,2023,836,2074,1729,1181,0.5941580756013746,0.3241626794258373,0.3055242390078918,0.7207118141374197,0.2792881858625803,0.6944757609921083,0.31456761462565297
0.75,2910,"[[271, 564], [616, 1459]]",271,616,564,616,887,2023,835,2075,1730,1180,0.5945017182130584,0.32455089820359284,0.3055242390078918,0.7212061295106278,0.2787938704893722,0.6944757609921083,0.31475029036004654
0.751,2910,"[[271, 562], [616, 1461]]",271,616,562,616,887,2023,833,2077,1732,1178,0.5951890034364261,0.32533013205282113,0.3055242390078918,0.722194760257044,0.277805239742956,0.6944757609921083,0.31511627906976747
0.752,2910,"[[271, 560], [616, 1463]]",271,616,560,616,887,2023,831,2079,1734,1176,0.5958762886597938,0.32611311672683513,0.3055242390078918,0.7231833910034602,0.2768166089965398,0.6944757609921083,0.31548311990686845
0.753,2910,"[[271, 559], [616, 1464]]",271,616,559,616,887,2023,830,2080,1735,1175,0.5962199312714777,0.3265060240963855,0.3055242390078918,0.7236777063766683,0.27632229362333166,0.6944757609921083,0.31566686080372736
0.754,2910,"[[271, 556], [616, 1467]]",271,616,556,616,887,2023,827,2083,1738,1172,0.5972508591065292,0.32769044740024184,0.3055242390078918,0.7251606524962926,0.27483934750370737,0.6944757609921083,0.3162193698949825
0.755,2910,"[[271, 554], [616, 1469]]",271,616,554,616,887,2023,825,2085,1740,1170,0.5979381443298969,0.3284848484848485,0.3055242390078918,0.7261492832427089,0.27385071675729117,0.6944757609921083,0.316588785046729
0.756,2910,"[[271, 553], [616, 1470]]",271,616,553,616,887,2023,824,2086,1741,1169,0.5982817869415807,0.3288834951456311,0.3055242390078918,0.726643598615917,0.27335640138408307,0.6944757609921083,0.31677381648158975
0.757,2910,"[[271, 551], [616, 1472]]",271,616,551,616,887,2023,822,2088,1743,1167,0.5989690721649484,0.32968369829683697,0.3055242390078918,0.7276322293623332,0.2723677706376668,0.6944757609921083,0.3171445289643066
0.758,2910,"[[271, 551], [616, 1472]]",271,616,551,616,887,2023,822,2088,1743,1167,0.5989690721649484,0.32968369829683697,0.3055242390078918,0.7276322293623332,0.2723677706376668,0.6944757609921083,0.3171445289643066
0.759,2910,"[[270, 551], [617, 1472]]",270,617,551,617,887,2023,821,2089,1742,1168,0.5986254295532646,0.32886723507917176,0.3043968432919955,0.7276322293623332,0.2723677706376668,0.6956031567080045,0.3161592505854801
0.76,2910,"[[270, 549], [617, 1474]]",270,617,549,617,887,2023,819,2091,1744,1166,0.5993127147766323,0.32967032967032966,0.3043968432919955,0.7286208601087494,0.2713791398912506,0.6956031567080045,0.3165298944900352
0.761,2910,"[[269, 549], [618, 1474]]",269,618,549,618,887,2023,818,2092,1743,1167,0.5989690721649484,0.32885085574572126,0.3032694475760992,0.7286208601087494,0.2713791398912506,0.6967305524239008,0.3155425219941349
0.762,2910,"[[269, 549], [618, 1474]]",269,618,549,618,887,2023,818,2092,1743,1167,0.5989690721649484,0.32885085574572126,0.3032694475760992,0.7286208601087494,0.2713791398912506,0.6967305524239008,0.3155425219941349
0.763,2910,"[[268, 547], [619, 1476]]",268,619,547,619,887,2023,815,2095,1744,1166,0.5993127147766323,0.32883435582822085,0.30214205186020293,0.7296094908551656,0.2703905091448344,0.6978579481397971,0.31492361927144535
0.764,2910,"[[267, 546], [620, 1477]]",267,620,546,620,887,2023,813,2097,1744,1166,0.5993127147766323,0.3284132841328413,0.30101465614430667,0.7301038062283737,0.2698961937716263,0.6989853438556933,0.3141176470588235
0.765,2910,"[[267, 543], [620, 1480]]",267,620,543,620,887,2023,810,2100,1747,1163,0.6003436426116838,0.3296296296296296,0.30101465614430667,0.731586752347998,0.268413247652002,0.6989853438556933,0.3146729522687095
0.766,2910,"[[267, 540], [620, 1483]]",267,620,540,620,887,2023,807,2103,1750,1160,0.6013745704467354,0.3308550185873606,0.30101465614430667,0.7330696984676224,0.2669303015323777,0.6989853438556933,0.31523022432113346
0.767,2910,"[[267, 539], [620, 1484]]",267,620,539,620,887,2023,806,2104,1751,1159,0.6017182130584192,0.33126550868486354,0.30101465614430667,0.7335640138408305,0.2664359861591695,0.6989853438556933,0.3154164205552274
0.768,2910,"[[267, 538], [620, 1485]]",267,620,538,620,887,2023,805,2105,1752,1158,0.6020618556701031,0.3316770186335404,0.30101465614430667,0.7340583292140386,0.2659416707859614,0.6989853438556933,0.31560283687943264
0.769,2910,"[[266, 538], [621, 1485]]",266,621,538,621,887,2023,804,2106,1751,1159,0.6017182130584192,0.3308457711442786,0.29988726042841035,0.7340583292140386,0.2659416707859614,0.7001127395715896,0.3146067415730337
0.77,2910,"[[264, 538], [623, 1485]]",264,623,538,623,887,2023,802,2108,1749,1161,0.6010309278350515,0.32917705735660846,0.2976324689966178,0.7340583292140386,0.2659416707859614,0.7023675310033822,0.3126110124333925
0.771,2910,"[[264, 537], [623, 1486]]",264,623,537,623,887,2023,801,2109,1750,1160,0.6013745704467354,0.3295880149812734,0.2976324689966178,0.7345526445872467,0.2654473554127533,0.7023675310033822,0.3127962085308057
0.772,2910,"[[263, 536], [624, 1487]]",263,624,536,624,887,2023,799,2111,1750,1160,0.6013745704467354,0.32916145181476847,0.2965050732807215,0.7350469599604548,0.26495304003954523,0.7034949267192785,0.31198102016607354
0.773,2910,"[[263, 534], [624, 1489]]",263,624,534,624,887,2023,797,2113,1752,1158,0.6020618556701031,0.3299874529485571,0.2965050732807215,0.736035590706871,0.26396440929312903,0.7034949267192785,0.3123515439429928
0.774,2910,"[[262, 533], [625, 1490]]",262,625,533,625,887,2023,795,2115,1752,1158,0.6020618556701031,0.32955974842767294,0.29537767756482525,0.7365299060800791,0.26347009391992093,0.7046223224351748,0.3115338882282996
0.775,2910,"[[261, 532], [626, 1491]]",261,626,532,626,887,2023,793,2117,1752,1158,0.6020618556701031,0.3291298865069357,0.294250281848929,0.7370242214532872,0.2629757785467128,0.705749718151071,0.3107142857142858
0.776,2910,"[[261, 530], [626, 1493]]",261,626,530,626,887,2023,791,2119,1754,1156,0.6027491408934708,0.3299620733249052,0.294250281848929,0.7380128521997034,0.2619871478002966,0.705749718151071,0.31108462455303937
0.777,2910,"[[260, 530], [627, 1493]]",260,627,530,627,887,2023,790,2120,1753,1157,0.6024054982817869,0.3291139240506329,0.29312288613303267,0.7380128521997034,0.2619871478002966,0.7068771138669673,0.31007751937984496
0.778,2910,"[[260, 530], [627, 1493]]",260,627,530,627,887,2023,790,2120,1753,1157,0.6024054982817869,0.3291139240506329,0.29312288613303267,0.7380128521997034,0.2619871478002966,0.7068771138669673,0.31007751937984496
0.779,2910,"[[259, 529], [628, 1494]]",259,628,529,628,887,2023,788,2122,1753,1157,0.6024054982817869,0.3286802030456853,0.2919954904171364,0.7385071675729116,0.2614928324270885,0.7080045095828635,0.30925373134328354
0.78,2910,"[[259, 529], [628, 1494]]",259,628,529,628,887,2023,788,2122,1753,1157,0.6024054982817869,0.3286802030456853,0.2919954904171364,0.7385071675729116,0.2614928324270885,0.7080045095828635,0.30925373134328354
0.781,2910,"[[259, 529], [628, 1494]]",259,628,529,628,887,2023,788,2122,1753,1157,0.6024054982817869,0.3286802030456853,0.2919954904171364,0.7385071675729116,0.2614928324270885,0.7080045095828635,0.30925373134328354
0.782,2910,"[[259, 528], [628, 1495]]",259,628,528,628,887,2023,787,2123,1754,1156,0.6027491408934708,0.3290978398983482,0.2919954904171364,0.7390014829461197,0.2609985170538804,0.7080045095828635,0.30943847072879327
0.783,2910,"[[259, 527], [628, 1496]]",259,628,527,628,887,2023,786,2124,1755,1155,0.6030927835051546,0.32951653944020354,0.2919954904171364,0.7394957983193278,0.2605042016806723,0.7080045095828635,0.309623430962343
0.784,2910,"[[259, 525], [628, 1498]]",259,628,525,628,887,2023,784,2126,1757,1153,0.6037800687285223,0.33035714285714285,0.2919954904171364,0.740484429065744,0.25951557093425603,0.7080045095828635,0.30999401555954514
0.785,2910,"[[259, 524], [628, 1499]]",259,628,524,628,887,2023,783,2127,1758,1152,0.6041237113402061,0.33077905491698595,0.2919954904171364,0.7409787444389521,0.25902125556104794,0.7080045095828635,0.31017964071856285
0.786,2910,"[[259, 524], [628, 1499]]",259,628,524,628,887,2023,783,2127,1758,1152,0.6041237113402061,0.33077905491698595,0.2919954904171364,0.7409787444389521,0.25902125556104794,0.7080045095828635,0.31017964071856285
0.787,2910,"[[259, 524], [628, 1499]]",259,628,524,628,887,2023,783,2127,1758,1152,0.6041237113402061,0.33077905491698595,0.2919954904171364,0.7409787444389521,0.25902125556104794,0.7080045095828635,0.31017964071856285
0.788,2910,"[[259, 523], [628, 1500]]",259,628,523,628,887,2023,782,2128,1759,1151,0.60446735395189,0.3312020460358056,0.2919954904171364,0.7414730598121602,0.25852694018783984,0.7080045095828635,0.3103654883163571
0.789,2910,"[[258, 522], [629, 1501]]",258,629,522,629,887,2023,780,2130,1759,1151,0.60446735395189,0.33076923076923076,0.29086809470124014,0.7419673751853683,0.25803262481463174,0.7091319052987599,0.3095380923815237
0.79,2910,"[[258, 521], [629, 1502]]",258,629,521,629,887,2023,779,2131,1760,1150,0.6048109965635738,0.33119383825417203,0.29086809470124014,0.7424616905585764,0.25753830944142364,0.7091319052987599,0.3097238895558223
0.791,2910,"[[258, 521], [629, 1502]]",258,629,521,629,887,2023,779,2131,1760,1150,0.6048109965635738,0.33119383825417203,0.29086809470124014,0.7424616905585764,0.25753830944142364,0.7091319052987599,0.3097238895558223
0.792,2910,"[[258, 520], [629, 1503]]",258,629,520,629,887,2023,778,2132,1761,1149,0.6051546391752577,0.33161953727506427,0.29086809470124014,0.7429560059317845,0.25704399406821554,0.7091319052987599,0.3099099099099099
0.793,2910,"[[257, 518], [630, 1505]]",257,630,518,630,887,2023,775,2135,1762,1148,0.6054982817869415,0.33161290322580644,0.2897406989853439,0.7439446366782007,0.2560553633217993,0.7102593010146562,0.30926594464500606
0.794,2910,"[[257, 517], [630, 1506]]",257,630,517,630,887,2023,774,2136,1763,1147,0.6058419243986254,0.33204134366925064,0.2897406989853439,0.7444389520514088,0.2555610479485912,0.7102593010146562,0.3094521372667068
0.795,2910,"[[256, 516], [631, 1507]]",256,631,516,631,887,2023,772,2138,1763,1147,0.6058419243986254,0.3316062176165803,0.28861330326944756,0.7449332674246169,0.2550667325753831,0.7113866967305524,0.3086196503918022
0.796,2910,"[[255, 514], [632, 1509]]",255,632,514,632,887,2023,769,2141,1764,1146,0.6061855670103092,0.33159947984395316,0.2874859075535513,0.7459218981710332,0.2540781018289669,0.7125140924464487,0.30797101449275366
0.797,2910,"[[255, 514], [632, 1509]]",255,632,514,632,887,2023,769,2141,1764,1146,0.6061855670103092,0.33159947984395316,0.2874859075535513,0.7459218981710332,0.2540781018289669,0.7125140924464487,0.30797101449275366
0.798,2910,"[[254, 513], [633, 1510]]",254,633,513,633,887,2023,767,2143,1764,1146,0.6061855670103092,0.33116036505867014,0.28635851183765504,0.7464162135442413,0.2535837864557588,0.713641488162345,0.3071342200725514
0.799,2910,"[[254, 510], [633, 1513]]",254,633,510,633,887,2023,764,2146,1767,1143,0.6072164948453608,0.3324607329842932,0.28635851183765504,0.7478991596638656,0.25210084033613445,0.713641488162345,0.30769230769230765
0.8,2910,"[[253, 508], [634, 1515]]",253,634,508,634,887,2023,761,2149,1768,1142,0.6075601374570446,0.3324572930354796,0.2852311161217587,0.7488877904102818,0.25111220958971825,0.7147688838782412,0.3070388349514563
0.801,2910,"[[253, 508], [634, 1515]]",253,634,508,634,887,2023,761,2149,1768,1142,0.6075601374570446,0.3324572930354796,0.2852311161217587,0.7488877904102818,0.25111220958971825,0.7147688838782412,0.3070388349514563
0.802,2910,"[[252, 508], [635, 1515]]",252,635,508,635,887,2023,760,2150,1767,1143,0.6072164948453608,0.33157894736842103,0.28410372040586246,0.7488877904102818,0.25111220958971825,0.7158962795941376,0.30601092896174864
0.803,2910,"[[251, 505], [636, 1518]]",251,636,505,636,887,2023,756,2154,1769,1141,0.6079037800687285,0.33201058201058203,0.2829763246899662,0.750370736529906,0.24962926347009393,0.7170236753100339,0.30553864881314674
0.804,2910,"[[251, 504], [636, 1519]]",251,636,504,636,887,2023,755,2155,1770,1140,0.6082474226804123,0.33245033112582784,0.2829763246899662,0.7508650519031141,0.2491349480968858,0.7170236753100339,0.30572472594397077
0.805,2910,"[[250, 504], [637, 1519]]",250,637,504,637,887,2023,754,2156,1769,1141,0.6079037800687285,0.33156498673740054,0.2818489289740699,0.7508650519031141,0.2491349480968858,0.7181510710259301,0.30469226081657524
0.806,2910,"[[250, 503], [637, 1520]]",250,637,503,637,887,2023,753,2157,1770,1140,0.6082474226804123,0.33200531208499334,0.2818489289740699,0.7513593672763222,0.2486406327236777,0.7181510710259301,0.30487804878048774
0.807,2910,"[[249, 502], [638, 1521]]",249,638,502,638,887,2023,751,2159,1770,1140,0.6082474226804123,0.33155792276964047,0.2807215332581736,0.7518536826495305,0.2481463173504696,0.7192784667418264,0.304029304029304
0.808,2910,"[[248, 500], [639, 1523]]",248,639,500,639,887,2023,748,2162,1771,1139,0.6085910652920962,0.3315508021390374,0.27959413754227735,0.7528423133959466,0.24715768660405338,0.7204058624577226,0.3033639143730887
0.809,2910,"[[247, 499], [640, 1524]]",247,640,499,640,887,2023,746,2164,1771,1139,0.6085910652920962,0.33109919571045576,0.27846674182638104,0.7533366287691547,0.24666337123084528,0.7215332581736189,0.3025107164727495
0.81,2910,"[[247, 499], [640, 1524]]",247,640,499,640,887,2023,746,2164,1771,1139,0.6085910652920962,0.33109919571045576,0.27846674182638104,0.7533366287691547,0.24666337123084528,0.7215332581736189,0.3025107164727495
0.811,2910,"[[245, 497], [642, 1526]]",245,642,497,642,887,2023,742,2168,1771,1139,0.6085910652920962,0.330188679245283,0.2762119503945885,0.754325259515571,0.24567474048442905,0.7237880496054115,0.30079803560466545
0.812,2910,"[[244, 496], [643, 1527]]",244,643,496,643,887,2023,740,2170,1771,1139,0.6085910652920962,0.32972972972972975,0.2750845546786922,0.754819574888779,0.24518042511122096,0.7249154453213078,0.29993853718500313
0.813,2910,"[[244, 496], [643, 1527]]",244,643,496,643,887,2023,740,2170,1771,1139,0.6085910652920962,0.32972972972972975,0.2750845546786922,0.754819574888779,0.24518042511122096,0.7249154453213078,0.29993853718500313
0.814,2910,"[[244, 496], [643, 1527]]",244,643,496,643,887,2023,740,2170,1771,1139,0.6085910652920962,0.32972972972972975,0.2750845546786922,0.754819574888779,0.24518042511122096,0.7249154453213078,0.29993853718500313
0.815,2910,"[[243, 496], [644, 1527]]",243,644,496,644,887,2023,739,2171,1770,1140,0.6082474226804123,0.32882273342354534,0.27395715896279593,0.754819574888779,0.24518042511122096,0.7260428410372041,0.29889298892988936
0.816,2910,"[[242, 493], [645, 1530]]",242,645,493,645,887,2023,735,2175,1772,1138,0.60893470790378,0.3292517006802721,0.27282976324689967,0.7563025210084033,0.24369747899159663,0.7271702367531003,0.29839704069050554
0.817,2910,"[[240, 493], [647, 1530]]",240,647,493,647,887,2023,733,2177,1770,1140,0.6082474226804123,0.3274215552523875,0.2705749718151071,0.7563025210084033,0.24369747899159663,0.7294250281848929,0.29629629629629634
0.818,2910,"[[240, 492], [647, 1531]]",240,647,492,647,887,2023,732,2178,1771,1139,0.6085910652920962,0.32786885245901637,0.2705749718151071,0.7567968363816114,0.24320316361838853,0.7294250281848929,0.29647930821494745
0.819,2910,"[[239, 490], [648, 1533]]",239,648,490,648,887,2023,729,2181,1772,1138,0.60893470790378,0.3278463648834019,0.26944757609921083,0.7577854671280276,0.2422145328719723,0.7305524239007892,0.2957920792079207
0.82,2910,"[[239, 490], [648, 1533]]",239,648,490,648,887,2023,729,2181,1772,1138,0.60893470790378,0.3278463648834019,0.26944757609921083,0.7577854671280276,0.2422145328719723,0.7305524239007892,0.2957920792079207
0.821,2910,"[[239, 490], [648, 1533]]",239,648,490,648,887,2023,729,2181,1772,1138,0.60893470790378,0.3278463648834019,0.26944757609921083,0.7577854671280276,0.2422145328719723,0.7305524239007892,0.2957920792079207
0.822,2910,"[[239, 489], [648, 1534]]",239,648,489,648,887,2023,728,2182,1773,1137,0.6092783505154639,0.3282967032967033,0.26944757609921083,0.7582797825012358,0.2417202174987642,0.7305524239007892,0.29597523219814237
0.823,2910,"[[239, 487], [648, 1536]]",239,648,487,648,887,2023,726,2184,1775,1135,0.6099656357388317,0.32920110192837465,0.26944757609921083,0.759268413247652,0.240731586752348,0.7305524239007892,0.296342219466832
0.824,2910,"[[239, 484], [648, 1539]]",239,648,484,648,887,2023,723,2187,1778,1132,0.6109965635738832,0.330567081604426,0.26944757609921083,0.7607513593672763,0.2392486406327237,0.7305524239007892,0.2968944099378882
0.825,2910,"[[238, 482], [649, 1541]]",238,649,482,649,887,2023,720,2190,1779,1131,0.6113402061855671,0.33055555555555555,0.26832018038331457,0.7617399901136925,0.23826000988630747,0.7316798196166855,0.29620410703173616
0.826,2910,"[[236, 481], [651, 1542]]",236,651,481,651,887,2023,717,2193,1778,1132,0.6109965635738832,0.3291492329149233,0.266065388951522,0.7622343054869006,0.23776569451309937,0.733934611048478,0.2942643391521197
0.827,2910,"[[235, 481], [652, 1542]]",235,652,481,652,887,2023,716,2194,1777,1133,0.6106529209621994,0.32821229050279327,0.2649379932356257,0.7622343054869006,0.23776569451309937,0.7350620067643743,0.29320024953212726
0.828,2910,"[[235, 480], [652, 1543]]",235,652,480,652,887,2023,715,2195,1778,1132,0.6109965635738832,0.32867132867132864,0.2649379932356257,0.7627286208601087,0.23727137913989124,0.7350620067643743,0.2933832709113608
0.829,2910,"[[235, 478], [652, 1545]]",235,652,478,652,887,2023,713,2197,1780,1130,0.6116838487972509,0.32959326788218796,0.2649379932356257,0.7637172516065249,0.23628274839347504,0.7350620067643743,0.29375
0.83,2910,"[[235, 477], [652, 1546]]",235,652,477,652,887,2023,712,2198,1781,1129,0.6120274914089348,0.3300561797752809,0.2649379932356257,0.764211566979733,0.23578843302026692,0.7350620067643743,0.29393370856785495
0.831,2910,"[[235, 473], [652, 1550]]",235,652,473,652,887,2023,708,2202,1785,1125,0.6134020618556701,0.3319209039548023,0.2649379932356257,0.7661888284725655,0.2338111715274345,0.7350620067643743,0.2946708463949843
0.832,2910,"[[234, 472], [653, 1551]]",234,653,472,653,887,2023,706,2204,1785,1125,0.6134020618556701,0.3314447592067989,0.2638105975197294,0.7666831438457736,0.2333168561542264,0.7361894024802705,0.2937853107344633
0.833,2910,"[[234, 470], [653, 1553]]",234,653,470,653,887,2023,704,2206,1787,1123,0.6140893470790378,0.33238636363636365,0.2638105975197294,0.7676717745921898,0.23232822540781017,0.7361894024802705,0.2941546197360151
0.834,2910,"[[232, 470], [655, 1553]]",232,655,470,655,887,2023,702,2208,1785,1125,0.6134020618556701,0.33048433048433046,0.2615558060879369,0.7676717745921898,0.23232822540781017,0.7384441939120632,0.29200755191944616
0.835,2910,"[[230, 467], [657, 1556]]",230,657,467,657,887,2023,697,2213,1786,1124,0.613745704467354,0.3299856527977044,0.2593010146561443,0.7691547207118141,0.23084527928818585,0.7406989853438557,0.2904040404040404
0.836,2910,"[[229, 465], [658, 1558]]",229,658,465,658,887,2023,694,2216,1787,1123,0.6140893470790378,0.329971181556196,0.25817361894024804,0.7701433514582303,0.22985664854176965,0.741826381059752,0.28969006957621757
0.837,2910,"[[229, 464], [658, 1559]]",229,658,464,658,887,2023,693,2217,1788,1122,0.6144329896907217,0.33044733044733043,0.25817361894024804,0.7706376668314384,0.22936233316856156,0.741826381059752,0.289873417721519
0.838,2910,"[[228, 463], [659, 1560]]",228,659,463,659,887,2023,691,2219,1788,1122,0.6144329896907217,0.3299565846599132,0.2570462232243517,0.7711319822046465,0.22886801779535343,0.7429537767756482,0.2889733840304183
0.839,2910,"[[228, 460], [659, 1563]]",228,659,460,659,887,2023,688,2222,1791,1119,0.6154639175257732,0.3313953488372093,0.2570462232243517,0.7726149283242709,0.2273850716757291,0.7429537767756482,0.2895238095238095
0.84,2910,"[[228, 458], [659, 1565]]",228,659,458,659,887,2023,686,2224,1793,1117,0.6161512027491409,0.3323615160349854,0.2570462232243517,0.7736035590706871,0.2263964409293129,0.7429537767756482,0.28989192625556265
0.841,2910,"[[228, 455], [659, 1568]]",228,659,455,659,887,2023,683,2227,1796,1114,0.6171821305841925,0.33382137628111275,0.2570462232243517,0.7750865051903114,0.22491349480968859,0.7429537767756482,0.2904458598726115
0.842,2910,"[[227, 455], [660, 1568]]",227,660,455,660,887,2023,682,2228,1795,1115,0.6168384879725086,0.33284457478005863,0.25591882750845546,0.7750865051903114,0.22491349480968859,0.7440811724915445,0.28935627788400253
0.843,2910,"[[227, 455], [660, 1568]]",227,660,455,660,887,2023,682,2228,1795,1115,0.6168384879725086,0.33284457478005863,0.25591882750845546,0.7750865051903114,0.22491349480968859,0.7440811724915445,0.28935627788400253
0.844,2910,"[[227, 455], [660, 1568]]",227,660,455,660,887,2023,682,2228,1795,1115,0.6168384879725086,0.33284457478005863,0.25591882750845546,0.7750865051903114,0.22491349480968859,0.7440811724915445,0.28935627788400253
0.845,2910,"[[224, 455], [663, 1568]]",224,663,455,663,887,2023,679,2231,1792,1118,0.6158075601374571,0.32989690721649484,0.2525366403607666,0.7750865051903114,0.22491349480968859,0.7474633596392334,0.28607918263090676
0.846,2910,"[[223, 452], [664, 1571]]",223,664,452,664,887,2023,675,2235,1794,1116,0.6164948453608248,0.33037037037037037,0.25140924464487036,0.7765694513099357,0.22343054869006426,0.7485907553551296,0.2855313700384123
0.847,2910,"[[222, 451], [665, 1572]]",222,665,451,665,887,2023,673,2237,1794,1116,0.6164948453608248,0.3298662704309064,0.2502818489289741,0.7770637666831438,0.22293623331685616,0.7497181510710259,0.2846153846153846
0.848,2910,"[[222, 450], [665, 1573]]",222,665,450,665,887,2023,672,2238,1795,1115,0.6168384879725086,0.33035714285714285,0.2502818489289741,0.7775580820563519,0.22244191794364804,0.7497181510710259,0.28479794740218084
0.849,2910,"[[222, 449], [665, 1574]]",222,665,449,665,887,2023,671,2239,1796,1114,0.6171821305841925,0.33084947839046197,0.2502818489289741,0.77805239742956,0.22194760257043994,0.7497181510710259,0.28498074454428757
0.85,2910,"[[221, 449], [666, 1574]]",221,666,449,666,887,2023,670,2240,1795,1115,0.6168384879725086,0.32985074626865674,0.2491544532130778,0.77805239742956,0.22194760257043994,0.7508455467869222,0.28387925497752087
0.851,2910,"[[220, 446], [667, 1577]]",220,667,446,667,887,2023,666,2244,1797,1113,0.6175257731958763,0.3303303303303303,0.2480270574971815,0.7795353435491844,0.22046465645081562,0.7519729425028185,0.283322601416613
0.852,2910,"[[220, 446], [667, 1577]]",220,667,446,667,887,2023,666,2244,1797,1113,0.6175257731958763,0.3303303303303303,0.2480270574971815,0.7795353435491844,0.22046465645081562,0.7519729425028185,0.283322601416613
0.853,2910,"[[219, 446], [668, 1577]]",219,668,446,668,887,2023,665,2245,1796,1114,0.6171821305841925,0.3293233082706767,0.24689966178128522,0.7795353435491844,0.22046465645081562,0.7531003382187148,0.2822164948453608
0.854,2910,"[[219, 443], [668, 1580]]",219,668,443,668,887,2023,662,2248,1799,1111,0.618213058419244,0.33081570996978854,0.24689966178128522,0.7810182896688087,0.2189817103311913,0.7531003382187148,0.28276307295029046
0.855,2910,"[[218, 442], [669, 1581]]",218,669,442,669,887,2023,660,2250,1799,1111,0.618213058419244,0.3303030303030303,0.24577226606538896,0.7815126050420168,0.2184873949579832,0.7542277339346111,0.28183581124757595
0.856,2910,"[[218, 442], [669, 1581]]",218,669,442,669,887,2023,660,2250,1799,1111,0.618213058419244,0.3303030303030303,0.24577226606538896,0.7815126050420168,0.2184873949579832,0.7542277339346111,0.28183581124757595
0.857,2910,"[[217, 442], [670, 1581]]",217,670,442,670,887,2023,659,2251,1798,1112,0.6178694158075602,0.3292867981790592,0.24464487034949267,0.7815126050420168,0.2184873949579832,0.7553551296505073,0.28072445019404924
0.858,2910,"[[217, 442], [670, 1581]]",217,670,442,670,887,2023,659,2251,1798,1112,0.6178694158075602,0.3292867981790592,0.24464487034949267,0.7815126050420168,0.2184873949579832,0.7553551296505073,0.28072445019404924
0.859,2910,"[[217, 441], [670, 1582]]",217,670,441,670,887,2023,658,2252,1799,1111,0.618213058419244,0.32978723404255317,0.24464487034949267,0.7820069204152249,0.2179930795847751,0.7553551296505073,0.2809061488673139
0.86,2910,"[[216, 439], [671, 1584]]",216,671,439,671,887,2023,655,2255,1800,1110,0.6185567010309279,0.3297709923664122,0.24351747463359638,0.7829955511616411,0.21700444883835887,0.7564825253664036,0.2801556420233463
0.861,2910,"[[211, 439], [676, 1584]]",211,676,439,676,887,2023,650,2260,1795,1115,0.6168384879725086,0.32461538461538464,0.237880496054115,0.7829955511616411,0.21700444883835887,0.762119503945885,0.2745608327911516
0.862,2910,"[[211, 437], [676, 1586]]",211,676,437,676,887,2023,648,2262,1797,1113,0.6175257731958763,0.3256172839506173,0.237880496054115,0.7839841819080573,0.21601581809194265,0.762119503945885,0.2749185667752443
0.863,2910,"[[211, 437], [676, 1586]]",211,676,437,676,887,2023,648,2262,1797,1113,0.6175257731958763,0.3256172839506173,0.237880496054115,0.7839841819080573,0.21601581809194265,0.762119503945885,0.2749185667752443
0.864,2910,"[[210, 436], [677, 1587]]",210,677,436,677,887,2023,646,2264,1797,1113,0.6175257731958763,0.32507739938080493,0.23675310033821872,0.7844784972812654,0.21552150271873455,0.7632468996617813,0.273972602739726
0.865,2910,"[[210, 435], [677, 1588]]",210,677,435,677,887,2023,645,2265,1798,1112,0.6178694158075602,0.32558139534883723,0.23675310033821872,0.7849728126544736,0.21502718734552645,0.7632468996617813,0.2741514360313316
0.866,2910,"[[209, 435], [678, 1588]]",209,678,435,678,887,2023,644,2266,1797,1113,0.6175257731958763,0.3245341614906832,0.23562570462232243,0.7849728126544736,0.21502718734552645,0.7643742953776775,0.2730241672109732
0.867,2910,"[[208, 433], [679, 1590]]",208,679,433,679,887,2023,641,2269,1798,1112,0.6178694158075602,0.3244929797191888,0.23449830890642615,0.7859614434008898,0.21403855659911022,0.7655016910935738,0.27225130890052357
0.868,2910,"[[206, 432], [681, 1591]]",206,681,432,681,887,2023,638,2272,1797,1113,0.6175257731958763,0.322884012539185,0.2322435174746336,0.7864557587740979,0.21354424122590213,0.7677564825253664,0.27016393442622955
0.869,2910,"[[206, 432], [681, 1591]]",206,681,432,681,887,2023,638,2272,1797,1113,0.6175257731958763,0.322884012539185,0.2322435174746336,0.7864557587740979,0.21354424122590213,0.7677564825253664,0.27016393442622955
0.87,2910,"[[206, 432], [681, 1591]]",206,681,432,681,887,2023,638,2272,1797,1113,0.6175257731958763,0.322884012539185,0.2322435174746336,0.7864557587740979,0.21354424122590213,0.7677564825253664,0.27016393442622955
0.871,2910,"[[205, 431], [682, 1592]]",205,682,431,682,887,2023,636,2274,1797,1113,0.6175257731958763,0.3223270440251572,0.23111612175873733,0.786950074147306,0.21304992585269403,0.7688838782412627,0.2692055154300722
0.872,2910,"[[205, 430], [682, 1593]]",205,682,430,682,887,2023,635,2275,1798,1112,0.6178694158075602,0.3228346456692913,0.23111612175873733,0.7874443895205141,0.2125556104794859,0.7688838782412627,0.26938239159001315
0.873,2910,"[[204, 429], [683, 1594]]",204,683,429,683,887,2023,633,2277,1798,1112,0.6178694158075602,0.3222748815165877,0.22998872604284104,0.7879387048937222,0.2120612951062778,0.770011273957159,0.26842105263157895
0.874,2910,"[[204, 427], [683, 1596]]",204,683,427,683,887,2023,631,2279,1800,1110,0.6185567010309279,0.3232963549920761,0.22998872604284104,0.7889273356401384,0.21107266435986158,0.770011273957159,0.26877470355731226
0.875,2910,"[[202, 427], [685, 1596]]",202,685,427,685,887,2023,629,2281,1798,1112,0.6178694158075602,0.32114467408585057,0.2277339346110485,0.7889273356401384,0.21107266435986158,0.7722660653889515,0.266490765171504
0.876,2910,"[[202, 425], [685, 1598]]",202,685,425,685,887,2023,627,2283,1800,1110,0.6185567010309279,0.32216905901116427,0.2277339346110485,0.7899159663865546,0.21008403361344538,0.7722660653889515,0.26684280052840165
0.877,2910,"[[201, 425], [686, 1598]]",201,686,425,686,887,2023,626,2284,1799,1111,0.618213058419244,0.3210862619808307,0.2266065388951522,0.7899159663865546,0.21008403361344538,0.7733934611048479,0.2656972901520158
0.878,2910,"[[201, 424], [686, 1599]]",201,686,424,686,887,2023,625,2285,1800,1110,0.6185567010309279,0.3216,0.2266065388951522,0.7904102817597627,0.20958971824023728,0.7733934611048479,0.2658730158730158
0.879,2910,"[[200, 421], [687, 1602]]",200,687,421,687,887,2023,621,2289,1802,1108,0.6192439862542956,0.322061191626409,0.2254791431792559,0.7918932278793871,0.20810677212061296,0.7745208568207441,0.26525198938992045
0.88,2910,"[[200, 420], [687, 1603]]",200,687,420,687,887,2023,620,2290,1803,1107,0.6195876288659794,0.3225806451612903,0.2254791431792559,0.7923875432525952,0.20761245674740483,0.7745208568207441,0.26542800265428
0.881,2910,"[[199, 419], [688, 1604]]",199,688,419,688,887,2023,618,2292,1803,1107,0.6195876288659794,0.3220064724919094,0.22435174746335965,0.7928818586258033,0.20711814137419673,0.7756482525366404,0.2644518272425249
0.882,2910,"[[199, 418], [688, 1605]]",199,688,418,688,887,2023,617,2293,1804,1106,0.6199312714776632,0.3225283630470016,0.22435174746335965,0.7933761739990114,0.20662382600098864,0.7756482525366404,0.2646276595744681
0.883,2910,"[[198, 415], [689, 1608]]",198,689,415,689,887,2023,613,2297,1806,1104,0.6206185567010309,0.32300163132137033,0.22322435174746336,0.7948591201186357,0.2051408798813643,0.7767756482525366,0.264
0.884,2910,"[[198, 415], [689, 1608]]",198,689,415,689,887,2023,613,2297,1806,1104,0.6206185567010309,0.32300163132137033,0.22322435174746336,0.7948591201186357,0.2051408798813643,0.7767756482525366,0.264
0.885,2910,"[[197, 415], [690, 1608]]",197,690,415,690,887,2023,612,2298,1805,1105,0.6202749140893471,0.32189542483660133,0.22209695603156707,0.7948591201186357,0.2051408798813643,0.7779030439684329,0.2628418945963976
0.886,2910,"[[197, 414], [690, 1609]]",197,690,414,690,887,2023,611,2299,1806,1104,0.6206185567010309,0.32242225859247137,0.22209695603156707,0.7953534354918438,0.20464656450815621,0.7779030439684329,0.2630173564753004
0.887,2910,"[[197, 412], [690, 1611]]",197,690,412,690,887,2023,609,2301,1808,1102,0.6213058419243986,0.32348111658456485,0.22209695603156707,0.79634206623826,0.20365793376174,0.7779030439684329,0.26336898395721925
0.888,2910,"[[197, 411], [690, 1612]]",197,690,411,690,887,2023,608,2302,1809,1101,0.6216494845360825,0.32401315789473684,0.22209695603156707,0.7968363816114681,0.2031636183885319,0.7779030439684329,0.2635451505016722
0.889,2910,"[[196, 409], [691, 1614]]",196,691,409,691,887,2023,605,2305,1810,1100,0.6219931271477663,0.3239669421487603,0.2209695603156708,0.7978250123578843,0.20217498764211567,0.7790304396843292,0.2627345844504021
0.89,2910,"[[195, 407], [692, 1616]]",195,692,407,692,887,2023,602,2308,1811,1099,0.6223367697594502,0.3239202657807309,0.21984216459977451,0.7988136431043006,0.20118635689569947,0.7801578354002254,0.2619207521826729
0.891,2910,"[[195, 407], [692, 1616]]",195,692,407,692,887,2023,602,2308,1811,1099,0.6223367697594502,0.3239202657807309,0.21984216459977451,0.7988136431043006,0.20118635689569947,0.7801578354002254,0.2619207521826729
0.892,2910,"[[195, 406], [692, 1617]]",195,692,406,692,887,2023,601,2309,1812,1098,0.622680412371134,0.324459234608985,0.21984216459977451,0.7993079584775087,0.20069204152249134,0.7801578354002254,0.2620967741935484
0.893,2910,"[[194, 401], [693, 1622]]",194,693,401,693,887,2023,595,2315,1816,1094,0.6240549828178694,0.32605042016806723,0.21871476888387825,0.8017795353435492,0.19822046465645082,0.7812852311161218,0.261808367071525
0.894,2910,"[[194, 398], [693, 1625]]",194,693,398,693,887,2023,592,2318,1819,1091,0.625085910652921,0.3277027027027027,0.21871476888387825,0.8032624814631735,0.1967375185368265,0.7812852311161218,0.2623394185260311
0.895,2910,"[[194, 395], [693, 1628]]",194,693,395,693,887,2023,589,2321,1822,1088,0.6261168384879725,0.3293718166383701,0.21871476888387825,0.8047454275827979,0.19525457241720218,0.7812852311161218,0.2628726287262873
0.896,2910,"[[194, 394], [693, 1629]]",194,693,394,693,887,2023,588,2322,1823,1087,0.6264604810996564,0.3299319727891156,0.21871476888387825,0.805239742956006,0.19476025704399408,0.7812852311161218,0.26305084745762713
0.897,2910,"[[194, 388], [693, 1635]]",194,693,388,693,887,2023,582,2328,1829,1081,0.6285223367697594,0.3333333333333333,0.21871476888387825,0.8082056351952546,0.19179436480474543,0.7812852311161218,0.26412525527569775
0.898,2910,"[[193, 385], [694, 1638]]",193,694,385,694,887,2023,578,2332,1831,1079,0.6292096219931271,0.33391003460207613,0.21758737316798196,0.8096885813148789,0.1903114186851211,0.7824126268320181,0.263481228668942
0.899,2910,"[[193, 380], [694, 1643]]",193,694,380,694,887,2023,573,2337,1836,1074,0.6309278350515464,0.3368237347294939,0.21758737316798196,0.8121601581809195,0.18783984181908056,0.7824126268320181,0.26438356164383564
0.9,2910,"[[193, 380], [694, 1643]]",193,694,380,694,887,2023,573,2337,1836,1074,0.6309278350515464,0.3368237347294939,0.21758737316798196,0.8121601581809195,0.18783984181908056,0.7824126268320181,0.26438356164383564
0.901,2910,"[[193, 378], [694, 1645]]",193,694,378,694,887,2023,571,2339,1838,1072,0.6316151202749141,0.3380035026269702,0.21758737316798196,0.8131487889273357,0.18685121107266436,0.7824126268320181,0.2647462277091907
0.902,2910,"[[193, 376], [694, 1647]]",193,694,376,694,887,2023,569,2341,1840,1070,0.6323024054982818,0.3391915641476274,0.21758737316798196,0.8141374196737519,0.18586258032624814,0.7824126268320181,0.2651098901098901
0.903,2910,"[[193, 376], [694, 1647]]",193,694,376,694,887,2023,569,2341,1840,1070,0.6323024054982818,0.3391915641476274,0.21758737316798196,0.8141374196737519,0.18586258032624814,0.7824126268320181,0.2651098901098901
0.904,2910,"[[190, 375], [697, 1648]]",190,697,375,697,887,2023,565,2345,1838,1072,0.6316151202749141,0.336283185840708,0.21420518602029312,0.81463173504696,0.18536826495304004,0.7857948139797069,0.2617079889807163
0.905,2910,"[[189, 374], [698, 1649]]",189,698,374,698,887,2023,563,2347,1838,1072,0.6316151202749141,0.33570159857904086,0.21307779030439683,0.8151260504201681,0.18487394957983194,0.7869222096956031,0.2606896551724138
0.906,2910,"[[189, 372], [698, 1651]]",189,698,372,698,887,2023,561,2349,1840,1070,0.6323024054982818,0.33689839572192515,0.21307779030439683,0.8161146811665843,0.18388531883341572,0.7869222096956031,0.2610497237569061
0.907,2910,"[[189, 370], [698, 1653]]",189,698,370,698,887,2023,559,2351,1842,1068,0.6329896907216495,0.33810375670840787,0.21307779030439683,0.8171033119130005,0.1828966880869995,0.7869222096956031,0.2614107883817427
0.908,2910,"[[189, 369], [698, 1654]]",189,698,369,698,887,2023,558,2352,1843,1067,0.6333333333333333,0.3387096774193548,0.21307779030439683,0.8175976272862086,0.1824023727137914,0.7869222096956031,0.26159169550173006
0.909,2910,"[[189, 368], [698, 1655]]",189,698,368,698,887,2023,557,2353,1844,1066,0.6336769759450172,0.3393177737881508,0.21307779030439683,0.8180919426594168,0.1819080573405833,0.7869222096956031,0.26177285318559557
0.91,2910,"[[188, 366], [699, 1657]]",188,699,366,699,887,2023,554,2356,1845,1065,0.634020618556701,0.33935018050541516,0.21195039458850057,0.819080573405833,0.18091942659416707,0.7880496054114995,0.2609299097848716
0.911,2910,"[[188, 365], [699, 1658]]",188,699,365,699,887,2023,553,2357,1846,1064,0.6343642611683848,0.3399638336347197,0.21195039458850057,0.819574888779041,0.18042511122095897,0.7880496054114995,0.26111111111111107
0.912,2910,"[[186, 364], [701, 1659]]",186,701,364,701,887,2023,550,2360,1845,1065,0.634020618556701,0.3381818181818182,0.20969560315670802,0.8200692041522492,0.17993079584775087,0.790304396843292,0.2588726513569937
0.913,2910,"[[186, 361], [701, 1662]]",186,701,361,701,887,2023,547,2363,1848,1062,0.6350515463917525,0.340036563071298,0.20969560315670802,0.8215521502718734,0.17844784972812655,0.790304396843292,0.25941422594142255
0.914,2910,"[[184, 360], [703, 1663]]",184,703,360,703,887,2023,544,2366,1847,1063,0.6347079037800687,0.3382352941176471,0.20744081172491544,0.8220464656450815,0.17795353435491842,0.7925591882750845,0.25716282320055905
0.915,2910,"[[184, 355], [703, 1668]]",184,703,355,703,887,2023,539,2371,1852,1058,0.6364261168384879,0.34137291280148424,0.20744081172491544,0.8245180425111222,0.1754819574888779,0.7925591882750845,0.25806451612903225
0.916,2910,"[[182, 354], [705, 1669]]",182,705,354,705,887,2023,536,2374,1851,1059,0.6360824742268041,0.33955223880597013,0.20518602029312288,0.8250123578843302,0.1749876421156698,0.7948139797068771,0.25579761068165846
0.917,2910,"[[181, 354], [706, 1669]]",181,706,354,706,887,2023,535,2375,1850,1060,0.6357388316151202,0.3383177570093458,0.2040586245772266,0.8250123578843302,0.1749876421156698,0.7959413754227734,0.2545710267229254
0.918,2910,"[[180, 351], [707, 1672]]",180,707,351,707,887,2023,531,2379,1852,1058,0.6364261168384879,0.3389830508474576,0.20293122886133033,0.8264953040039545,0.17350469599604548,0.7970687711386697,0.25387870239774335
0.919,2910,"[[179, 348], [708, 1675]]",179,708,348,708,887,2023,527,2383,1854,1056,0.6371134020618556,0.3396584440227704,0.20180383314543404,0.8279782501235788,0.17202174987642116,0.798196166854566,0.25318246110325315
0.92,2910,"[[178, 346], [709, 1677]]",178,709,346,709,887,2023,524,2386,1855,1055,0.6374570446735395,0.33969465648854963,0.20067643742953778,0.828966880869995,0.17103311913000493,0.7993235625704622,0.2523033309709426
0.921,2910,"[[178, 344], [709, 1679]]",178,709,344,709,887,2023,522,2388,1857,1053,0.6381443298969072,0.34099616858237547,0.20067643742953778,0.8299555116164112,0.17004448838358874,0.7993235625704622,0.2526614620298084
0.922,2910,"[[178, 342], [709, 1681]]",178,709,342,709,887,2023,520,2390,1859,1051,0.6388316151202749,0.3423076923076923,0.20067643742953778,0.8309441423628274,0.1690558576371725,0.7993235625704622,0.25302061122956643
0.923,2910,"[[177, 342], [710, 1681]]",177,710,342,710,887,2023,519,2391,1858,1052,0.638487972508591,0.34104046242774566,0.1995490417136415,0.8309441423628274,0.1690558576371725,0.8004509582863585,0.25177809388335703
0.924,2910,"[[177, 341], [710, 1682]]",177,710,341,710,887,2023,518,2392,1859,1051,0.6388316151202749,0.3416988416988417,0.1995490417136415,0.8314384577360356,0.16856154226396441,0.8004509582863585,0.25195729537366546
0.925,2910,"[[175, 339], [712, 1684]]",175,712,339,712,887,2023,514,2396,1859,1051,0.6388316151202749,0.3404669260700389,0.19729425028184894,0.8324270884824518,0.1675729115175482,0.8027057497181511,0.2498215560314061
0.926,2910,"[[174, 339], [713, 1684]]",174,713,339,713,887,2023,513,2397,1858,1052,0.638487972508591,0.3391812865497076,0.19616685456595265,0.8324270884824518,0.1675729115175482,0.8038331454340474,0.24857142857142858
0.927,2910,"[[173, 338], [714, 1685]]",173,714,338,714,887,2023,511,2399,1858,1052,0.638487972508591,0.3385518590998043,0.19503945885005636,0.8329214038556599,0.1670785961443401,0.8049605411499436,0.24749642346208872
0.928,2910,"[[173, 332], [714, 1691]]",173,714,332,714,887,2023,505,2405,1864,1046,0.6405498281786941,0.3425742574257426,0.19503945885005636,0.8358872960949085,0.16411270390509144,0.8049605411499436,0.24856321839080459
0.929,2910,"[[173, 331], [714, 1692]]",173,714,331,714,887,2023,504,2406,1865,1045,0.6408934707903781,0.34325396825396826,0.19503945885005636,0.8363816114681166,0.16361838853188335,0.8049605411499436,0.24874191229331416
0.93,2910,"[[171, 330], [716, 1693]]",171,716,330,716,887,2023,501,2409,1864,1046,0.6405498281786941,0.3413173652694611,0.1927846674182638,0.8368759268413247,0.16312407315867525,0.8072153325817362,0.24639769452449564
0.931,2910,"[[171, 328], [716, 1695]]",171,716,328,716,887,2023,499,2411,1866,1044,0.6412371134020619,0.342685370741483,0.1927846674182638,0.837864557587741,0.16213544241225902,0.8072153325817362,0.24675324675324675
0.932,2910,"[[169, 325], [718, 1698]]",169,718,325,718,887,2023,494,2416,1867,1043,0.6415807560137458,0.34210526315789475,0.19052987598647125,0.8393475037073653,0.1606524962926347,0.8094701240135288,0.24475018102824042
0.933,2910,"[[169, 324], [718, 1699]]",169,718,324,718,887,2023,493,2417,1868,1042,0.6419243986254296,0.34279918864097364,0.19052987598647125,0.8398418190805734,0.1601581809194266,0.8094701240135288,0.24492753623188404
0.934,2910,"[[167, 323], [720, 1700]]",167,720,323,720,887,2023,490,2420,1867,1043,0.6415807560137458,0.3408163265306122,0.1882750845546787,0.8403361344537815,0.15966386554621848,0.8117249154453213,0.24255628177196806
0.935,2910,"[[166, 322], [721, 1701]]",166,721,322,721,887,2023,488,2422,1867,1043,0.6415807560137458,0.3401639344262295,0.1871476888387824,0.8408304498269896,0.15916955017301038,0.8128523111612176,0.24145454545454548
0.936,2910,"[[164, 320], [723, 1703]]",164,723,320,723,887,2023,484,2426,1867,1043,0.6415807560137458,0.33884297520661155,0.18489289740698986,0.8418190805734058,0.15818091942659418,0.8151071025930101,0.23924142961342082
0.937,2910,"[[163, 319], [724, 1704]]",163,724,319,724,887,2023,482,2428,1867,1043,0.6415807560137458,0.3381742738589212,0.18376550169109357,0.8423133959466139,0.15768660405338605,0.8162344983089064,0.23813002191380567
0.938,2910,"[[161, 315], [726, 1708]]",161,726,315,726,887,2023,476,2434,1869,1041,0.6422680412371135,0.3382352941176471,0.18151071025930102,0.8442906574394463,0.15570934256055363,0.818489289740699,0.23624358033749085
0.939,2910,"[[161, 314], [726, 1709]]",161,726,314,726,887,2023,475,2435,1870,1040,0.6426116838487973,0.3389473684210526,0.18151071025930102,0.8447849728126545,0.15521502718734553,0.818489289740699,0.23641703377386195
0.94,2910,"[[157, 314], [730, 1709]]",157,730,314,730,887,2023,471,2439,1866,1044,0.6412371134020619,0.3333333333333333,0.17700112739571588,0.8447849728126545,0.15521502718734553,0.8229988726042841,0.2312223858615611
0.941,2910,"[[155, 312], [732, 1711]]",155,732,312,732,887,2023,467,2443,1866,1044,0.6412371134020619,0.33190578158458245,0.17474633596392333,0.8457736035590707,0.1542263964409293,0.8252536640360767,0.22895125553914325
0.942,2910,"[[153, 311], [734, 1712]]",153,734,311,734,887,2023,464,2446,1865,1045,0.6408934707903781,0.3297413793103448,0.17249154453213078,0.8462679189322788,0.1537320810677212,0.8275084554678692,0.2264988897113249
0.943,2910,"[[152, 306], [735, 1717]]",152,735,306,735,887,2023,458,2452,1869,1041,0.6422680412371135,0.3318777292576419,0.1713641488162345,0.8487394957983193,0.15126050420168066,0.8286358511837655,0.22602230483271374
0.944,2910,"[[152, 305], [735, 1718]]",152,735,305,735,887,2023,457,2453,1870,1040,0.6426116838487973,0.33260393873085337,0.1713641488162345,0.8492338111715274,0.15076618882847256,0.8286358511837655,0.2261904761904762
0.945,2910,"[[150, 301], [737, 1722]]",150,737,301,737,887,2023,451,2459,1872,1038,0.643298969072165,0.3325942350332594,0.16910935738444194,0.8512110726643599,0.14878892733564014,0.830890642615558,0.2242152466367713
0.946,2910,"[[145, 298], [742, 1725]]",145,742,298,742,887,2023,443,2467,1870,1040,0.6426116838487973,0.327313769751693,0.16347237880496054,0.8526940187839842,0.14730598121601582,0.8365276211950394,0.2180451127819549
0.947,2910,"[[144, 294], [743, 1729]]",144,743,294,743,887,2023,438,2472,1873,1037,0.6436426116838488,0.3287671232876712,0.16234498308906425,0.8546712802768166,0.1453287197231834,0.8376550169109357,0.21735849056603773
0.948,2910,"[[140, 290], [747, 1733]]",140,747,290,747,887,2023,430,2480,1873,1037,0.6436426116838488,0.32558139534883723,0.15783540022547915,0.856648541769649,0.14335145823035098,0.8421645997745209,0.2126044039483675
0.949,2910,"[[138, 289], [749, 1734]]",138,749,289,749,887,2023,427,2483,1872,1038,0.643298969072165,0.3231850117096019,0.1555806087936866,0.8571428571428571,0.14285714285714285,0.8444193912063134,0.21004566210045664
0.95,2910,"[[136, 287], [751, 1736]]",136,751,287,751,887,2023,423,2487,1872,1038,0.643298969072165,0.3215130023640662,0.15332581736189402,0.8581314878892734,0.14186851211072665,0.846674182638106,0.20763358778625954
0.951,2910,"[[136, 285], [751, 1738]]",136,751,285,751,887,2023,421,2489,1874,1036,0.6439862542955327,0.32304038004750596,0.15332581736189402,0.8591201186356896,0.14087988136431043,0.846674182638106,0.20795107033639143
0.952,2910,"[[136, 283], [751, 1740]]",136,751,283,751,887,2023,419,2491,1876,1034,0.6446735395189004,0.324582338902148,0.15332581736189402,0.8601087493821058,0.1398912506178942,0.846674182638106,0.20826952526799386
0.953,2910,"[[135, 279], [752, 1744]]",135,752,279,752,887,2023,414,2496,1879,1031,0.6457044673539519,0.32608695652173914,0.15219842164599776,0.8620860108749382,0.13791398912506178,0.8478015783540023,0.20753266717909302
0.954,2910,"[[134, 279], [753, 1744]]",134,753,279,753,887,2023,413,2497,1878,1032,0.6453608247422681,0.324455205811138,0.15107102593010147,0.8620860108749382,0.13791398912506178,0.8489289740698985,0.20615384615384616
0.955,2910,"[[132, 277], [755, 1746]]",132,755,277,755,887,2023,409,2501,1878,1032,0.6453608247422681,0.32273838630806845,0.1488162344983089,0.8630746416213544,0.13692535837864558,0.8511837655016911,0.20370370370370372
0.956,2910,"[[131, 275], [756, 1748]]",131,756,275,756,887,2023,406,2504,1879,1031,0.6457044673539519,0.3226600985221675,0.14768883878241262,0.8640632723677706,0.13593672763222936,0.8523111612175873,0.20262954369682906
0.957,2910,"[[129, 269], [758, 1754]]",129,758,269,758,887,2023,398,2512,1883,1027,0.6470790378006873,0.3241206030150754,0.14543404735062007,0.8670291646070193,0.1329708353929807,0.85456595264938,0.20077821011673153
0.958,2910,"[[129, 264], [758, 1759]]",129,758,264,758,887,2023,393,2517,1888,1022,0.6487972508591066,0.3282442748091603,0.14543404735062007,0.8695007414730598,0.1304992585269402,0.85456595264938,0.2015625
0.959,2910,"[[128, 263], [759, 1760]]",128,759,263,759,887,2023,391,2519,1888,1022,0.6487972508591066,0.3273657289002558,0.14430665163472378,0.8699950568462679,0.1300049431537321,0.8556933483652762,0.20031298904538342
0.96,2910,"[[127, 262], [760, 1761]]",127,760,262,760,887,2023,389,2521,1888,1022,0.6487972508591066,0.3264781491002571,0.14317925591882752,0.870489372219476,0.12951062778052397,0.8568207440811725,0.19905956112852666
0.961,2910,"[[125, 261], [762, 1762]]",125,762,261,762,887,2023,386,2524,1887,1023,0.6484536082474227,0.3238341968911917,0.14092446448703494,0.8709836875926842,0.12901631240731587,0.859075535512965,0.19638648860958366
0.962,2910,"[[124, 260], [763, 1763]]",124,763,260,763,887,2023,384,2526,1887,1023,0.6484536082474227,0.3229166666666667,0.13979706877113868,0.8714780029658923,0.12852199703410777,0.8602029312288614,0.1951219512195122
0.963,2910,"[[122, 256], [765, 1767]]",122,765,256,765,887,2023,378,2532,1889,1021,0.6491408934707904,0.32275132275132273,0.1375422773393461,0.8734552644587247,0.12654473554127532,0.8624577226606539,0.19288537549407114
0.964,2910,"[[119, 255], [768, 1768]]",119,768,255,768,887,2023,374,2536,1887,1023,0.6484536082474227,0.3181818181818182,0.13416009019165728,0.8739495798319328,0.12605042016806722,0.8658399098083427,0.18873909595559082
0.965,2910,"[[115, 252], [772, 1771]]",115,772,252,772,887,2023,367,2543,1886,1024,0.6481099656357389,0.3133514986376022,0.12965050732807215,0.8754325259515571,0.1245674740484429,0.8703494926719278,0.18341307814992028
0.966,2910,"[[114, 247], [773, 1776]]",114,773,247,773,887,2023,361,2549,1890,1020,0.6494845360824743,0.3157894736842105,0.12852311161217586,0.8779041028175977,0.12209589718240237,0.8714768883878241,0.18269230769230765
0.967,2910,"[[111, 242], [776, 1781]]",111,776,242,776,887,2023,353,2557,1892,1018,0.650171821305842,0.31444759206798867,0.12514092446448705,0.8803756796836382,0.11962432031636185,0.874859075535513,0.17903225806451614
0.968,2910,"[[110, 239], [777, 1784]]",110,777,239,777,887,2023,349,2561,1894,1016,0.6508591065292096,0.3151862464183381,0.12401352874859076,0.8818586258032625,0.11814137419673752,0.8759864712514093,0.1779935275080906
0.969,2910,"[[108, 236], [779, 1787]]",108,779,236,779,887,2023,344,2566,1895,1015,0.6512027491408935,0.313953488372093,0.12175873731679819,0.8833415719228868,0.1166584280771132,0.8782412626832018,0.17546709991876522
0.97,2910,"[[107, 234], [780, 1789]]",107,780,234,780,887,2023,341,2569,1896,1014,0.6515463917525773,0.31378299120234604,0.12063134160090191,0.8843302026693031,0.11566979733069699,0.8793686583990981,0.1742671009771987
0.971,2910,"[[105, 231], [782, 1792]]",105,782,231,782,887,2023,336,2574,1897,1013,0.6518900343642612,0.3125,0.11837655016910936,0.8858131487889274,0.11418685121107267,0.8816234498308907,0.1717089125102208
0.972,2910,"[[105, 229], [782, 1794]]",105,782,229,782,887,2023,334,2576,1899,1011,0.6525773195876289,0.3143712574850299,0.11837655016910936,0.8868017795353436,0.11319822046465645,0.8816234498308907,0.171990171990172
0.973,2910,"[[104, 227], [783, 1796]]",104,783,227,783,887,2023,331,2579,1900,1010,0.6529209621993127,0.31419939577039274,0.11724915445321307,0.8877904102817598,0.11220958971824024,0.882750845546787,0.17077175697865352
0.974,2910,"[[101, 225], [786, 1798]]",101,786,225,786,887,2023,326,2584,1899,1011,0.6525773195876289,0.3098159509202454,0.11386696730552424,0.888779041028176,0.11122095897182402,0.8861330326944757,0.1665292662819456
0.975,2910,"[[100, 221], [787, 1802]]",100,787,221,787,887,2023,321,2589,1902,1008,0.6536082474226804,0.3115264797507788,0.11273957158962795,0.8907563025210085,0.1092436974789916,0.887260428410372,0.16556291390728475
0.976,2910,"[[98, 214], [789, 1809]]",98,789,214,789,887,2023,312,2598,1907,1003,0.6553264604810997,0.3141025641025641,0.1104847801578354,0.8942165101334651,0.10578348986653485,0.8895152198421646,0.1634695579649708
0.977,2910,"[[97, 210], [790, 1813]]",97,790,210,790,887,2023,307,2603,1910,1000,0.6563573883161512,0.31596091205211724,0.10935738444193913,0.8961937716262975,0.10380622837370242,0.8906426155580609,0.1624790619765494
0.978,2910,"[[94, 208], [793, 1815]]",94,793,208,793,887,2023,302,2608,1909,1001,0.6560137457044674,0.31125827814569534,0.10597519729425028,0.8971824023727137,0.1028175976272862,0.8940248027057497,0.1581160639192599
0.979,2910,"[[93, 201], [794, 1822]]",93,794,201,794,887,2023,294,2616,1915,995,0.6580756013745704,0.3163265306122449,0.10484780157835401,0.9006426099851705,0.09935739001482946,0.895152198421646,0.15749364944961897
0.98,2910,"[[91, 197], [796, 1826]]",91,796,197,796,887,2023,288,2622,1917,993,0.6587628865979381,0.3159722222222222,0.10259301014656144,0.9026198714780029,0.09738012852199704,0.8974069898534386,0.15489361702127658
0.981,2910,"[[89, 194], [798, 1829]]",89,798,194,798,887,2023,283,2627,1918,992,0.659106529209622,0.31448763250883394,0.10033821871476889,0.9041028175976273,0.09589718240237272,0.8996617812852311,0.15213675213675215
0.982,2910,"[[89, 190], [798, 1833]]",89,798,190,798,887,2023,279,2631,1922,988,0.6604810996563574,0.31899641577060933,0.10033821871476889,0.9060800790904597,0.09391992090954028,0.8996617812852311,0.15265866209262438
0.983,2910,"[[87, 184], [800, 1839]]",87,800,184,800,887,2023,271,2639,1926,984,0.6618556701030928,0.3210332103321033,0.09808342728297632,0.9090459713297083,0.09095402867029165,0.9019165727170236,0.15025906735751293
0.984,2910,"[[85, 178], [802, 1845]]",85,802,178,802,887,2023,263,2647,1930,980,0.6632302405498282,0.3231939163498099,0.09582863585118377,0.912011863568957,0.087988136431043,0.9041713641488163,0.14782608695652175
0.985,2910,"[[82, 175], [805, 1848]]",82,805,175,805,887,2023,257,2653,1930,980,0.6632302405498282,0.31906614785992216,0.09244644870349493,0.9134948096885813,0.08650519031141868,0.9075535512965051,0.14335664335664336
0.986,2910,"[[79, 166], [808, 1857]]",79,808,166,808,887,2023,245,2665,1936,974,0.6652920962199312,0.3224489795918367,0.08906426155580609,0.9179436480474543,0.08205635195254572,0.910935738444194,0.13957597173144876
0.987,2910,"[[78, 161], [809, 1862]]",78,809,161,809,887,2023,239,2671,1940,970,0.6666666666666666,0.3263598326359833,0.08793686583990981,0.9204152249134948,0.07958477508650519,0.9120631341600902,0.13854351687388988
0.988,2910,"[[74, 155], [813, 1868]]",74,813,155,813,887,2023,229,2681,1942,968,0.6673539518900343,0.3231441048034934,0.0834272829763247,0.9233811171527434,0.07661888284725656,0.9165727170236753,0.13261648745519714
0.989,2910,"[[71, 154], [816, 1869]]",71,816,154,816,887,2023,225,2685,1940,970,0.6666666666666666,0.31555555555555553,0.08004509582863585,0.9238754325259516,0.07612456747404844,0.9199549041713642,0.12769784172661872
0.99,2910,"[[69, 148], [818, 1875]]",69,818,148,818,887,2023,217,2693,1944,966,0.668041237113402,0.31797235023041476,0.0777903043968433,0.9268413247652002,0.0731586752347998,0.9222096956031567,0.125
0.991,2910,"[[63, 137], [824, 1886]]",63,824,137,824,887,2023,200,2710,1949,961,0.6697594501718213,0.315,0.07102593010146561,0.9322787938704894,0.06772120612951063,0.9289740698985344,0.11591536338546457
0.992,2910,"[[61, 129], [826, 1894]]",61,826,129,826,887,2023,190,2720,1955,955,0.6718213058419243,0.32105263157894737,0.06877113866967305,0.9362333168561542,0.06376668314384577,0.9312288613303269,0.11327762302692665
0.993,2910,"[[60, 119], [827, 1904]]",60,827,119,827,887,2023,179,2731,1964,946,0.6749140893470791,0.33519553072625696,0.06764374295377677,0.9411764705882353,0.058823529411764705,0.9323562570462233,0.1125703564727955
0.994,2910,"[[55, 112], [832, 1911]]",55,832,112,832,887,2023,167,2743,1966,944,0.6756013745704468,0.32934131736526945,0.06200676437429538,0.9446366782006921,0.05536332179930796,0.9379932356257046,0.10436432637571158
0.995,2910,"[[49, 100], [838, 1923]]",49,838,100,838,887,2023,149,2761,1972,938,0.6776632302405499,0.3288590604026846,0.0552423900789177,0.9505684626791894,0.049431537320810674,0.9447576099210823,0.0945945945945946
0.996,2910,"[[45, 88], [842, 1935]]",45,842,88,842,887,2023,133,2777,1980,930,0.6804123711340206,0.3383458646616541,0.05073280721533258,0.9565002471576866,0.043499752842313395,0.9492671927846674,0.08823529411764706
0.997,2910,"[[34, 74], [853, 1949]]",34,853,74,853,887,2023,108,2802,1983,927,0.6814432989690722,0.3148148148148148,0.038331454340473504,0.9634206623826,0.0365793376173999,0.9616685456595265,0.06834170854271357
0.998,2910,"[[26, 59], [861, 1964]]",26,861,59,861,887,2023,85,2825,1990,920,0.6838487972508591,0.3058823529411765,0.029312288613303268,0.9708353929807217,0.0291646070192783,0.9706877113866967,0.053497942386831275
0.999,2910,"[[23, 38], [864, 1985]]",23,864,38,864,887,2023,61,2849,2008,902,0.6900343642611684,0.3770491803278688,0.02593010146561443,0.9812160158180919,0.018783984181908058,0.9740698985343855,0.04852320675105485
1.0,2910,"[[0, 0], [887, 2023]]",0,887,0,887,887,2023,0,2910,2023,887,0.6951890034364261,,0.0,1.0,0.0,1.0,
1.001,2910,"[[0, 0], [887, 2023]]",0,887,0,887,887,2023,0,2910,2023,887,0.6951890034364261,,0.0,1.0,0.0,1.0,
